customerId,description,purchase_by_invoice,purchase_total_amount,purchase_streek,next_streek_purchase_amount,remaining_amount,is_eligible_customer,offer_eligibility
1001,WHITE HANGING HEART T-LIGHT HOLDER,24,982,20,2100,1118,1,40
1002,WHITE METAL LANTERN,26,658,20,2100,1442,1,40
1003,CREAM CUPID HEARTS COAT HANGER,10,804,25,2600,1796,1,50
1004,KNITTED UNION FLAG HOT WATER BOTTLE,34,100,0,100,0,1,0
1005,RED WOOLLY HOTTIE WHITE HEART.,21,1472,20,2100,628,1,40
1006,SET 7 BABUSHKA NESTING BOXES,28,1624,25,2600,976,1,50
1007,GLASS STAR FROSTED T-LIGHT HOLDER,31,535,6,700,165,1,12
1008,HAND WARMER UNION JACK,35,670,17,1800,1130,1,34
1009,HAND WARMER RED POLKA DOT,4,2070,22,2300,230,1,44
1010,ASSORTED COLOUR BIRD ORNAMENT,21,935,20,2100,1165,1,40
1011,POPPY'S PLAYHOUSE BEDROOM ,33,147,3,400,253,1,6
1012,POPPY'S PLAYHOUSE KITCHEN,21,449,11,1200,751,1,22
1013,FELTCRAFT PRINCESS CHARLOTTE DOLL,19,795,19,2000,1205,1,38
1014,IVORY KNITTED MUG COSY ,10,413,4,500,87,1,8
1015,BOX OF 6 ASSORTED COLOUR TEASPOONS,33,355,5,600,245,1,10
1016,BOX OF VINTAGE JIGSAW BLOCKS ,21,527,23,2400,1873,1,46
1017,BOX OF VINTAGE ALPHABET BLOCKS,27,1069,15,1600,531,1,30
1018,HOME BUILDING BLOCK WORD,24,254,2,300,46,1,4
1019,LOVE BUILDING BLOCK WORD,24,651,9,1000,349,1,18
1020,RECIPE BOX WITH METAL HEART,17,615,16,1700,1085,1,32
1021,DOORMAT NEW ENGLAND,8,598,21,2200,1602,1,42
1022,JAM MAKING SET WITH JARS,27,1584,15,1600,16,1,30
1023,RED COAT RACK PARIS FASHION,19,100,0,100,0,1,0
1024,YELLOW COAT RACK PARIS FASHION,24,183,5,600,417,1,10
1025,BLUE COAT RACK PARIS FASHION,27,1626,17,1800,174,1,34
1026,BATH BUILDING BLOCK WORD,11,329,5,600,271,1,10
1027,ALARM CLOCK BAKELIKE PINK,14,332,5,600,268,1,10
1028,ALARM CLOCK BAKELIKE RED ,9,703,15,1600,897,1,30
1029,ALARM CLOCK BAKELIKE GREEN,27,478,10,1100,622,1,20
1030,PANDA AND BUNNIES STICKER SHEET,19,680,8,900,220,1,16
1031,STARS GIFT TAPE ,34,1306,21,2200,894,1,42
1032,INFLATABLE POLITICAL GLOBE ,30,1770,18,1900,130,1,36
1033,VINTAGE HEADS AND TAILS CARD GAME ,25,429,18,1900,1471,1,36
1034,SET/2 RED RETROSPOT TEA TOWELS ,24,751,18,1900,1149,1,36
1035,ROUND SNACK BOXES SET OF4 WOODLAND ,2,1156,20,2100,944,1,40
1036,SPACEBOY LUNCH BOX ,25,1982,19,2000,18,1,38
1037,LUNCH BOX I LOVE LONDON,10,137,6,700,563,1,12
1038,CIRCUS PARADE LUNCH BOX ,10,337,8,900,563,1,16
1039,CHARLOTTE BAG DOLLY GIRL DESIGN,2,421,4,500,79,1,8
1040,RED TOADSTOOL LED NIGHT LIGHT,5,546,5,600,54,1,10
1041, SET 2 TEA TOWELS I LOVE LONDON ,6,385,6,700,315,1,12
1042,VINTAGE SEASIDE JIGSAW PUZZLES,16,565,9,1000,435,1,18
1043,MINI JIGSAW CIRCUS PARADE ,22,770,8,900,130,1,16
1044,MINI JIGSAW SPACEBOY,31,483,6,700,217,1,12
1045,MINI PAINT SET VINTAGE ,35,862,13,1400,538,1,26
1046,POSTAGE,25,542,24,2500,1958,1,48
1047,PAPER CHAIN KIT 50'S CHRISTMAS ,34,1719,25,2600,881,1,50
1048,HAND WARMER RED POLKA DOT,15,1132,16,1700,568,1,32
1049,HAND WARMER UNION JACK,5,888,8,900,12,1,16
1050,WHITE HANGING HEART T-LIGHT HOLDER,33,1142,25,2600,1458,1,50
1051,WHITE METAL LANTERN,20,1830,20,2100,270,1,40
1052,CREAM CUPID HEARTS COAT HANGER,6,793,7,800,7,1,14
1053,EDWARDIAN PARASOL RED,29,726,12,1300,574,1,24
1054,RETRO COFFEE MUGS ASSORTED,22,190,2,300,110,1,4
1055,SAVE THE PLANET MUG,33,1933,24,2500,567,1,48
1056,VINTAGE BILLBOARD DRINK ME MUG,29,1152,23,2400,1248,1,46
1057,VINTAGE BILLBOARD LOVE/HATE MUG,27,482,4,500,18,1,8
1058,WOOD 2 DRAWER CABINET WHITE FINISH,11,616,10,1100,484,1,20
1059,WOOD S/3 CABINET ANT WHITE FINISH,21,100,0,100,0,1,0
1060,WOODEN PICTURE FRAME WHITE FINISH,35,1304,25,2600,1296,1,50
1061,WOODEN FRAME ANTIQUE WHITE ,3,1088,24,2500,1412,1,48
1062,KNITTED UNION FLAG HOT WATER BOTTLE,16,188,1,200,12,1,2
1063,RED WOOLLY HOTTIE WHITE HEART.,9,245,15,1600,1355,1,30
1064,SET 7 BABUSHKA NESTING BOXES,8,1063,14,1500,437,1,28
1065,GLASS STAR FROSTED T-LIGHT HOLDER,1,1661,24,2500,839,1,48
1066,VICTORIAN SEWING BOX LARGE,11,665,14,1500,835,1,28
1067,WHITE HANGING HEART T-LIGHT HOLDER,21,1225,24,2500,1275,1,48
1068,WHITE METAL LANTERN,15,207,13,1400,1193,1,26
1069,CREAM CUPID HEARTS COAT HANGER,24,355,10,1100,745,1,20
1070,EDWARDIAN PARASOL RED,24,387,8,900,513,1,16
1071,RETRO COFFEE MUGS ASSORTED,14,989,18,1900,911,1,36
1072,SAVE THE PLANET MUG,24,1627,25,2600,973,1,50
1073,VINTAGE BILLBOARD DRINK ME MUG,33,176,6,700,524,1,12
1074,VINTAGE BILLBOARD LOVE/HATE MUG,24,320,6,700,380,1,12
1075,WOOD 2 DRAWER CABINET WHITE FINISH,23,532,6,700,168,1,12
1076,WOOD S/3 CABINET ANT WHITE FINISH,1,2566,25,2600,34,1,50
1077,WOODEN PICTURE FRAME WHITE FINISH,25,396,9,1000,604,1,18
1078,WOODEN FRAME ANTIQUE WHITE ,8,152,18,1900,1748,1,36
1079,KNITTED UNION FLAG HOT WATER BOTTLE,27,682,6,700,18,1,12
1080,RED WOOLLY HOTTIE WHITE HEART.,23,251,2,300,49,1,4
1081,SET 7 BABUSHKA NESTING BOXES,4,1449,25,2600,1151,1,50
1082,GLASS STAR FROSTED T-LIGHT HOLDER,4,173,8,900,727,1,16
1083,HOT WATER BOTTLE TEA AND SYMPATHY,19,283,8,900,617,1,16
1084,RED HANGING HEART T-LIGHT HOLDER,9,152,1,200,48,1,2
1085,HAND WARMER RED POLKA DOT,3,566,6,700,134,1,12
1086,HAND WARMER UNION JACK,14,809,23,2400,1591,1,46
1087,JUMBO BAG PINK POLKADOT,4,1793,25,2600,807,1,50
1088,JUMBO  BAG BAROQUE BLACK WHITE,3,2284,24,2500,216,1,48
1089,JUMBO BAG CHARLIE AND LOLA TOYS,13,299,7,800,501,1,14
1090,STRAWBERRY CHARLOTTE BAG,13,420,7,800,380,1,14
1091,RED 3 PIECE RETROSPOT CUTLERY SET,1,909,19,2000,1091,1,38
1092,BLUE 3 PIECE POLKADOT CUTLERY SET,5,1823,21,2200,377,1,42
1093,SET/6 RED SPOTTY PAPER PLATES,28,413,21,2200,1787,1,42
1094,LUNCH BAG RED RETROSPOT,31,2056,21,2200,144,1,42
1095,STRAWBERRY LUNCH BOX WITH CUTLERY,19,556,13,1400,844,1,26
1096,LUNCH BOX WITH CUTLERY RETROSPOT ,4,1741,19,2000,259,1,38
1097,PACK OF 72 RETROSPOT CAKE CASES,12,341,6,700,359,1,12
1098,PACK OF 60 DINOSAUR CAKE CASES,20,719,14,1500,781,1,28
1099,PACK OF 60 PINK PAISLEY CAKE CASES,32,747,16,1700,953,1,32
1100,60 TEATIME FAIRY CAKE CASES,18,378,14,1500,1122,1,28
1101,TOMATO CHARLIE+LOLA COASTER SET,19,461,13,1400,939,1,26
1102,CHARLIE & LOLA WASTEPAPER BIN FLORA,13,272,11,1200,928,1,22
1103,RED CHARLIE+LOLA PERSONAL DOORSIGN,15,114,6,700,586,1,12
1104,JUMBO STORAGE BAG SUKI,8,410,8,900,490,1,16
1105,JUMBO BAG PINK VINTAGE PAISLEY,10,1026,12,1300,274,1,24
1106,JAM MAKING SET PRINTED,33,200,1,200,0,1,2
1107,RETROSPOT TEA SET CERAMIC 11 PC ,35,1873,24,2500,627,1,48
1108,GIRLY PINK TOOL SET,8,148,8,900,752,1,16
1109,JUMBO SHOPPER VINTAGE RED PAISLEY,18,1053,23,2400,1347,1,46
1110,"AIRLINE LOUNGE,METAL SIGN",18,1811,20,2100,289,1,40
1111,WHITE SPOT RED CERAMIC DRAWER KNOB,17,454,10,1100,646,1,20
1112,RED DRAWER KNOB ACRYLIC EDWARDIAN,18,1390,19,2000,610,1,38
1113,CLEAR DRAWER KNOB ACRYLIC EDWARDIAN,3,536,12,1300,764,1,24
1114,PHOTO CLIP LINE,2,1229,13,1400,171,1,26
1115,FELT EGG COSY CHICKEN,5,625,9,1000,375,1,18
1116,PIGGY BANK RETROSPOT ,27,758,23,2400,1642,1,46
1117,SKULL SHOULDER BAG,2,446,22,2300,1854,1,44
1118,YOU'RE CONFUSING ME METAL SIGN ,10,100,0,100,0,1,0
1119,COOK WITH WINE METAL SIGN ,5,1542,23,2400,858,1,46
1120,GIN + TONIC DIET METAL SIGN,23,509,10,1100,591,1,20
1121,YELLOW BREAKFAST CUP AND SAUCER,8,1071,13,1400,329,1,26
1122,PINK BREAKFAST CUP AND SAUCER ,34,160,1,200,40,1,2
1123,PAPER CHAIN KIT 50'S CHRISTMAS ,3,792,17,1800,1008,1,34
1124,PAPER CHAIN KIT RETROSPOT,27,1814,18,1900,86,1,36
1125,SMALL HEART FLOWERS HOOK ,24,617,10,1100,483,1,20
1126,PHOTO CLIP LINE,4,342,11,1200,858,1,22
1127,TEA TIME DES TEA COSY,18,872,9,1000,128,1,18
1128,FELT EGG COSY WHITE RABBIT ,23,171,13,1400,1229,1,26
1129,ZINC WILLIE WINKIE  CANDLE STICK,14,242,2,300,58,1,4
1130,CERAMIC CHERRY CAKE MONEY BANK,17,348,23,2400,2052,1,46
1131,RETROSPOT LARGE MILK JUG,6,2369,25,2600,231,1,50
1132,SET OF 6 FUNKY BEAKERS,22,121,2,300,179,1,4
1133,EDWARDIAN PARASOL BLACK,34,1898,19,2000,102,1,38
1134,EDWARDIAN PARASOL NATURAL,20,633,11,1200,567,1,22
1135,CERAMIC STRAWBERRY CAKE MONEY BANK,33,196,13,1400,1204,1,26
1136,BLUE OWL SOFT TOY,34,480,5,600,120,1,10
1137,BALLOON ART MAKE YOUR OWN FLOWERS,18,575,5,600,25,1,10
1138,RED TOADSTOOL LED NIGHT LIGHT,7,366,24,2500,2134,1,48
1139,GLASS CLOCHE SMALL,30,1884,23,2400,516,1,46
1140,GUMBALL MONOCHROME COAT RACK,17,2170,21,2200,30,1,42
1141,DOORMAT FANCY FONT HOME SWEET HOME,17,193,5,600,407,1,10
1142,Discount,30,121,3,400,279,1,6
1143,INFLATABLE POLITICAL GLOBE ,23,453,9,1000,547,1,18
1144,VINTAGE SNAKES & LADDERS,11,420,9,1000,580,1,18
1145,CHOCOLATE CALCULATOR,33,154,22,2300,2146,1,44
1146,JUMBO SHOPPER VINTAGE RED PAISLEY,8,138,2,300,162,1,4
1147,RECYCLING BAG RETROSPOT ,8,589,25,2600,2011,1,50
1148,TOY TIDY PINK POLKADOT,25,1829,22,2300,471,1,44
1149,ANTIQUE GLASS DRESSING TABLE POT,29,246,2,300,54,1,4
1150,ALARM CLOCK BAKELIKE GREEN,27,1085,10,1100,15,1,20
1151,IVORY GIANT GARDEN THERMOMETER,27,210,15,1600,1390,1,30
1152,3 TIER CAKE TIN GREEN AND CREAM,31,447,17,1800,1353,1,34
1153,3 TIER CAKE TIN RED AND CREAM,30,975,11,1200,225,1,22
1154,SET 3 WICKER OVAL BASKETS W LIDS,24,267,8,900,633,1,16
1155,SET OF 3 COLOURED  FLYING DUCKS,2,1092,21,2200,1108,1,42
1156,WOOD BLACK BOARD ANT WHITE FINISH,6,463,8,900,437,1,16
1157,COLOUR GLASS T-LIGHT HOLDER HANGING,35,189,16,1700,1511,1,32
1158,HANGING METAL HEART LANTERN,15,115,1,200,85,1,2
1159,HANGING MEDINA LANTERN SMALL,9,242,2,300,58,1,4
1160,NATURAL SLATE HEART CHALKBOARD ,28,141,1,200,59,1,2
1161,HEART OF WICKER SMALL,13,100,0,100,0,1,0
1162,HEART OF WICKER LARGE,16,300,12,1300,1000,1,24
1163,WHITE LOVEBIRD LANTERN,17,202,4,500,298,1,8
1164,CLASSIC METAL BIRDCAGE PLANT HOLDER,35,100,0,100,0,1,0
1165,CREAM HEART CARD HOLDER,26,1670,20,2100,430,1,40
1166,ENAMEL FLOWER JUG CREAM,4,1202,16,1700,498,1,32
1167,ENAMEL FIRE BUCKET CREAM,19,923,17,1800,877,1,34
1168,ENAMEL BREAD BIN CREAM,13,357,3,400,43,1,6
1169,SET 3 WICKER OVAL BASKETS W LIDS,26,2189,25,2600,411,1,50
1170,JAM MAKING SET PRINTED,16,100,0,100,0,1,0
1171,JAM MAKING SET WITH JARS,32,433,9,1000,567,1,18
1172,JUMBO BAG DOLLY GIRL DESIGN,20,2465,25,2600,135,1,50
1173,TRADITIONAL CHRISTMAS RIBBONS,6,144,1,200,56,1,2
1174,ORGANISER WOOD ANTIQUE WHITE ,17,1113,20,2100,987,1,40
1175,LUNCH BAG DOLLY GIRL DESIGN,28,357,10,1100,743,1,20
1176,WHITE WIRE EGG HOLDER,14,249,2,300,51,1,4
1177,JUMBO  BAG BAROQUE BLACK WHITE,2,1487,15,1600,113,1,30
1178,JUMBO BAG RED RETROSPOT,25,332,7,800,468,1,14
1179,CHILLI LIGHTS,26,348,21,2200,1852,1,42
1180,LIGHT GARLAND BUTTERFILES PINK,26,638,22,2300,1662,1,44
1181,WOODEN OWLS LIGHT GARLAND ,27,1358,13,1400,42,1,26
1182,FAIRY TALE COTTAGE NIGHTLIGHT,32,346,6,700,354,1,12
1183,RED TOADSTOOL LED NIGHT LIGHT,35,1804,24,2500,696,1,48
1184,HOME BUILDING BLOCK WORD,5,149,3,400,251,1,6
1185,LOVE BUILDING BLOCK WORD,1,299,2,300,1,1,4
1186,DOORMAT FANCY FONT HOME SWEET HOME,32,235,2,300,65,1,4
1187,HOME SMALL WOOD LETTERS,2,824,19,2000,1176,1,38
1188,GINGHAM HEART  DOORSTOP RED,9,107,2,300,193,1,4
1189,FIVE HEART HANGING DECORATION,6,987,12,1300,313,1,24
1190,HANGING METAL HEART LANTERN,23,292,13,1400,1108,1,26
1191,ASSORTED BOTTLE TOP  MAGNETS ,27,177,2,300,123,1,4
1192,FRIDGE MAGNETS US DINER ASSORTED,33,617,13,1400,783,1,26
1193,HOMEMADE JAM SCENTED CANDLES,33,109,3,400,291,1,6
1194,FRIDGE MAGNETS LES ENFANTS ASSORTED,2,1520,18,1900,380,1,36
1195,ROSE CARAVAN DOORSTOP,32,573,25,2600,2027,1,50
1196,HEART OF WICKER SMALL,35,2402,25,2600,198,1,50
1197,5 HOOK HANGER MAGIC TOADSTOOL,27,523,18,1900,1377,1,36
1198,CHRISTMAS LIGHTS 10 REINDEER,33,602,13,1400,798,1,26
1199,VINTAGE UNION JACK CUSHION COVER,15,139,2,300,161,1,4
1200,VINTAGE HEADS AND TAILS CARD GAME ,3,569,9,1000,431,1,18
1201,SET OF 3 COLOURED  FLYING DUCKS,24,100,0,100,0,1,0
1202,SET OF 3 GOLD FLYING DUCKS,7,145,3,400,255,1,6
1203,RED RETROSPOT UMBRELLA,5,1581,21,2200,619,1,42
1204,BLACK/BLUE POLKADOT UMBRELLA,26,290,25,2600,2310,1,50
1205,RED DINER WALL CLOCK,7,204,10,1100,896,1,20
1206,ALARM CLOCK BAKELIKE GREEN,23,2228,23,2400,172,1,46
1207,ALARM CLOCK BAKELIKE RED ,4,883,22,2300,1417,1,44
1208,BLUE DINER WALL CLOCK,15,221,3,400,179,1,6
1209,IVORY DINER WALL CLOCK,30,304,4,500,196,1,8
1210,LARGE HEART MEASURING SPOONS,13,1020,12,1300,280,1,24
1211,SMALL HEART MEASURING SPOONS,5,996,16,1700,704,1,32
1212,CHRISTMAS LIGHTS 10 REINDEER,23,699,8,900,201,1,16
1213,JAM MAKING SET WITH JARS,1,298,2,300,2,1,4
1214,JAM MAKING SET PRINTED,3,100,0,100,0,1,0
1215,JAM JAR WITH PINK LID,5,1010,11,1200,190,1,22
1216,JAM JAR WITH GREEN LID,8,199,2,300,101,1,4
1217,ROSE COTTAGE KEEPSAKE BOX ,15,1125,12,1300,175,1,24
1218,HANGING HEART ZINC T-LIGHT HOLDER,32,899,14,1500,601,1,28
1219,PAPER CHAIN KIT VINTAGE CHRISTMAS,8,527,8,900,373,1,16
1220,DISCO BALL CHRISTMAS DECORATION,29,1262,24,2500,1238,1,48
1221,WHITE HANGING HEART T-LIGHT HOLDER,20,151,8,900,749,1,16
1222,SMALL POPCORN HOLDER,32,1250,14,1500,250,1,28
1223,LARGE POPCORN HOLDER ,31,229,13,1400,1171,1,26
1224,RETROSPOT LARGE MILK JUG,28,552,9,1000,448,1,18
1225,SET/20 RED RETROSPOT PAPER NAPKINS ,3,553,6,700,147,1,12
1226,SET/6 RED SPOTTY PAPER PLATES,20,242,20,2100,1858,1,40
1227,SET/6 RED SPOTTY PAPER CUPS,33,235,2,300,65,1,4
1228,POLKADOT RAIN HAT ,20,704,15,1600,896,1,30
1229,DELUXE SEWING KIT ,23,107,2,300,193,1,4
1230,RETROSPOT HEART HOT WATER BOTTLE,26,1643,19,2000,357,1,38
1231,KNITTED UNION FLAG HOT WATER BOTTLE,31,147,1,200,53,1,2
1232,ENGLISH ROSE HOT WATER BOTTLE,21,780,8,900,120,1,16
1233,PHOTO CUBE,23,663,16,1700,1037,1,32
1234,HOMEMADE JAM SCENTED CANDLES,19,888,16,1700,812,1,32
1235,JUMBO BAG RED RETROSPOT,10,225,14,1500,1275,1,28
1236,PLASTERS IN TIN CIRCUS PARADE ,29,1964,23,2400,436,1,46
1237,PACK OF 12 PINK PAISLEY TISSUES ,17,2213,24,2500,287,1,48
1238,PACK OF 12 BLUE PAISLEY TISSUES ,12,1075,18,1900,825,1,36
1239,PACK OF 12 RED RETROSPOT TISSUES ,27,1296,21,2200,904,1,42
1240,CHICK GREY HOT WATER BOTTLE,21,557,13,1400,843,1,26
1241,PLASTERS IN TIN VINTAGE PAISLEY ,30,677,9,1000,323,1,18
1242,PLASTERS IN TIN SKULLS,8,629,11,1200,571,1,22
1243,3 STRIPEY MICE FELTCRAFT,28,1802,24,2500,698,1,48
1244,SET OF 6 SOLDIER SKITTLES,15,199,6,700,501,1,12
1245,TRADITIONAL WOODEN SKIPPING ROPE,4,246,3,400,154,1,6
1246,WOODEN BOX OF DOMINOES,35,1198,21,2200,1002,1,42
1247,RUSTIC  SEVENTEEN DRAWER SIDEBOARD,13,2464,25,2600,136,1,50
1248,PARTY CONES CARNIVAL ASSORTED,18,213,19,2000,1787,1,38
1249,PARTY CONES CANDY ASSORTED,8,454,15,1600,1146,1,30
1250,PICNIC BASKET WICKER SMALL,6,136,4,500,364,1,8
1251,ASSORTED COLOUR BIRD ORNAMENT,12,778,17,1800,1022,1,34
1252,STAR DECORATION PAINTED ZINC ,9,819,17,1800,981,1,34
1253,RETROSPOT LAMP,13,890,16,1700,810,1,32
1254,"FANCY FONT BIRTHDAY CARD, ",1,136,14,1500,1364,1,28
1255,HAND WARMER UNION JACK,17,385,14,1500,1115,1,28
1256,HAND WARMER SCOTTY DOG DESIGN,1,230,6,700,470,1,12
1257,HAND WARMER OWL DESIGN,9,126,5,600,474,1,10
1258,HAND WARMER RED RETROSPOT,22,841,17,1800,959,1,34
1259,RETROSPOT HEART HOT WATER BOTTLE,15,179,1,200,21,1,2
1260,DOG BOWL CHASING BALL DESIGN,13,885,8,900,15,1,16
1261,CLOTHES PEGS RETROSPOT PACK 24 ,11,1574,20,2100,526,1,40
1262,HAND OVER THE CHOCOLATE   SIGN ,33,692,7,800,108,1,14
1263,WHITE HANGING HEART T-LIGHT HOLDER,16,874,8,900,26,1,16
1264,TRAVEL SEWING KIT,26,214,22,2300,2086,1,44
1265,BLACK HEART CARD HOLDER,18,158,13,1400,1242,1,26
1266,ASSORTED COLOUR BIRD ORNAMENT,10,1317,18,1900,583,1,36
1267,PACK OF 60 PINK PAISLEY CAKE CASES,17,548,22,2300,1752,1,44
1268,60 TEATIME FAIRY CAKE CASES,26,264,10,1100,836,1,20
1269,PACK OF 72 RETROSPOT CAKE CASES,3,389,3,400,11,1,6
1270,CHICK GREY HOT WATER BOTTLE,35,584,20,2100,1516,1,40
1271,SMALL GLASS HEART TRINKET POT,24,142,1,200,58,1,2
1272,ALARM CLOCK BAKELIKE IVORY,16,1005,15,1600,595,1,30
1273,ALARM CLOCK BAKELIKE RED ,1,241,6,700,459,1,12
1274,ALARM CLOCK BAKELIKE ORANGE,2,314,5,600,286,1,10
1275,ALARM CLOCK BAKELIKE GREEN,27,661,8,900,239,1,16
1276,HOT WATER BOTTLE TEA AND SYMPATHY,1,100,0,100,0,1,0
1277,HAND WARMER BIRD DESIGN,27,1485,19,2000,515,1,38
1278,HAND WARMER SCOTTY DOG DESIGN,7,724,17,1800,1076,1,34
1279,WHITE HANGING HEART T-LIGHT HOLDER,18,790,7,800,10,1,14
1280,WHITE METAL LANTERN,25,458,6,700,242,1,12
1281,CREAM CUPID HEARTS COAT HANGER,13,277,21,2200,1923,1,42
1282,EDWARDIAN PARASOL BLACK,30,424,6,700,276,1,12
1283,EDWARDIAN PARASOL RED,12,726,18,1900,1174,1,36
1284,RETRO COFFEE MUGS ASSORTED,30,1728,21,2200,472,1,42
1285,SAVE THE PLANET MUG,12,255,18,1900,1645,1,36
1286,VINTAGE BILLBOARD DRINK ME MUG,16,1446,20,2100,654,1,40
1287,VINTAGE BILLBOARD LOVE/HATE MUG,34,599,17,1800,1201,1,34
1288,WOOD 2 DRAWER CABINET WHITE FINISH,9,1735,24,2500,765,1,48
1289,WOOD S/3 CABINET ANT WHITE FINISH,22,1552,17,1800,248,1,34
1290,WOODEN PICTURE FRAME WHITE FINISH,22,813,21,2200,1387,1,42
1291,WOODEN FRAME ANTIQUE WHITE ,14,1704,24,2500,796,1,48
1292,KNITTED UNION FLAG HOT WATER BOTTLE,24,1513,23,2400,887,1,46
1293,RED WOOLLY HOTTIE WHITE HEART.,1,342,17,1800,1458,1,34
1294,SET 7 BABUSHKA NESTING BOXES,33,1235,19,2000,765,1,38
1295,IVORY EMBROIDERED QUILT ,14,456,11,1200,744,1,22
1296,GLASS STAR FROSTED T-LIGHT HOLDER,14,200,4,500,300,1,8
1297,SET OF 3 BLACK FLYING DUCKS,34,740,17,1800,1060,1,34
1298,SET OF 3 COLOURED  FLYING DUCKS,34,124,1,200,76,1,2
1299,PACK OF 12 RED RETROSPOT TISSUES ,34,371,7,800,429,1,14
1300,RED RETROSPOT MUG,35,271,16,1700,1429,1,32
1301,BABUSHKA LIGHTS STRING OF 10,11,747,12,1300,553,1,24
1302,PIGGY BANK RETROSPOT ,20,282,16,1700,1418,1,32
1303,SET 7 BABUSHKA NESTING BOXES,2,1167,11,1200,33,1,22
1304,DOORMAT FAIRY CAKE,28,196,2,300,104,1,4
1305,HAND WARMER RED RETROSPOT,23,286,7,800,514,1,14
1306,HAND WARMER SCOTTY DOG DESIGN,27,2295,24,2500,205,1,48
1307,HAND WARMER OWL DESIGN,23,230,2,300,70,1,4
1308,STRAWBERRY CERAMIC TRINKET BOX,5,397,18,1900,1503,1,36
1309,PINK DOUGHNUT TRINKET POT ,11,963,12,1300,337,1,24
1310,SILK PURSE BABUSHKA PINK,16,183,3,400,217,1,6
1311,HOT WATER BOTTLE TEA AND SYMPATHY,28,566,6,700,134,1,12
1312,HOT WATER BOTTLE I AM SO POORLY,24,168,11,1200,1032,1,22
1313,CHOCOLATE HOT WATER BOTTLE,29,1385,17,1800,415,1,34
1314,WHITE SKULL HOT WATER BOTTLE ,34,564,25,2600,2036,1,50
1315,SCOTTIE DOG HOT WATER BOTTLE,12,1433,19,2000,567,1,38
1316,HAND WARMER RED POLKA DOT,29,848,16,1700,852,1,32
1317,HAND WARMER UNION JACK,25,1239,15,1600,361,1,30
1318,HOMEMADE JAM SCENTED CANDLES,29,484,5,600,116,1,10
1319,BIRD HOUSE HOT WATER BOTTLE,9,193,4,500,307,1,8
1320,BOUDOIR SQUARE TISSUE BOX,23,303,10,1100,797,1,20
1321,SKULLS SQUARE TISSUE BOX,3,207,5,600,393,1,10
1322,PHOTO FRAME CORNICE,18,2083,21,2200,117,1,42
1323,SILK PURSE BABUSHKA RED,23,2497,24,2500,3,1,48
1324,PICTURE DOMINOES,23,325,9,1000,675,1,18
1325,S/6 SEW ON CROCHET FLOWERS,13,527,8,900,373,1,16
1326,SCANDINAVIAN REDS RIBBONS,32,1975,21,2200,225,1,42
1327,BALLOONS  WRITING SET ,9,1003,13,1400,397,1,26
1328,JAM MAKING SET PRINTED,11,1181,16,1700,519,1,32
1329,LAVENDER INCENSE IN TIN,24,1003,12,1300,297,1,24
1330,TV DINNER TRAY VINTAGE PAISLEY,18,140,1,200,60,1,2
1331,SET OF 4 ENGLISH ROSE PLACEMATS,18,2006,20,2100,94,1,40
1332,SET OF 4 ENGLISH ROSE COASTERS,20,627,11,1200,573,1,22
1333,TRIPLE PHOTO FRAME CORNICE ,31,372,4,500,128,1,8
1334,FAMILY PHOTO FRAME CORNICE,22,300,4,500,200,1,8
1335,MIRRORED DISCO BALL ,9,1312,17,1800,488,1,34
1336,DISCO BALL ROTATOR BATTERY OPERATED,22,1785,22,2300,515,1,44
1337,SILVER LOOKING MIRROR,14,134,1,200,66,1,2
1338,LADIES & GENTLEMEN METAL SIGN,30,500,24,2500,2000,1,48
1339,METAL SIGN HER DINNER IS SERVED ,17,185,2,300,115,1,4
1340,YOU'RE CONFUSING ME METAL SIGN ,5,279,3,400,121,1,6
1341,DOORMAT TOPIARY,9,949,12,1300,351,1,24
1342,BATHROOM METAL SIGN,7,800,9,1000,200,1,18
1343,KITCHEN METAL SIGN,1,1313,16,1700,387,1,32
1344,TOILET METAL SIGN,3,609,11,1200,591,1,22
1345,METAL SIGN TAKE IT OR LEAVE IT ,15,392,3,400,8,1,6
1346,I'M ON HOLIDAY METAL SIGN,10,472,17,1800,1328,1,34
1347,GROW YOUR OWN BASIL IN ENAMEL MUG,19,1295,12,1300,5,1,24
1348,SET/10 PINK POLKADOT PARTY CANDLES,14,190,3,400,210,1,6
1349,SET 20 NAPKINS FAIRY CAKES DESIGN ,32,242,4,500,258,1,8
1350,60 TEATIME FAIRY CAKE CASES,18,909,21,2200,1291,1,42
1351,SET OF 6 T-LIGHTS SNOWMEN,28,270,2,300,30,1,4
1352,SET OF 6 T-LIGHTS SANTA,31,968,21,2200,1232,1,42
1353,SET OF 9 HEART SHAPED BALLOONS,10,1998,24,2500,502,1,48
1354,SANDWICH BATH SPONGE,32,805,9,1000,195,1,18
1355,APPLE BATH SPONGE,13,934,15,1600,666,1,30
1356,STRAWBERRY BATH SPONGE ,22,595,13,1400,805,1,26
1357,BLACK PIRATE TREASURE CHEST,18,656,9,1000,344,1,18
1358,STAR PORTABLE TABLE LIGHT ,8,186,10,1100,914,1,20
1359,SNOWFLAKE PORTABLE TABLE LIGHT ,5,1172,11,1200,28,1,22
1360,PINK OVAL JEWELLED MIRROR,8,137,1,200,63,1,2
1361,RETROSPOT CIGAR BOX MATCHES ,8,1221,24,2500,1279,1,48
1362,COSY HOUR GIANT TUBE MATCHES,11,1283,17,1800,517,1,34
1363,JAZZ HEARTS PURSE NOTEBOOK,29,580,18,1900,1320,1,36
1364,LUNCH BAG DOLLY GIRL DESIGN,26,118,1,200,82,1,2
1365,WHITE HANGING HEART T-LIGHT HOLDER,22,141,2,300,159,1,4
1366,CANDLEHOLDER PINK HANGING HEART,1,462,24,2500,2038,1,48
1367,WOOD 2 DRAWER CABINET WHITE FINISH,27,154,25,2600,2446,1,50
1368,ASSORTED COLOUR MINI CASES,17,342,6,700,358,1,12
1369,LUNCH BAG RED RETROSPOT,18,666,8,900,234,1,16
1370,LUNCH BAG SPACEBOY DESIGN ,28,1712,22,2300,588,1,44
1371,LUNCH BAG WOODLAND,29,963,12,1300,337,1,24
1372,LUNCH BAG PINK POLKADOT,29,1440,14,1500,60,1,28
1373,GUMBALL COAT RACK,3,366,6,700,334,1,12
1374,BLUE NEW BAROQUE CANDLESTICK CANDLE,3,646,14,1500,854,1,28
1375,PINK NEW BAROQUECANDLESTICK CANDLE,31,166,2,300,134,1,4
1376,FAIRY CAKE FLANNEL ASSORTED COLOUR,9,1628,21,2200,572,1,42
1377,BREAD BIN DINER STYLE PINK,35,565,7,800,235,1,14
1378,JUMBO BAG CHARLIE AND LOLA TOYS,7,1104,16,1700,596,1,32
1379,TEA TIME TABLE CLOTH,24,521,15,1600,1079,1,30
1380,ENGLISH ROSE HOT WATER BOTTLE,19,328,11,1200,872,1,22
1381,ENAMEL FIRE BUCKET CREAM,29,371,8,900,529,1,16
1382,PICNIC BASKET WICKER SMALL,28,100,0,100,0,1,0
1383,PAPER CHAIN KIT 50'S CHRISTMAS ,13,522,10,1100,578,1,20
1384,PAPER CHAIN KIT VINTAGE CHRISTMAS,17,258,6,700,442,1,12
1385,HOT WATER BOTTLE BABUSHKA ,3,112,5,600,488,1,10
1386,HAND WARMER BIRD DESIGN,23,883,12,1300,417,1,24
1387,POSTAGE,2,1108,19,2000,892,1,38
1388,HEART IVORY TRELLIS SMALL,18,102,5,600,498,1,10
1389,CLEAR DRAWER KNOB ACRYLIC EDWARDIAN,24,591,21,2200,1609,1,42
1390,PINK DRAWER KNOB ACRYLIC EDWARDIAN,35,1228,18,1900,672,1,36
1391,GREEN DRAWER KNOB ACRYLIC EDWARDIAN,30,998,13,1400,402,1,26
1392,BLUE DRAWER KNOB ACRYLIC EDWARDIAN,35,702,14,1500,798,1,28
1393,HEART OF WICKER SMALL,15,1766,19,2000,234,1,38
1394,SMALL POPCORN HOLDER,14,1472,14,1500,28,1,28
1395,SET 6 FOOTBALL CELEBRATION CANDLES,30,2023,21,2200,177,1,42
1396,SET OF 6 GIRLS CELEBRATION CANDLES,15,628,6,700,72,1,12
1397,ROMANTIC PINKS RIBBONS ,4,333,3,400,67,1,6
1398,BRIGHT BLUES RIBBONS ,30,720,11,1200,480,1,22
1399,SCANDINAVIAN REDS RIBBONS,7,298,16,1700,1402,1,32
1400,CHOCOLATE BOX RIBBONS ,18,832,11,1200,368,1,22
1401,PARTY INVITES FOOTBALL,10,874,9,1000,126,1,18
1402,PARTY INVITES JAZZ HEARTS,31,752,9,1000,248,1,18
1403,PARTY INVITES SPACEMAN,6,609,16,1700,1091,1,32
1404,SET OF 3 BUTTERFLY COOKIE CUTTERS,8,327,25,2600,2273,1,50
1405,SET OF 3 HEART COOKIE CUTTERS,22,398,3,400,2,1,6
1406,3 PIECE SPACEBOY COOKIE CUTTER SET,29,390,13,1400,1010,1,26
1407,PACK OF 72 SKULL CAKE CASES,10,167,23,2400,2233,1,46
1408,PACK OF 60 SPACEBOY CAKE CASES,9,563,18,1900,1337,1,36
1409,PACK OF 72 RETROSPOT CAKE CASES,25,585,6,700,115,1,12
1410,72 SWEETHEART FAIRY CAKE CASES,13,240,4,500,260,1,8
1411,PACK OF 60 DINOSAUR CAKE CASES,32,1835,20,2100,265,1,40
1412,LUNCH BAG SUKI  DESIGN ,34,2103,22,2300,197,1,44
1413,LUNCH BAG CARS BLUE,13,947,10,1100,153,1,20
1414,LUNCH BAG  BLACK SKULL.,24,300,9,1000,700,1,18
1415,HEART IVORY TRELLIS LARGE,17,730,9,1000,270,1,18
1416,SET/5 RED RETROSPOT LID GLASS BOWLS,5,181,6,700,519,1,12
1417,WHITE HANGING HEART T-LIGHT HOLDER,26,372,13,1400,1028,1,26
1418,WHITE METAL LANTERN,23,430,12,1300,870,1,24
1419,CREAM CUPID HEARTS COAT HANGER,3,843,17,1800,957,1,34
1420,EDWARDIAN PARASOL RED,15,1218,17,1800,582,1,34
1421,RETRO COFFEE MUGS ASSORTED,21,811,24,2500,1689,1,48
1422,SAVE THE PLANET MUG,3,1908,23,2400,492,1,46
1423,VINTAGE BILLBOARD DRINK ME MUG,17,355,23,2400,2045,1,46
1424,VINTAGE BILLBOARD LOVE/HATE MUG,12,2569,25,2600,31,1,50
1425,WOOD 2 DRAWER CABINET WHITE FINISH,12,475,12,1300,825,1,24
1426,WOOD S/3 CABINET ANT WHITE FINISH,9,416,4,500,84,1,8
1427,WOODEN PICTURE FRAME WHITE FINISH,31,156,1,200,44,1,2
1428,WOODEN FRAME ANTIQUE WHITE ,11,284,3,400,116,1,6
1429,KNITTED UNION FLAG HOT WATER BOTTLE,31,588,15,1600,1012,1,30
1430,RED WOOLLY HOTTIE WHITE HEART.,23,100,0,100,0,1,0
1431,SET 7 BABUSHKA NESTING BOXES,10,1443,25,2600,1157,1,50
1432,IVORY EMBROIDERED QUILT ,29,2298,25,2600,302,1,50
1433,GLASS STAR FROSTED T-LIGHT HOLDER,14,943,9,1000,57,1,18
1434,HAND WARMER RED POLKA DOT,28,857,10,1100,243,1,20
1435,HAND WARMER UNION JACK,18,2420,25,2600,180,1,50
1436,MAGIC DRAWING SLATE DINOSAUR,18,1123,20,2100,977,1,40
1437,MAGIC DRAWING SLATE BAKE A CAKE ,9,770,7,800,30,1,14
1438,12 PENCILS TALL TUBE SKULLS,19,1275,21,2200,925,1,42
1439,CHOCOLATE CALCULATOR,27,802,21,2200,1398,1,42
1440,RED  HARMONICA IN BOX ,5,531,13,1400,869,1,26
1441,BLUE HARMONICA IN BOX ,12,1719,24,2500,781,1,48
1442,SKULLS  WATER TRANSFER TATTOOS ,5,1400,14,1500,100,1,28
1443,PACK 3 BOXES BIRD PANNETONE ,27,2474,24,2500,26,1,48
1444,HOT WATER BOTTLE TEA AND SYMPATHY,25,1154,21,2200,1046,1,42
1445,RED WOOLLY HOTTIE WHITE HEART.,7,784,23,2400,1616,1,46
1446,WHITE SKULL HOT WATER BOTTLE ,4,283,12,1300,1017,1,24
1447,3 PIECE SPACEBOY COOKIE CUTTER SET,28,483,7,800,317,1,14
1448,SET OF 20 KIDS COOKIE CUTTERS,10,421,9,1000,579,1,18
1449,10 COLOUR SPACEBOY PEN,10,330,13,1400,1070,1,26
1450,VICTORIAN GLASS HANGING T-LIGHT,5,306,8,900,594,1,16
1451,SINGLE HEART ZINC T-LIGHT HOLDER,12,428,4,500,72,1,8
1452,RED HANGING HEART T-LIGHT HOLDER,22,453,23,2400,1947,1,46
1453,HANGING METAL STAR LANTERN,11,247,2,300,53,1,4
1454,SILVER HANGING T-LIGHT HOLDER,34,674,10,1100,426,1,20
1455,DOORMAT RED RETROSPOT,6,628,6,700,72,1,12
1456,DOORMAT HEARTS,5,1153,21,2200,1047,1,42
1457,NATURAL SLATE RECTANGLE CHALKBOARD,12,1624,25,2600,976,1,50
1458,LOVEBIRD HANGING DECORATION WHITE ,22,1068,19,2000,932,1,38
1459,ASSORTED COLOUR BIRD ORNAMENT,24,340,6,700,360,1,12
1460,HOME BUILDING BLOCK WORD,12,778,25,2600,1822,1,50
1461,LOVE BUILDING BLOCK WORD,17,459,7,800,341,1,14
1462,PHOTO FRAME CORNICE,4,1911,21,2200,289,1,42
1463,PENS ASSORTED FUNNY FACE,6,252,3,400,148,1,6
1464,CARD CIRCUS PARADE,34,455,5,600,145,1,10
1465,WRAP COWBOYS  ,13,408,4,500,92,1,8
1466,AIRLINE BAG VINTAGE TOKYO 78,15,100,0,100,0,1,0
1467,RED RETROSPOT UMBRELLA,3,571,23,2400,1829,1,46
1468,BLACK/BLUE POLKADOT UMBRELLA,24,170,2,300,130,1,4
1469,RED 3 PIECE RETROSPOT CUTLERY SET,4,610,10,1100,490,1,20
1470,PACK OF 72 RETROSPOT CAKE CASES,3,808,8,900,92,1,16
1471,SET OF 72 RETROSPOT PAPER  DOILIES,7,156,2,300,144,1,4
1472,BLUE COAT RACK PARIS FASHION,1,1328,24,2500,1172,1,48
1473,PLASTERS IN TIN SKULLS,35,256,8,900,644,1,16
1474,SLEEPING CAT ERASERS,29,452,4,500,48,1,8
1475,CARD BIRTHDAY COWBOY,23,2256,25,2600,344,1,50
1476,PACK 3 BOXES CHRISTMAS PANNETONE,13,421,11,1200,779,1,22
1477,ROTATING SILVER ANGELS T-LIGHT HLDR,10,437,9,1000,563,1,18
1478,COSY HOUR GIANT TUBE MATCHES,2,283,6,700,417,1,12
1479,RIBBON REEL MAKING SNOWMEN ,8,121,1,200,79,1,2
1480,MINI PAINT SET VINTAGE ,12,274,7,800,526,1,14
1481,4 TRADITIONAL SPINNING TOPS,21,177,3,400,223,1,6
1482,SET OF 6 SOLDIER SKITTLES,22,1048,10,1100,52,1,20
1483,BAG 500g SWIRLY MARBLES,31,1040,20,2100,1060,1,40
1484,5 STRAND GLASS NECKLACE CRYSTAL,7,726,9,1000,274,1,18
1485,WHITE SKULL HOT WATER BOTTLE ,21,100,0,100,0,1,0
1486,SCOTTIE DOG HOT WATER BOTTLE,24,655,11,1200,545,1,22
1487,SQUARECUSHION COVER PINK UNION FLAG,18,1586,15,1600,14,1,30
1488,SPACEBOY CHILDRENS EGG CUP,7,253,11,1200,947,1,22
1489,CHILDREN'S SPACEBOY MUG,33,456,8,900,444,1,16
1490,HAND WARMER SCOTTY DOG DESIGN,11,102,9,1000,898,1,18
1491,FELTCRAFT CUSHION OWL,14,1509,24,2500,991,1,48
1492,BLACK CANDELABRA T-LIGHT HOLDER,32,683,18,1900,1217,1,36
1493,TOY TIDY DOLLY GIRL DESIGN,27,1086,10,1100,14,1,20
1494,SET 12 LAVENDER  BOTANICAL T-LIGHTS,16,373,5,600,227,1,10
1495,UNION JACK FLAG LUGGAGE TAG,14,524,18,1900,1376,1,36
1496,RED HEART LUGGAGE TAG,29,1549,18,1900,351,1,36
1497,RED GLASS TASSLE BAG CHARM,33,135,1,200,65,1,2
1498,CLEAR ACRYLIC FACETED BANGLE,11,868,25,2600,1732,1,50
1499,5 STRAND GLASS NECKLACE CRYSTAL,19,281,6,700,419,1,12
1500,DOORMAT UNION JACK GUNS AND ROSES,19,865,12,1300,435,1,24
1501,VANILLA SCENT CANDLE JEWELLED BOX,11,1148,12,1300,152,1,24
1502,FULL ENGLISH BREAKFAST PLATE,19,2154,24,2500,346,1,48
1503,BLACK CANDELABRA T-LIGHT HOLDER,18,184,1,200,16,1,2
1504,MAGIC DRAWING SLATE CIRCUS PARADE  ,5,1188,23,2400,1212,1,46
1505,CHRISTMAS HANGING HEART WITH BELL,31,791,14,1500,709,1,28
1506,CAKE STAND VICTORIAN FILIGREE MED,16,1145,11,1200,55,1,22
1507,PAISLEY PATTERN  STICKERS,1,100,0,100,0,1,0
1508,FLOWERS  STICKERS,16,1553,18,1900,347,1,36
1509,PINK NEW BAROQUECANDLESTICK CANDLE,25,643,9,1000,357,1,18
1510,BLUE NEW BAROQUE CANDLESTICK CANDLE,5,359,20,2100,1741,1,40
1511,JUMBO STORAGE BAG SUKI,3,742,12,1300,558,1,24
1512,BLACK LOVE BIRD CANDLE,4,1275,18,1900,625,1,36
1513,PARTY TIME PENCIL ERASERS,8,1311,25,2600,1289,1,50
1514,DISCO BALL CHRISTMAS DECORATION,22,826,13,1400,574,1,26
1515,PINK B'FLY C/COVER W BOBBLES,13,672,12,1300,628,1,24
1516,PINK UNION JACK  LUGGAGE TAG,15,120,19,2000,1880,1,38
1517,6 RIBBONS ELEGANT CHRISTMAS ,22,172,1,200,28,1,2
1518,UNION JACK FLAG LUGGAGE TAG,35,1866,25,2600,734,1,50
1519,AGED GLASS SILVER T-LIGHT HOLDER,8,1500,21,2200,700,1,42
1520,BOOM BOX SPEAKER GIRLS,18,1803,21,2200,397,1,42
1521,6 RIBBONS SHIMMERING PINKS ,3,122,1,200,78,1,2
1522, SET 2 TEA TOWELS I LOVE LONDON ,19,488,17,1800,1312,1,34
1523,JUMBO BAG OWLS,10,639,22,2300,1661,1,44
1524,SANDWICH BATH SPONGE,11,335,10,1100,765,1,20
1525,OWL DOORSTOP,21,269,8,900,631,1,16
1526,5 STRAND GLASS NECKLACE CRYSTAL,31,1379,21,2200,821,1,42
1527,HAND WARMER UNION JACK,22,171,2,300,129,1,4
1528,HAND WARMER SCOTTY DOG DESIGN,12,100,0,100,0,1,0
1529,LARGE POPCORN HOLDER ,17,869,13,1400,531,1,26
1530,PAINTED METAL STAR WITH HOLLY BELLS,25,143,6,700,557,1,12
1531,PAINTED METAL HEART WITH HOLLY BELL,33,287,10,1100,813,1,20
1532,ANGEL DECORATION STARS ON DRESS,28,121,1,200,79,1,2
1533,SMALL POPCORN HOLDER,14,1179,20,2100,921,1,40
1534,JUMBO BAG RED RETROSPOT,14,317,18,1900,1583,1,36
1535,JUMBO BAG STRAWBERRY,10,259,3,400,141,1,6
1536,STRAWBERRY SHOPPER BAG,8,1419,15,1600,181,1,30
1537,STRAWBERRY CHARLOTTE BAG,22,200,1,200,0,1,2
1538, SET 2 TEA TOWELS I LOVE LONDON ,35,126,1,200,74,1,2
1539,PACK OF 12 RED RETROSPOT TISSUES ,3,454,16,1700,1246,1,32
1540,SCOTTIE DOG HOT WATER BOTTLE,2,1322,15,1600,278,1,30
1541,CHOCOLATE HOT WATER BOTTLE,6,1806,19,2000,194,1,38
1542,LUNCH BAG CARS BLUE,20,1403,17,1800,397,1,34
1543,LUNCH BAG SPACEBOY DESIGN ,20,344,15,1600,1256,1,30
1544,ROUND SNACK BOXES SET OF4 WOODLAND ,6,1561,15,1600,39,1,30
1545,LUNCH BAG DOLLY GIRL DESIGN,31,112,1,200,88,1,2
1546,LUNCH BAG SUKI  DESIGN ,4,178,9,1000,822,1,18
1547,LUNCH BAG  BLACK SKULL.,25,1005,23,2400,1395,1,46
1548,ROUND SNACK BOXES SET OF 4 FRUITS ,31,949,11,1200,251,1,22
1549,ROUND SNACK BOXES SET OF 4 SKULLS,26,1003,14,1500,497,1,28
1550,DOLLY GIRL LUNCH BOX,28,594,18,1900,1306,1,36
1551,SPACEBOY LUNCH BOX ,18,1810,20,2100,290,1,40
1552,GREEN POLKADOT PLATE ,32,1392,15,1600,208,1,30
1553,BLUE POLKADOT PLATE ,18,258,7,800,542,1,14
1554,RED RETROSPOT PLATE ,13,1704,17,1800,96,1,34
1555,PINK  POLKADOT PLATE ,28,973,10,1100,127,1,20
1556,ROUND SNACK BOXES SET OF 4 SKULLS,19,197,1,200,3,1,2
1557,FELTCRAFT DOLL MOLLY,8,486,22,2300,1814,1,44
1558,FELTCRAFT CHRISTMAS FAIRY,29,302,9,1000,698,1,18
1559,TRAVEL SEWING KIT,28,362,6,700,338,1,12
1560,SET OF 3 NOTEBOOKS IN PARCEL,3,100,0,100,0,1,0
1561,RED RETROSPOT TAPE,28,100,0,100,0,1,0
1562,COSY SLIPPER SHOES SMALL  RED ,4,939,10,1100,161,1,20
1563,6 RIBBONS RUSTIC CHARM,30,769,13,1400,631,1,26
1564,SCANDINAVIAN REDS RIBBONS,2,1792,17,1800,8,1,34
1565,JAM MAKING SET PRINTED,31,296,14,1500,1204,1,28
1566,12 DAISY PEGS IN WOOD BOX,22,1362,16,1700,338,1,32
1567,HOT WATER BOTTLE BABUSHKA ,26,1088,16,1700,612,1,32
1568,FELTCRAFT PRINCESS CHARLOTTE DOLL,2,899,19,2000,1101,1,38
1569,FELTCRAFT CHRISTMAS FAIRY,20,952,22,2300,1348,1,44
1570,FELTCRAFT PRINCESS CHARLOTTE DOLL,13,236,2,300,64,1,4
1571,6 RIBBONS RUSTIC CHARM,22,201,23,2400,2199,1,46
1572,COSY SLIPPER SHOES SMALL  RED ,9,1117,25,2600,1483,1,50
1573,SCANDINAVIAN REDS RIBBONS,33,888,15,1600,712,1,30
1574,5 HOOK HANGER RED MAGIC TOADSTOOL,6,232,9,1000,768,1,18
1575,CHRISTMAS CRAFT TREE TOP ANGEL,13,1257,12,1300,43,1,24
1576,CHRISTMAS CRAFT LITTLE FRIENDS,30,143,4,500,357,1,8
1577,5 HOOK HANGER RED MAGIC TOADSTOOL,11,555,22,2300,1745,1,44
1578,6 RIBBONS RUSTIC CHARM,25,1973,20,2100,127,1,40
1579,12 DAISY PEGS IN WOOD BOX,8,1008,23,2400,1392,1,46
1580,SET OF 3 NOTEBOOKS IN PARCEL,18,1369,23,2400,1031,1,46
1581,5 HOOK HANGER MAGIC TOADSTOOL,1,803,14,1500,697,1,28
1582,SCANDINAVIAN REDS RIBBONS,20,178,4,500,322,1,8
1583,RED TOADSTOOL LED NIGHT LIGHT,4,589,16,1700,1111,1,32
1584,5 HOOK HANGER RED MAGIC TOADSTOOL,7,482,7,800,318,1,14
1585,COSY SLIPPER SHOES SMALL GREEN,24,1406,22,2300,894,1,44
1586,COSY SLIPPER SHOES SMALL  RED ,29,374,3,400,26,1,6
1587,FELTCRAFT DOLL ROSIE,14,2373,23,2400,27,1,46
1588,FELTCRAFT DOLL MOLLY,29,651,7,800,149,1,14
1589,FELTCRAFT DOLL EMILY,28,1644,16,1700,56,1,32
1590,FELTCRAFT PRINCESS CHARLOTTE DOLL,35,281,22,2300,2019,1,44
1591,FELTCRAFT PRINCESS OLIVIA DOLL,8,128,2,300,172,1,4
1592,REX CASH+CARRY JUMBO SHOPPER,24,2013,25,2600,587,1,50
1593,FELTCRAFT DOLL MOLLY,34,134,6,700,566,1,12
1594,FELTCRAFT CUSHION OWL,11,751,21,2200,1449,1,42
1595,CHRISTMAS CRAFT TREE TOP ANGEL,19,673,12,1300,627,1,24
1596,CHRISTMAS CRAFT LITTLE FRIENDS,33,532,18,1900,1368,1,36
1597,FELTCRAFT CUSHION RABBIT,12,145,15,1600,1455,1,30
1598,FELTCRAFT CUSHION BUTTERFLY,35,300,21,2200,1900,1,42
1599,12 DAISY PEGS IN WOOD BOX,34,316,4,500,184,1,8
1600,PAPER CHAIN KIT 50'S CHRISTMAS ,21,1362,16,1700,338,1,32
1601,FELTCRAFT CUSHION BUTTERFLY,30,615,18,1900,1285,1,36
1602,12 DAISY PEGS IN WOOD BOX,27,525,9,1000,475,1,18
1603,ROSE COTTAGE KEEPSAKE BOX ,22,594,25,2600,2006,1,50
1604,TOTE BAG I LOVE LONDON,7,184,22,2300,2116,1,44
1605,12 DAISY PEGS IN WOOD BOX,26,1072,11,1200,128,1,22
1606,TOTE BAG I LOVE LONDON,11,222,3,400,178,1,6
1607,FOLDING UMBRELLA PINKWHITE POLKADOT,9,448,22,2300,1852,1,44
1608,FOLDING UMBRELLA CREAM POLKADOT,20,261,20,2100,1839,1,40
1609,FOLDING UMBRELLA WHITE/RED POLKADOT,34,1106,21,2200,1094,1,42
1610,SET 10 LIGHTS NIGHT OWL,29,898,11,1200,302,1,22
1611,SMALL POPCORN HOLDER,12,333,18,1900,1567,1,36
1612, SET 2 TEA TOWELS I LOVE LONDON ,5,455,4,500,45,1,8
1613,FOLDING UMBRELLA RED/WHITE POLKADOT,4,276,2,300,24,1,4
1614,BABUSHKA LIGHTS STRING OF 10,31,1277,23,2400,1123,1,46
1615,LUNCH BAG RED RETROSPOT,33,485,6,700,215,1,12
1616,S/4 VALENTINE DECOUPAGE HEART BOX,8,1877,21,2200,323,1,42
1617,FOLDING UMBRELLA CREAM POLKADOT,17,248,6,700,452,1,12
1618, SET 2 TEA TOWELS I LOVE LONDON ,14,472,20,2100,1628,1,40
1619,FOLDING UMBRELLA RED/WHITE POLKADOT,31,833,22,2300,1467,1,44
1620,SOLDIERS EGG CUP ,1,562,13,1400,838,1,26
1621,S/4 VALENTINE DECOUPAGE HEART BOX,9,244,5,600,356,1,10
1622,RED RETROSPOT MINI CASES,20,100,0,100,0,1,0
1623,,34,666,20,2100,1434,1,40
1624,60 CAKE CASES VINTAGE CHRISTMAS,7,1971,20,2100,129,1,40
1625,PAPER CHAIN KIT VINTAGE CHRISTMAS,4,1806,21,2200,394,1,42
1626,RIBBON REEL CHRISTMAS SOCK BAUBLE,14,287,2,300,13,1,4
1627,RIBBON REEL SNOWY VILLAGE,33,1353,14,1500,147,1,28
1628,RIBBON REEL MAKING SNOWMEN ,4,1548,19,2000,452,1,38
1629,SET OF 20 VINTAGE CHRISTMAS NAPKINS,20,100,0,100,0,1,0
1630,TURQUOISE CHRISTMAS TREE ,33,1002,13,1400,398,1,26
1631,RED STAR CARD HOLDER,28,205,16,1700,1495,1,32
1632,WICKER WREATH SMALL,12,808,12,1300,492,1,24
1633,HEART OF WICKER LARGE,12,1175,15,1600,425,1,30
1634,ADVENT CALENDAR GINGHAM SACK,32,1016,21,2200,1184,1,42
1635,HEART OF WICKER SMALL,10,100,0,100,0,1,0
1636,FELTCRAFT BUTTERFLY HEARTS,15,946,13,1400,454,1,26
1637,PARTY CONE CHRISTMAS DECORATION ,35,121,21,2200,2079,1,42
1638,VINTAGE HEADS AND TAILS CARD GAME ,19,133,1,200,67,1,2
1639,WICKER STAR ,24,2226,24,2500,274,1,48
1640,VINTAGE SNAP CARDS,11,477,4,500,23,1,8
1641,FELTCRAFT 6 FLOWER FRIENDS,33,170,2,300,130,1,4
1642, SET 2 TEA TOWELS I LOVE LONDON ,35,1274,24,2500,1226,1,48
1643,JAM MAKING SET PRINTED,35,379,3,400,21,1,6
1644,BIRD DECORATION RED RETROSPOT,3,1304,14,1500,196,1,28
1645,CHRISTMAS GINGHAM TREE,17,1846,22,2300,454,1,44
1646,CHRISTMAS GINGHAM STAR,24,100,0,100,0,1,0
1647,CHRISTMAS GINGHAM HEART,30,167,9,1000,833,1,18
1648,PACK OF 12 PINK POLKADOT TISSUES,13,1467,17,1800,333,1,34
1649,FELTCRAFT PRINCESS LOLA DOLL,1,192,13,1400,1208,1,26
1650,PACK OF 12 LONDON TISSUES ,34,368,16,1700,1332,1,32
1651,PURPLE DRAWERKNOB ACRYLIC EDWARDIAN,11,147,17,1800,1653,1,34
1652,CHILDREN'S APRON DOLLY GIRL ,6,177,1,200,23,1,2
1653,CHILDRENS APRON SPACEBOY DESIGN,19,122,5,600,478,1,10
1654,CHRISTMAS LIGHTS 10 SANTAS ,21,1582,22,2300,718,1,44
1655,CHRISTMAS LIGHTS 10 REINDEER,20,1297,20,2100,803,1,40
1656,PAPER CHAIN KIT 50'S CHRISTMAS ,31,594,10,1100,506,1,20
1657,FELTCRAFT CHRISTMAS FAIRY,11,176,4,500,324,1,8
1658,PACK OF 72 RETROSPOT CAKE CASES,11,881,11,1200,319,1,22
1659,PACK OF 60 MUSHROOM CAKE CASES,10,262,2,300,38,1,4
1660,60 CAKE CASES DOLLY GIRL DESIGN,35,2164,23,2400,236,1,46
1661,PACK OF 60 PINK PAISLEY CAKE CASES,22,1272,21,2200,928,1,42
1662,HAND WARMER BABUSHKA DESIGN,2,1958,22,2300,342,1,44
1663,HAND WARMER BIRD DESIGN,33,1231,24,2500,1269,1,48
1664,HAND WARMER OWL DESIGN,7,1190,20,2100,910,1,40
1665,HAND WARMER RED RETROSPOT,19,810,11,1200,390,1,22
1666,SET 12 RETRO WHITE CHALK STICKS,13,967,16,1700,733,1,32
1667,FELTCRAFT HAIRBAND RED AND BLUE,1,198,1,200,2,1,2
1668,FELTCRAFT HAIRBAND PINK AND PURPLE,24,441,4,500,59,1,8
1669,FELTCRAFT HAIRBANDS PINK AND WHITE ,22,1473,22,2300,827,1,44
1670,TV DINNER TRAY DOLLY GIRL,9,255,25,2600,2345,1,50
1671,PLASTERS IN TIN VINTAGE PAISLEY ,16,570,23,2400,1830,1,46
1672,PLASTERS IN TIN SPACEBOY,19,271,13,1400,1129,1,26
1673,PLASTERS IN TIN WOODLAND ANIMALS,28,731,19,2000,1269,1,38
1674,MAGIC DRAWING SLATE SPACEBOY ,16,328,8,900,572,1,16
1675,MAGIC DRAWING SLATE CIRCUS PARADE  ,30,459,6,700,241,1,12
1676,MAGIC DRAWING SLATE GO TO THE FAIR ,17,434,6,700,266,1,12
1677,MAGIC DRAWING SLATE DOLLY GIRL ,2,730,22,2300,1570,1,44
1678,CHARLIE + LOLA RED HOT WATER BOTTLE,3,108,2,300,192,1,4
1679,HOT WATER BOTTLE BABUSHKA ,32,1165,18,1900,735,1,36
1680,URBAN BLACK RIBBONS ,33,684,9,1000,316,1,18
1681,FELTCRAFT PRINCESS CHARLOTTE DOLL,24,124,1,200,76,1,2
1682,SET OF 6 T-LIGHTS TOADSTOOLS,24,371,5,600,229,1,10
1683,ROTATING LEAVES T-LIGHT HOLDER,14,208,4,500,292,1,8
1684,RED  HARMONICA IN BOX ,3,300,9,1000,700,1,18
1685,CUPCAKE LACE PAPER SET 6,3,276,2,300,24,1,4
1686,FAMILY PHOTO FRAME CORNICE,21,1766,20,2100,334,1,40
1687,TRIPLE PHOTO FRAME CORNICE ,21,214,5,600,386,1,10
1688,WOODEN FRAME ANTIQUE WHITE ,17,117,13,1400,1283,1,26
1689,WOODEN BOX OF DOMINOES,34,294,3,400,106,1,6
1690,TRADITIONAL WOODEN CATCH CUP GAME ,3,150,11,1200,1050,1,22
1691,TRADITIONAL WOODEN SKIPPING ROPE,34,231,7,800,569,1,14
1692,S/6 WOODEN SKITTLES IN COTTON BAG,15,337,7,800,463,1,14
1693,RED METAL BEACH SPADE ,14,1779,19,2000,221,1,38
1694,BOYS VINTAGE TIN SEASIDE BUCKET,18,281,18,1900,1619,1,36
1695,GIRLS VINTAGE TIN SEASIDE BUCKET,4,554,13,1400,846,1,26
1696,GREY HEART HOT WATER BOTTLE,30,518,25,2600,2082,1,50
1697,SCOTTIE DOG HOT WATER BOTTLE,30,238,2,300,62,1,4
1698,BIRD HOUSE HOT WATER BOTTLE,1,578,22,2300,1722,1,44
1699,KINGS CHOICE TEA CADDY ,3,297,2,300,3,1,4
1700,KINGS CHOICE BISCUIT TIN,7,101,10,1100,999,1,20
1701,METAL SIGN EMPIRE TEA,31,829,20,2100,1271,1,40
1702,HOMEMADE JAM SCENTED CANDLES,30,648,16,1700,1052,1,32
1703,SET OF 6 SOLDIER SKITTLES,22,344,20,2100,1756,1,40
1704,FAWN BLUE HOT WATER BOTTLE,23,682,13,1400,718,1,26
1705,HAND WARMER RED RETROSPOT,5,1305,15,1600,295,1,30
1706,HOT WATER BOTTLE BABUSHKA ,30,130,9,1000,870,1,18
1707,WHITE SKULL HOT WATER BOTTLE ,29,311,25,2600,2289,1,50
1708,RETROSPOT HEART HOT WATER BOTTLE,8,837,13,1400,563,1,26
1709,RED WOOLLY HOTTIE WHITE HEART.,25,245,4,500,255,1,8
1710,SCOTTIE DOG HOT WATER BOTTLE,24,148,1,200,52,1,2
1711,GREY HEART HOT WATER BOTTLE,4,485,4,500,15,1,8
1712,HOT WATER BOTTLE BABUSHKA ,22,1475,19,2000,525,1,38
1713,PACK OF 6 BIRDY GIFT TAGS,14,454,10,1100,646,1,20
1714,CHILLI LIGHTS,6,2064,24,2500,436,1,48
1715,PIGGY BANK RETROSPOT ,16,147,1,200,53,1,2
1716,CERAMIC STRAWBERRY MONEY BOX,12,100,0,100,0,1,0
1717,CERAMIC STRAWBERRY CAKE MONEY BANK,23,326,5,600,274,1,10
1718,CERAMIC CHERRY CAKE MONEY BANK,13,879,15,1600,721,1,30
1719,CERAMIC HEART FAIRY CAKE MONEY BANK,6,845,8,900,55,1,16
1720,CERAMIC PIRATE CHEST MONEY BANK,22,1469,14,1500,31,1,28
1721,DOORSTOP RETROSPOT HEART,5,565,11,1200,635,1,22
1722,GINGHAM HEART  DOORSTOP RED,10,187,1,200,13,1,2
1723,RETROSPOT BABUSHKA DOORSTOP,12,154,6,700,546,1,12
1724,SILK PURSE BABUSHKA RED,30,1559,18,1900,341,1,36
1725,SILK PURSE BABUSHKA PINK,10,307,14,1500,1193,1,28
1726,FAMILY PHOTO FRAME CORNICE,32,162,2,300,138,1,4
1727,SWEETHEART WIRE WALL TIDY,30,934,10,1100,166,1,20
1728,JAM MAKING SET PRINTED,19,848,10,1100,252,1,20
1729,RED RETROSPOT OVEN GLOVE ,30,293,6,700,407,1,12
1730,CREAM HEART CARD HOLDER,27,854,12,1300,446,1,24
1731,NAMASTE SWAGAT INCENSE,26,1729,17,1800,71,1,34
1732,CERAMIC STRAWBERRY DESIGN MUG,28,355,3,400,45,1,6
1733,BLACK HEART CARD HOLDER,15,713,12,1300,587,1,24
1734,CLASSICAL ROSE SMALL VASE,23,289,17,1800,1511,1,34
1735,HYACINTH BULB T-LIGHT CANDLES,33,1168,13,1400,232,1,26
1736,CHRISTMAS CRAFT WHITE FAIRY ,1,317,4,500,183,1,8
1737,CHRISTMAS CRAFT LITTLE FRIENDS,34,331,5,600,269,1,10
1738,COSY HOUR CIGAR BOX MATCHES ,2,1067,20,2100,1033,1,40
1739,RED TEA TOWEL CLASSIC DESIGN,6,322,4,500,178,1,8
1740,HEART FILIGREE DOVE  SMALL,12,1846,23,2400,554,1,46
1741,RETROSPOT CHILDRENS APRON,25,762,7,800,38,1,14
1742,COLOURING PENCILS BROWN TUBE,16,1960,19,2000,40,1,38
1743,4 IVORY DINNER CANDLES SILVER FLOCK,25,1881,23,2400,519,1,46
1744,HEART FILIGREE DOVE  SMALL,18,533,24,2500,1967,1,48
1745,ZINC METAL HEART DECORATION,12,964,14,1500,536,1,28
1746,GREEN FERN NOTEBOOK,15,509,13,1400,891,1,26
1747,BLUE PAISLEY NOTEBOOK,15,1099,23,2400,1301,1,46
1748,CHRYSANTHEMUM NOTEBOOK,6,312,3,400,88,1,6
1749,LARGE CHINESE STYLE SCISSOR,18,1167,11,1200,33,1,22
1750,SMALL CHINESE STYLE SCISSOR,9,1398,20,2100,702,1,40
1751,S/6 WOODEN SKITTLES IN COTTON BAG,28,301,3,400,99,1,6
1752,TRADITIONAL WOODEN SKIPPING ROPE,7,1125,23,2400,1275,1,46
1753,SET OF 6 SOLDIER SKITTLES,26,101,10,1100,999,1,20
1754,4 TRADITIONAL SPINNING TOPS,5,142,1,200,58,1,2
1755,ROTATING SILVER ANGELS T-LIGHT HLDR,30,588,20,2100,1512,1,40
1756,BLACK LOVE BIRD CANDLE,17,240,20,2100,1860,1,40
1757,RETROSPOT CHILDRENS APRON,22,910,24,2500,1590,1,48
1758,HANGING GLASS ETCHED TEALIGHT,34,2120,24,2500,380,1,48
1759,HANGING GLASS ETCHED TEALIGHT,4,100,0,100,0,1,0
1760,BLUE NEW BAROQUE CANDLESTICK CANDLE,18,888,17,1800,912,1,34
1761,COOKING SET RETROSPOT,7,398,14,1500,1102,1,28
1762,KINGS CHOICE GIANT TUBE MATCHES,26,402,7,800,398,1,14
1763,COSY HOUR GIANT TUBE MATCHES,14,100,0,100,0,1,0
1764,PLACE SETTING WHITE STAR,35,712,16,1700,988,1,32
1765,HYACINTH BULB T-LIGHT CANDLES,22,268,9,1000,732,1,18
1766,S/15 SILVER GLASS BAUBLES IN BAG,10,588,5,600,12,1,10
1767,FRENCH WC SIGN BLUE METAL,27,464,22,2300,1836,1,44
1768,KINGS CHOICE GIANT TUBE MATCHES,15,163,5,600,437,1,10
1769,72 SWEETHEART FAIRY CAKE CASES,7,643,23,2400,1757,1,46
1770,ASSORTED COLOUR BIRD ORNAMENT,3,200,1,200,0,1,2
1771,FAIRY SOAP SOAP HOLDER,34,910,13,1400,490,1,26
1772,GREEN GIANT GARDEN THERMOMETER,35,1465,18,1900,435,1,36
1773,IVORY GIANT GARDEN THERMOMETER,7,969,25,2600,1631,1,50
1774,BLUE GIANT GARDEN THERMOMETER,12,201,2,300,99,1,4
1775,PACK OF 60 PINK PAISLEY CAKE CASES,7,378,4,500,122,1,8
1776,RETROSPOT HEART HOT WATER BOTTLE,6,178,2,300,122,1,4
1777,CHICK GREY HOT WATER BOTTLE,11,1207,18,1900,693,1,36
1778,VICTORIAN SEWING BOX SMALL ,21,1112,14,1500,388,1,28
1779,VICTORIAN SEWING BOX MEDIUM,6,279,17,1800,1521,1,34
1780,SET/10 RED POLKADOT PARTY CANDLES,30,549,23,2400,1851,1,46
1781,WASHROOM METAL SIGN,17,318,13,1400,1082,1,26
1782,BLACK SWEETHEART BRACELET,31,480,4,500,20,1,8
1783,DIAMANTE HAIR GRIP PACK/2 BLACK DIA,17,1431,14,1500,69,1,28
1784,BLACK DIAMANTE EXPANDABLE RING,3,552,9,1000,448,1,18
1785,DIAMANTE HAIR GRIP PACK/2 RUBY,7,1480,18,1900,420,1,36
1786,DIAMANTE HAIR GRIP PACK/2 MONTANA,30,842,8,900,58,1,16
1787,BLUE SWEETHEART BRACELET,7,827,8,900,73,1,16
1788,PINK SWEETHEART BRACELET,30,1675,25,2600,925,1,50
1789,PURPLE SWEETHEART BRACELET,34,100,0,100,0,1,0
1790,JUMBO BAG PINK POLKADOT,15,129,1,200,71,1,2
1791,JUMBO BAG RED RETROSPOT,31,1524,15,1600,76,1,30
1792,ASSORTED COLOUR BIRD ORNAMENT,31,482,7,800,318,1,14
1793,PAPER CHAIN KIT 50'S CHRISTMAS ,26,1689,16,1700,11,1,32
1794,RIBBON REEL CHRISTMAS PRESENT ,34,1351,19,2000,649,1,38
1795,FIRST AID TIN,22,100,0,100,0,1,0
1796,MAKE YOUR OWN MONSOON CARD KIT,17,147,1,200,53,1,2
1797,PACK OF 12 HEARTS DESIGN TISSUES ,1,680,12,1300,620,1,24
1798,PACK OF 12 RED RETROSPOT TISSUES ,9,522,12,1300,778,1,24
1799,SOLDIERS EGG CUP ,8,253,22,2300,2047,1,44
1800,HEART IVORY TRELLIS SMALL,3,452,6,700,248,1,12
1801,HEART FILIGREE DOVE  SMALL,11,257,4,500,243,1,8
1802,HEART FILIGREE DOVE LARGE,7,382,4,500,118,1,8
1803,PACK 3 BOXES BIRD PANNETONE ,10,1842,22,2300,458,1,44
1804,PACK 3 BOXES CHRISTMAS PANNETONE,24,1965,23,2400,435,1,46
1805,SMALL POPCORN HOLDER,19,100,0,100,0,1,0
1806,PACK OF 60 PINK PAISLEY CAKE CASES,21,1909,23,2400,491,1,46
1807,SET OF 6 SOLDIER SKITTLES,31,434,25,2600,2166,1,50
1808,SWIRLY CIRCULAR RUBBERS IN BAG,6,100,0,100,0,1,0
1809,VINTAGE PAISLEY STATIONERY SET,24,455,5,600,145,1,10
1810,PAPER CHAIN KIT VINTAGE CHRISTMAS,33,191,1,200,9,1,2
1811,SET/10 BLUE POLKADOT PARTY CANDLES,15,1097,11,1200,103,1,22
1812,RIBBON REEL SOCKS AND MITTENS,27,630,22,2300,1670,1,44
1813,60 CAKE CASES VINTAGE CHRISTMAS,6,115,1,200,85,1,2
1814,CHRISTMAS METAL TAGS ASSORTED ,4,186,8,900,714,1,16
1815,CHRISTMAS TREE T-LIGHT HOLDER,20,769,7,800,31,1,14
1816,STAR  T-LIGHT HOLDER ,17,866,11,1200,334,1,22
1817,HEART T-LIGHT HOLDER ,16,452,21,2200,1748,1,42
1818,MINI FUNKY DESIGN TAPES,9,975,15,1600,625,1,30
1819,SET OF 6 T-LIGHTS SNOWMEN,23,939,20,2100,1161,1,40
1820,STAR WOODEN CHRISTMAS DECORATION,30,264,2,300,36,1,4
1821,WOODEN HEART CHRISTMAS SCANDINAVIAN,22,432,13,1400,968,1,26
1822,CHRISTMAS RETROSPOT TREE WOOD,6,1651,18,1900,249,1,36
1823,SET OF 6 T-LIGHTS SANTA,6,173,2,300,127,1,4
1824,SET/9 CHRISTMAS T-LIGHTS SCENTED ,35,948,24,2500,1552,1,48
1825,BLUE ROSE FABRIC MIRROR,10,142,6,700,558,1,12
1826,THREE CANVAS LUGGAGE TAGS,22,1328,17,1800,472,1,34
1827,RETROSPOT PARTY BAG + STICKER SET,34,1775,20,2100,325,1,40
1828,PLASTERS IN TIN VINTAGE PAISLEY ,29,710,16,1700,990,1,32
1829,RETROSPOT SMALL TUBE MATCHES,11,978,18,1900,922,1,36
1830,HAND WARMER SCOTTY DOG DESIGN,19,296,6,700,404,1,12
1831,3D CHRISTMAS STAMPS STICKERS ,33,170,7,800,630,1,14
1832,HAND WARMER SCOTTY DOG DESIGN,9,267,3,400,133,1,6
1833,HAND WARMER SCOTTY DOG DESIGN,35,107,6,700,593,1,12
1834,CLOTHES PEGS RETROSPOT PACK 24 ,9,1031,12,1300,269,1,24
1835,36 FOIL HEART CAKE CASES,15,1088,17,1800,712,1,34
1836,CHRISTMAS METAL TAGS ASSORTED ,34,2061,25,2600,539,1,50
1837,PACK OF 6 SWEETIE GIFT BOXES,16,359,14,1500,1141,1,28
1838,PACK OF 72 RETROSPOT CAKE CASES,7,224,5,600,376,1,10
1839,PACK OF 72 RETROSPOT CAKE CASES,18,868,15,1600,732,1,30
1840,PACK OF 6 BIRDY GIFT TAGS,33,2208,23,2400,192,1,46
1841,SET/10 RED POLKADOT PARTY CANDLES,25,1328,17,1800,472,1,34
1842,SET/10 PINK POLKADOT PARTY CANDLES,13,1166,14,1500,334,1,28
1843,SET OF 3 NOTEBOOKS IN PARCEL,17,224,5,600,376,1,10
1844,STAR  T-LIGHT HOLDER ,29,1475,20,2100,625,1,40
1845,CINAMMON SET OF 9 T-LIGHTS,17,1019,13,1400,381,1,26
1846,ORANGE SCENTED SET/9 T-LIGHTS,3,622,6,700,78,1,12
1847,RIBBON REEL STRIPES DESIGN ,19,833,10,1100,267,1,20
1848,SET OF 2 TINS JARDIN DE PROVENCE,28,137,10,1100,963,1,20
1849,MAKE YOUR OWN PLAYTIME CARD KIT,30,651,6,700,49,1,12
1850,DINOSAURS  WRITING SET ,17,1415,20,2100,685,1,40
1851,BALLOONS  WRITING SET ,13,472,7,800,328,1,14
1852,SKULLS WRITING SET ,2,1005,23,2400,1395,1,46
1853,VINTAGE PAISLEY STATIONERY SET,27,807,12,1300,493,1,24
1854,COSY SLIPPER SHOES SMALL  RED ,3,437,25,2600,2163,1,50
1855,DOORMAT BLACK FLOCK ,16,1951,24,2500,549,1,48
1856,JUMBO  BAG BAROQUE BLACK WHITE,31,233,5,600,367,1,10
1857,JAM MAKING SET WITH JARS,33,146,2,300,154,1,4
1858,ORANGE SCENTED SET/9 T-LIGHTS,19,126,1,200,74,1,2
1859,CINAMMON SET OF 9 T-LIGHTS,34,703,12,1300,597,1,24
1860,HAND WARMER SCOTTY DOG DESIGN,17,157,2,300,143,1,4
1861,CHRISTMAS DECOUPAGE CANDLE,2,735,8,900,165,1,16
1862,HEART T-LIGHT HOLDER ,11,625,7,800,175,1,14
1863,GROW YOUR OWN BASIL IN ENAMEL MUG,13,287,22,2300,2013,1,44
1864,OFFICE MUG WARMER POLKADOT,16,140,9,1000,860,1,18
1865,SMALL POPCORN HOLDER,26,107,3,400,293,1,6
1866,JUMBO BAG DOLLY GIRL DESIGN,24,1129,21,2200,1071,1,42
1867,JAM MAKING SET WITH JARS,19,100,0,100,0,1,0
1868,JAM MAKING SET PRINTED,31,1840,25,2600,760,1,50
1869,SMALL GLASS HEART TRINKET POT,9,114,3,400,286,1,6
1870,RED WOOLLY HOTTIE WHITE HEART.,34,225,9,1000,775,1,18
1871,BLACK RECORD COVER FRAME,24,392,6,700,308,1,12
1872,"RECORD FRAME 7"" SINGLE SIZE ",20,1106,19,2000,894,1,38
1873,36 PENCILS TUBE RED RETROSPOT,27,1096,10,1100,4,1,20
1874,36 PENCILS TUBE WOODLAND,35,105,11,1200,1095,1,22
1875,SET OF 6 SOLDIER SKITTLES,20,1112,11,1200,88,1,22
1876,ROCKING HORSE RED CHRISTMAS ,15,134,16,1700,1566,1,32
1877,CHRISTMAS GINGHAM HEART,28,686,20,2100,1414,1,40
1878,CHRISTMAS GINGHAM STAR,10,808,14,1500,692,1,28
1879,HAND WARMER UNION JACK,28,115,2,300,185,1,4
1880,HAND WARMER RED RETROSPOT,6,419,5,600,181,1,10
1881,REGENCY CAKESTAND 3 TIER,15,885,8,900,15,1,16
1882,JUMBO SHOPPER VINTAGE RED PAISLEY,14,640,12,1300,660,1,24
1883,RIBBON REEL SNOWY VILLAGE,33,1810,21,2200,390,1,42
1884,VINTAGE UNION JACK BUNTING,7,1214,20,2100,886,1,40
1885,JAM MAKING SET WITH JARS,3,799,10,1100,301,1,20
1886,RIBBON REEL STRIPES DESIGN ,26,1283,22,2300,1017,1,44
1887,RETRO LONGBOARD IRONING BOARD COVER,20,1471,14,1500,29,1,28
1888,3D DOG PICTURE PLAYING CARDS,6,144,1,200,56,1,2
1889,RETROSPOT CIGAR BOX MATCHES ,20,689,15,1600,911,1,30
1890,SET/9 CHRISTMAS T-LIGHTS SCENTED ,28,822,12,1300,478,1,24
1891,ROTATING SILVER ANGELS T-LIGHT HLDR,25,896,8,900,4,1,16
1892,ROTATING SILVER ANGELS T-LIGHT HLDR,4,258,22,2300,2042,1,44
1893,SAVE THE PLANET COTTON TOTE BAG,1,1636,20,2100,464,1,40
1894,SET OF 20 VINTAGE CHRISTMAS NAPKINS,34,236,3,400,164,1,6
1895,PAPER BUNTING WHITE LACE,11,778,17,1800,1022,1,34
1896,GENTLEMAN SHIRT REPAIR KIT ,8,783,16,1700,917,1,32
1897,CARD I LOVE LONDON ,17,248,5,600,352,1,10
1898,PAPER CHAIN KIT VINTAGE CHRISTMAS,14,624,6,700,76,1,12
1899,MIRRORED WALL ART FOXY,15,106,6,700,594,1,12
1900,MIRRORED WALL ART GENTS,7,116,11,1200,1084,1,22
1901,AIRLINE BAG VINTAGE JET SET WHITE,5,1486,14,1500,14,1,28
1902,JAM MAKING SET PRINTED,14,308,7,800,492,1,14
1903,POTTING SHED SOW 'N' GROW SET,20,800,21,2200,1400,1,42
1904,BABUSHKA LIGHTS STRING OF 10,27,297,4,500,203,1,8
1905,REX CASH+CARRY JUMBO SHOPPER,12,534,5,600,66,1,10
1906,AIRLINE BAG VINTAGE WORLD CHAMPION ,15,603,10,1100,497,1,20
1907,HAND WARMER BIRD DESIGN,23,1460,18,1900,440,1,36
1908,CHRISTMAS CRAFT LITTLE FRIENDS,32,237,11,1200,963,1,22
1909,PINK HEARTS PAPER GARLAND,18,1802,18,1900,98,1,36
1910,POTTING SHED SEED ENVELOPES,19,1132,15,1600,468,1,30
1911,HI TEC ALPINE HAND WARMER,5,324,17,1800,1476,1,34
1912,FELTCRAFT CHRISTMAS FAIRY,5,1483,23,2400,917,1,46
1913,HI TEC ALPINE HAND WARMER,31,1597,22,2300,703,1,44
1914,ROTATING SILVER ANGELS T-LIGHT HLDR,14,115,4,500,385,1,8
1915,3 STRIPEY MICE FELTCRAFT,11,804,8,900,96,1,16
1916,FELTCRAFT 6 FLOWER FRIENDS,5,1438,22,2300,862,1,44
1917,CHRISTMAS CRAFT LITTLE FRIENDS,23,1091,13,1400,309,1,26
1918,VINTAGE UNION JACK CUSHION COVER,29,269,7,800,531,1,14
1919,POLYESTER FILLER PAD 45x45cm,17,332,20,2100,1768,1,40
1920,DOLLY GIRL LUNCH BOX,23,189,7,800,611,1,14
1921,PACK OF 12 LONDON TISSUES ,28,947,22,2300,1353,1,44
1922,CARD DOLLY GIRL ,22,102,3,400,298,1,6
1923,CARD BILLBOARD FONT,24,1770,22,2300,530,1,44
1924,RAINY LADIES BIRTHDAY CARD,31,2289,23,2400,111,1,46
1925,GREY HEART HOT WATER BOTTLE,18,1325,16,1700,375,1,32
1926,RED WOOLLY HOTTIE WHITE HEART.,1,699,7,800,101,1,14
1927,RED WHITE SCARF  HOT WATER BOTTLE,9,737,14,1500,763,1,28
1928, SET 2 TEA TOWELS I LOVE LONDON ,16,357,20,2100,1743,1,40
1929,SET OF 2 TEA TOWELS APPLE AND PEARS,16,233,14,1500,1267,1,28
1930,SET/2 RED RETROSPOT TEA TOWELS ,3,106,16,1700,1594,1,32
1931,LOVE BUILDING BLOCK WORD,31,1265,16,1700,435,1,32
1932,HOME BUILDING BLOCK WORD,20,676,18,1900,1224,1,36
1933,ASSORTED COLOUR BIRD ORNAMENT,23,1343,17,1800,457,1,34
1934,LANTERN CREAM GAZEBO ,20,1099,25,2600,1501,1,50
1935,BLUE BIRDHOUSE DECORATION,2,1961,22,2300,339,1,44
1936,WHITE HANGING HEART T-LIGHT HOLDER,7,167,3,400,233,1,6
1937,REGENCY CAKESTAND 3 TIER,25,281,15,1600,1319,1,30
1938,ANTIQUE SILVER TEA GLASS ENGRAVED,4,800,21,2200,1400,1,42
1939,AGED GLASS SILVER T-LIGHT HOLDER,1,1458,25,2600,1142,1,50
1940,JAM MAKING SET WITH JARS,18,100,0,100,0,1,0
1941,HAND WARMER OWL DESIGN,19,881,15,1600,719,1,30
1942,SET OF 2 WOODEN MARKET CRATES,2,1419,18,1900,481,1,36
1943,SET OF 6 T-LIGHTS TOADSTOOLS,10,195,2,300,105,1,4
1944,HAND WARMER UNION JACK,29,664,23,2400,1736,1,46
1945,HAND WARMER SCOTTY DOG DESIGN,14,327,5,600,273,1,10
1946,CLASSIC FRENCH STYLE BASKET NATURAL,9,247,12,1300,1053,1,24
1947,CRAZY DAISY HEART DECORATION,25,481,21,2200,1719,1,42
1948,GIN + TONIC DIET METAL SIGN,28,1401,20,2100,699,1,40
1949,IVORY GIANT GARDEN THERMOMETER,15,107,2,300,193,1,4
1950,CARD HOLDER GINGHAM HEART,14,230,21,2200,1970,1,42
1951,SMALL STRIPES CHOCOLATE GIFT BAG ,26,281,20,2100,1819,1,40
1952,S/6 WOODEN SKITTLES IN COTTON BAG,11,407,7,800,393,1,14
1953,HAND WARMER RED RETROSPOT,16,216,9,1000,784,1,18
1954,HAND WARMER UNION JACK,26,989,11,1200,211,1,22
1955,FRENCH WC SIGN BLUE METAL,6,126,2,300,174,1,4
1956,PINK UNION JACK  LUGGAGE TAG,9,616,25,2600,1984,1,50
1957,"TRAY, BREAKFAST IN BED",17,1575,19,2000,425,1,38
1958,PIZZA PLATE IN BOX,30,563,15,1600,1037,1,30
1959,HEART OF WICKER LARGE,1,153,2,300,147,1,4
1960,PINK HEART DOTS HOT WATER BOTTLE,34,1646,24,2500,854,1,48
1961,PLACE SETTING WHITE HEART,19,454,7,800,346,1,14
1962,SET OF 4 NAPKIN CHARMS LEAVES   ,32,523,17,1800,1277,1,34
1963,SET OF 4 NAPKIN CHARMS STARS   ,17,2125,25,2600,475,1,50
1964,SET OF 4 NAPKIN CHARMS CUTLERY,10,893,25,2600,1707,1,50
1965,CARAVAN SQUARE TISSUE BOX,25,696,9,1000,304,1,18
1966,PLASTERS IN TIN SKULLS,29,847,23,2400,1553,1,46
1967,PLASTERS IN TIN SPACEBOY,22,1073,13,1400,327,1,26
1968,BUTTON BOX ,11,1183,19,2000,817,1,38
1969,PLASTERS IN TIN VINTAGE PAISLEY ,14,239,2,300,61,1,4
1970,12 MESSAGE CARDS WITH ENVELOPES,32,597,7,800,203,1,14
1971,SMALL RED BABUSHKA NOTEBOOK ,22,442,5,600,158,1,10
1972,CUPCAKE LACE PAPER SET 6,17,245,15,1600,1355,1,30
1973,PACK 3 BOXES CHRISTMAS PANNETONE,7,1778,17,1800,22,1,34
1974,HERB MARKER MINT,30,100,0,100,0,1,0
1975,HERB MARKER ROSEMARY,4,100,0,100,0,1,0
1976,HERB MARKER BASIL,6,116,12,1300,1184,1,24
1977,HERB MARKER CHIVES ,26,405,11,1200,795,1,22
1978,HERB MARKER PARSLEY,33,568,8,900,332,1,16
1979,HERB MARKER THYME,27,187,1,200,13,1,2
1980,WHITE HANGING HEART T-LIGHT HOLDER,25,100,0,100,0,1,0
1981,METAL MERRY CHRISTMAS WREATH,24,176,1,200,24,1,2
1982,WHITE CHRISTMAS GARLAND STARS TREES,27,456,13,1400,944,1,26
1983,RETROSPOT SMALL TUBE MATCHES,14,146,7,800,654,1,14
1984,RETROSPOT GIANT TUBE MATCHES,34,288,2,300,12,1,4
1985,PLACE SETTING WHITE STAR,26,482,5,600,118,1,10
1986,GROW YOUR OWN BASIL IN ENAMEL MUG,29,371,12,1300,929,1,24
1987,36 FOIL STAR CAKE CASES ,12,1792,25,2600,808,1,50
1988,36 FOIL HEART CAKE CASES,33,193,7,800,607,1,14
1989,PACK OF 6 SWEETIE GIFT BOXES,9,1302,15,1600,298,1,30
1990,PACK OF 6 HANDBAG GIFT BOXES,17,451,6,700,249,1,12
1991,GARLAND WOODEN HAPPY EASTER,17,1118,12,1300,182,1,24
1992,CALENDAR PAPER CUT DESIGN,21,672,11,1200,528,1,22
1993,CALENDAR IN SEASON DESIGN,14,254,22,2300,2046,1,44
1994,SMALL POPCORN HOLDER,8,896,9,1000,104,1,18
1995,BLUE PAISLEY TISSUE BOX,34,686,11,1200,514,1,22
1996,HEART OF WICKER SMALL,16,2447,25,2600,153,1,50
1997,SKULLS SQUARE TISSUE BOX,9,521,24,2500,1979,1,48
1998,SKULLS SQUARE TISSUE BOX,15,430,4,500,70,1,8
1999,WHITE HANGING HEART T-LIGHT HOLDER,5,692,10,1100,408,1,20
2000,WHITE METAL LANTERN,9,1521,25,2600,1079,1,50
2001,CREAM CUPID HEARTS COAT HANGER,1,106,8,900,794,1,16
2002,KNITTED UNION FLAG HOT WATER BOTTLE,4,284,18,1900,1616,1,36
2003,RED WOOLLY HOTTIE WHITE HEART.,10,396,10,1100,704,1,20
2004,SET 7 BABUSHKA NESTING BOXES,4,100,0,100,0,1,0
2005,GLASS STAR FROSTED T-LIGHT HOLDER,7,179,2,300,121,1,4
2006,HAND WARMER UNION JACK,1,2571,25,2600,29,1,50
2007,HAND WARMER RED POLKA DOT,4,669,12,1300,631,1,24
2008,ASSORTED COLOUR BIRD ORNAMENT,9,100,0,100,0,1,0
2009,POPPY'S PLAYHOUSE BEDROOM ,8,337,10,1100,763,1,20
2010,POPPY'S PLAYHOUSE KITCHEN,4,2132,22,2300,168,1,44
2011,FELTCRAFT PRINCESS CHARLOTTE DOLL,9,224,16,1700,1476,1,32
2012,IVORY KNITTED MUG COSY ,10,2554,25,2600,46,1,50
2013,BOX OF 6 ASSORTED COLOUR TEASPOONS,9,194,1,200,6,1,2
2014,BOX OF VINTAGE JIGSAW BLOCKS ,6,1633,20,2100,467,1,40
2015,BOX OF VINTAGE ALPHABET BLOCKS,6,259,5,600,341,1,10
2016,HOME BUILDING BLOCK WORD,7,1087,10,1100,13,1,20
2017,LOVE BUILDING BLOCK WORD,7,213,7,800,587,1,14
2018,RECIPE BOX WITH METAL HEART,7,335,3,400,65,1,6
2019,DOORMAT NEW ENGLAND,10,1284,13,1400,116,1,26
2020,JAM MAKING SET WITH JARS,3,474,17,1800,1326,1,34
2021,RED COAT RACK PARIS FASHION,3,923,9,1000,77,1,18
2022,YELLOW COAT RACK PARIS FASHION,5,423,21,2200,1777,1,42
2023,BLUE COAT RACK PARIS FASHION,3,932,15,1600,668,1,30
2024,BATH BUILDING BLOCK WORD,5,228,2,300,72,1,4
2025,ALARM CLOCK BAKELIKE PINK,1,559,16,1700,1141,1,32
2026,ALARM CLOCK BAKELIKE RED ,6,405,6,700,295,1,12
2027,ALARM CLOCK BAKELIKE GREEN,8,745,22,2300,1555,1,44
2028,PANDA AND BUNNIES STICKER SHEET,9,208,4,500,292,1,8
2029,STARS GIFT TAPE ,6,1138,13,1400,262,1,26
2030,INFLATABLE POLITICAL GLOBE ,5,201,24,2500,2299,1,48
2031,VINTAGE HEADS AND TAILS CARD GAME ,6,486,4,500,14,1,8
2032,SET/2 RED RETROSPOT TEA TOWELS ,1,597,23,2400,1803,1,46
2033,ROUND SNACK BOXES SET OF4 WOODLAND ,9,1575,19,2000,425,1,38
2034,SPACEBOY LUNCH BOX ,2,204,4,500,296,1,8
2035,LUNCH BOX I LOVE LONDON,4,505,5,600,95,1,10
2036,CIRCUS PARADE LUNCH BOX ,6,1250,21,2200,950,1,42
2037,CHARLOTTE BAG DOLLY GIRL DESIGN,4,175,8,900,725,1,16
2038,RED TOADSTOOL LED NIGHT LIGHT,5,392,16,1700,1308,1,32
2039, SET 2 TEA TOWELS I LOVE LONDON ,1,1480,17,1800,320,1,34
2040,VINTAGE SEASIDE JIGSAW PUZZLES,8,109,7,800,691,1,14
2041,MINI JIGSAW CIRCUS PARADE ,5,904,17,1800,896,1,34
2042,MINI JIGSAW SPACEBOY,1,1944,23,2400,456,1,46
2043,MINI PAINT SET VINTAGE ,10,128,1,200,72,1,2
2044,POSTAGE,5,179,2,300,121,1,4
2045,PAPER CHAIN KIT 50'S CHRISTMAS ,4,283,5,600,317,1,10
2046,HAND WARMER RED POLKA DOT,6,384,3,400,16,1,6
2047,HAND WARMER UNION JACK,10,591,9,1000,409,1,18
2048,WHITE HANGING HEART T-LIGHT HOLDER,8,202,23,2400,2198,1,46
2049,WHITE METAL LANTERN,7,696,25,2600,1904,1,50
2050,CREAM CUPID HEARTS COAT HANGER,7,963,24,2500,1537,1,48
2051,EDWARDIAN PARASOL RED,9,515,7,800,285,1,14
2052,RETRO COFFEE MUGS ASSORTED,8,2205,25,2600,395,1,50
2053,SAVE THE PLANET MUG,9,681,15,1600,919,1,30
2054,VINTAGE BILLBOARD DRINK ME MUG,4,560,19,2000,1440,1,38
2055,VINTAGE BILLBOARD LOVE/HATE MUG,10,1560,16,1700,140,1,32
2056,WOOD 2 DRAWER CABINET WHITE FINISH,3,1627,22,2300,673,1,44
2057,WOOD S/3 CABINET ANT WHITE FINISH,6,576,15,1600,1024,1,30
2058,WOODEN PICTURE FRAME WHITE FINISH,1,111,22,2300,2189,1,44
2059,WOODEN FRAME ANTIQUE WHITE ,6,533,5,600,67,1,10
2060,KNITTED UNION FLAG HOT WATER BOTTLE,9,344,3,400,56,1,6
2061,RED WOOLLY HOTTIE WHITE HEART.,3,1033,23,2400,1367,1,46
2062,SET 7 BABUSHKA NESTING BOXES,7,840,15,1600,760,1,30
2063,GLASS STAR FROSTED T-LIGHT HOLDER,9,444,13,1400,956,1,26
2064,VICTORIAN SEWING BOX LARGE,8,426,9,1000,574,1,18
2065,WHITE HANGING HEART T-LIGHT HOLDER,2,667,18,1900,1233,1,36
2066,WHITE METAL LANTERN,6,363,4,500,137,1,8
2067,CREAM CUPID HEARTS COAT HANGER,4,114,11,1200,1086,1,22
2068,EDWARDIAN PARASOL RED,9,232,10,1100,868,1,20
2069,RETRO COFFEE MUGS ASSORTED,7,1326,24,2500,1174,1,48
2070,SAVE THE PLANET MUG,5,100,0,100,0,1,0
2071,VINTAGE BILLBOARD DRINK ME MUG,3,143,8,900,757,1,16
2072,VINTAGE BILLBOARD LOVE/HATE MUG,7,1466,17,1800,334,1,34
2073,WOOD 2 DRAWER CABINET WHITE FINISH,9,809,10,1100,291,1,20
2074,WOOD S/3 CABINET ANT WHITE FINISH,9,755,11,1200,445,1,22
2075,WOODEN PICTURE FRAME WHITE FINISH,4,539,6,700,161,1,12
2076,WOODEN FRAME ANTIQUE WHITE ,10,848,11,1200,352,1,22
2077,KNITTED UNION FLAG HOT WATER BOTTLE,4,215,8,900,685,1,16
2078,RED WOOLLY HOTTIE WHITE HEART.,8,202,5,600,398,1,10
2079,SET 7 BABUSHKA NESTING BOXES,5,1083,24,2500,1417,1,48
2080,GLASS STAR FROSTED T-LIGHT HOLDER,6,759,8,900,141,1,16
2081,HOT WATER BOTTLE TEA AND SYMPATHY,6,1066,21,2200,1134,1,42
2082,RED HANGING HEART T-LIGHT HOLDER,7,1067,11,1200,133,1,22
2083,HAND WARMER RED POLKA DOT,3,364,10,1100,736,1,20
2084,HAND WARMER UNION JACK,3,409,17,1800,1391,1,34
2085,JUMBO BAG PINK POLKADOT,3,435,10,1100,665,1,20
2086,JUMBO  BAG BAROQUE BLACK WHITE,8,208,2,300,92,1,4
2087,JUMBO BAG CHARLIE AND LOLA TOYS,8,160,2,300,140,1,4
2088,STRAWBERRY CHARLOTTE BAG,10,100,0,100,0,1,0
2089,RED 3 PIECE RETROSPOT CUTLERY SET,1,1034,23,2400,1366,1,46
2090,BLUE 3 PIECE POLKADOT CUTLERY SET,3,434,6,700,266,1,12
2091,SET/6 RED SPOTTY PAPER PLATES,5,305,10,1100,795,1,20
2092,LUNCH BAG RED RETROSPOT,10,609,10,1100,491,1,20
2093,STRAWBERRY LUNCH BOX WITH CUTLERY,9,1172,13,1400,228,1,26
2094,LUNCH BOX WITH CUTLERY RETROSPOT ,9,1393,14,1500,107,1,28
2095,PACK OF 72 RETROSPOT CAKE CASES,9,1497,17,1800,303,1,34
2096,PACK OF 60 DINOSAUR CAKE CASES,2,281,9,1000,719,1,18
2097,PACK OF 60 PINK PAISLEY CAKE CASES,10,163,2,300,137,1,4
2098,61 TEATIME FAIRY CAKE CASES,2,1159,14,1500,341,1,28
2099,TOMATO CHARLIE+LOLA COASTER SET,2,1252,16,1700,448,1,32
2100,CHARLIE & LOLA WASTEPAPER BIN FLORA,8,890,23,2400,1510,1,46
2101,RED CHARLIE+LOLA PERSONAL DOORSIGN,2,289,5,600,311,1,10
2102,JUMBO STORAGE BAG SUKI,10,728,8,900,172,1,16
2103,JUMBO BAG PINK VINTAGE PAISLEY,4,2026,21,2200,174,1,42
2104,JAM MAKING SET PRINTED,3,444,15,1600,1156,1,30
2105,RETROSPOT TEA SET CERAMIC 11 PC ,3,169,2,300,131,1,4
2106,GIRLY PINK TOOL SET,6,1180,14,1500,320,1,28
2107,JUMBO SHOPPER VINTAGE RED PAISLEY,3,919,15,1600,681,1,30
2108,"AIRLINE LOUNGE,METAL SIGN",5,1945,24,2500,555,1,48
2109,WHITE SPOT RED CERAMIC DRAWER KNOB,10,487,13,1400,913,1,26
2110,RED DRAWER KNOB ACRYLIC EDWARDIAN,9,529,20,2100,1571,1,40
2111,CLEAR DRAWER KNOB ACRYLIC EDWARDIAN,2,758,15,1600,842,1,30
2112,PHOTO CLIP LINE,4,1110,18,1900,790,1,36
2113,FELT EGG COSY CHICKEN,1,167,22,2300,2133,1,44
2114,PIGGY BANK RETROSPOT ,2,1799,24,2500,701,1,48
2115,SKULL SHOULDER BAG,6,230,12,1300,1070,1,24
2116,YOU'RE CONFUSING ME METAL SIGN ,1,601,11,1200,599,1,22
2117,COOK WITH WINE METAL SIGN ,5,101,1,200,99,1,2
2118,GIN + TONIC DIET METAL SIGN,1,344,3,400,56,1,6
2119,YELLOW BREAKFAST CUP AND SAUCER,2,1442,22,2300,858,1,44
2120,PINK BREAKFAST CUP AND SAUCER ,5,789,7,800,11,1,14
2121,PAPER CHAIN KIT 50'S CHRISTMAS ,10,1719,24,2500,781,1,48
2122,PAPER CHAIN KIT RETROSPOT,9,556,25,2600,2044,1,50
2123,SMALL HEART FLOWERS HOOK ,8,438,4,500,62,1,8
2124,PHOTO CLIP LINE,6,538,6,700,162,1,12
2125,TEA TIME DES TEA COSY,8,462,7,800,338,1,14
2126,FELT EGG COSY WHITE RABBIT ,5,144,14,1500,1356,1,28
2127,ZINC WILLIE WINKIE  CANDLE STICK,10,1892,23,2400,508,1,46
2128,CERAMIC CHERRY CAKE MONEY BANK,9,876,18,1900,1024,1,36
2129,RETROSPOT LARGE MILK JUG,7,1340,21,2200,860,1,42
2130,SET OF 6 FUNKY BEAKERS,4,491,7,800,309,1,14
2131,EDWARDIAN PARASOL BLACK,10,1091,16,1700,609,1,32
2132,EDWARDIAN PARASOL NATURAL,5,312,9,1000,688,1,18
2133,CERAMIC STRAWBERRY CAKE MONEY BANK,3,1078,18,1900,822,1,36
2134,BLUE OWL SOFT TOY,3,426,10,1100,674,1,20
2135,BALLOON ART MAKE YOUR OWN FLOWERS,8,232,7,800,568,1,14
2136,RED TOADSTOOL LED NIGHT LIGHT,2,1006,12,1300,294,1,24
2137,GLASS CLOCHE SMALL,6,1704,25,2600,896,1,50
2138,GUMBALL MONOCHROME COAT RACK,8,174,5,600,426,1,10
2139,DOORMAT FANCY FONT HOME SWEET HOME,6,130,15,1600,1470,1,30
2140,Discount,10,701,11,1200,499,1,22
2141,INFLATABLE POLITICAL GLOBE ,5,162,9,1000,838,1,18
2142,VINTAGE SNAKES & LADDERS,2,851,23,2400,1549,1,46
2143,CHOCOLATE CALCULATOR,7,1410,18,1900,490,1,36
2144,JUMBO SHOPPER VINTAGE RED PAISLEY,1,1280,25,2600,1320,1,50
2145,RECYCLING BAG RETROSPOT ,3,478,24,2500,2022,1,48
2146,TOY TIDY PINK POLKADOT,8,128,8,900,772,1,16
2147,ANTIQUE GLASS DRESSING TABLE POT,2,446,4,500,54,1,8
2148,ALARM CLOCK BAKELIKE GREEN,8,868,12,1300,432,1,24
2149,IVORY GIANT GARDEN THERMOMETER,2,756,22,2300,1544,1,44
2150,4 TIER CAKE TIN GREEN AND CREAM,4,1893,23,2400,507,1,46
2151,4 TIER CAKE TIN RED AND CREAM,6,166,1,200,34,1,2
2152,SET 3 WICKER OVAL BASKETS W LIDS,7,114,1,200,86,1,2
2153,SET OF 3 COLOURED  FLYING DUCKS,8,214,8,900,686,1,16
2154,WOOD BLACK BOARD ANT WHITE FINISH,7,623,9,1000,377,1,18
2155,COLOUR GLASS T-LIGHT HOLDER HANGING,3,134,19,2000,1866,1,38
2156,HANGING METAL HEART LANTERN,8,828,16,1700,872,1,32
2157,HANGING MEDINA LANTERN SMALL,3,1393,13,1400,7,1,26
2158,NATURAL SLATE HEART CHALKBOARD ,8,100,0,100,0,1,0
2159,HEART OF WICKER SMALL,9,215,2,300,85,1,4
2160,HEART OF WICKER LARGE,6,1628,16,1700,72,1,32
2161,WHITE LOVEBIRD LANTERN,1,476,25,2600,2124,1,50
2162,CLASSIC METAL BIRDCAGE PLANT HOLDER,2,513,19,2000,1487,1,38
2163,CREAM HEART CARD HOLDER,3,861,19,2000,1139,1,38
2164,ENAMEL FLOWER JUG CREAM,5,380,4,500,120,1,8
2165,ENAMEL FIRE BUCKET CREAM,10,455,18,1900,1445,1,36
2166,ENAMEL BREAD BIN CREAM,2,1156,22,2300,1144,1,44
2167,SET 3 WICKER OVAL BASKETS W LIDS,5,970,20,2100,1130,1,40
2168,JAM MAKING SET PRINTED,3,1138,20,2100,962,1,40
2169,JAM MAKING SET WITH JARS,8,1453,21,2200,747,1,42
2170,JUMBO BAG DOLLY GIRL DESIGN,9,2127,24,2500,373,1,48
2171,TRADITIONAL CHRISTMAS RIBBONS,6,615,25,2600,1985,1,50
2172,ORGANISER WOOD ANTIQUE WHITE ,1,381,15,1600,1219,1,30
2173,LUNCH BAG DOLLY GIRL DESIGN,4,112,16,1700,1588,1,32
2174,WHITE WIRE EGG HOLDER,5,838,24,2500,1662,1,48
2175,JUMBO  BAG BAROQUE BLACK WHITE,5,137,10,1100,963,1,20
2176,JUMBO BAG RED RETROSPOT,10,1420,24,2500,1080,1,48
2177,CHILLI LIGHTS,3,331,3,400,69,1,6
2178,LIGHT GARLAND BUTTERFILES PINK,8,553,7,800,247,1,14
2179,WOODEN OWLS LIGHT GARLAND ,8,854,15,1600,746,1,30
2180,FAIRY TALE COTTAGE NIGHTLIGHT,4,951,19,2000,1049,1,38
2181,RED TOADSTOOL LED NIGHT LIGHT,6,583,7,800,217,1,14
2182,HOME BUILDING BLOCK WORD,9,137,1,200,63,1,2
2183,LOVE BUILDING BLOCK WORD,7,110,4,500,390,1,8
2184,DOORMAT FANCY FONT HOME SWEET HOME,7,342,6,700,358,1,12
2185,HOME SMALL WOOD LETTERS,1,100,0,100,0,1,0
2186,GINGHAM HEART  DOORSTOP RED,8,115,8,900,785,1,16
2187,FIVE HEART HANGING DECORATION,10,1323,19,2000,677,1,38
2188,HANGING METAL HEART LANTERN,10,250,2,300,50,1,4
2189,ASSORTED BOTTLE TOP  MAGNETS ,5,170,17,1800,1630,1,34
2190,FRIDGE MAGNETS US DINER ASSORTED,3,925,19,2000,1075,1,38
2191,HOMEMADE JAM SCENTED CANDLES,7,147,1,200,53,1,2
2192,FRIDGE MAGNETS LES ENFANTS ASSORTED,6,287,2,300,13,1,4
2193,ROSE CARAVAN DOORSTOP,2,519,16,1700,1181,1,32
2194,HEART OF WICKER SMALL,1,171,18,1900,1729,1,36
2195,6 HOOK HANGER MAGIC TOADSTOOL,3,181,5,600,419,1,10
2196,CHRISTMAS LIGHTS 10 REINDEER,2,627,8,900,273,1,16
2197,VINTAGE UNION JACK CUSHION COVER,8,619,13,1400,781,1,26
2198,VINTAGE HEADS AND TAILS CARD GAME ,4,100,0,100,0,1,0
2199,SET OF 3 COLOURED  FLYING DUCKS,5,152,2,300,148,1,4
2200,SET OF 3 GOLD FLYING DUCKS,1,593,11,1200,607,1,22
2201,RED RETROSPOT UMBRELLA,4,1148,17,1800,652,1,34
2202,BLACK/BLUE POLKADOT UMBRELLA,1,100,5,600,500,1,10
2203,RED DINER WALL CLOCK,2,160,7,800,640,1,14
2204,ALARM CLOCK BAKELIKE GREEN,7,1088,23,2400,1312,1,46
2205,ALARM CLOCK BAKELIKE RED ,6,466,10,1100,634,1,20
2206,BLUE DINER WALL CLOCK,9,111,5,600,489,1,10
2207,IVORY DINER WALL CLOCK,2,331,18,1900,1569,1,36
2208,LARGE HEART MEASURING SPOONS,10,1300,16,1700,400,1,32
2209,SMALL HEART MEASURING SPOONS,5,364,9,1000,636,1,18
2210,CHRISTMAS LIGHTS 10 REINDEER,4,684,14,1500,816,1,28
2211,JAM MAKING SET WITH JARS,9,383,12,1300,917,1,24
2212,JAM MAKING SET PRINTED,3,471,7,800,329,1,14
2213,JAM JAR WITH PINK LID,5,556,25,2600,2044,1,50
2214,JAM JAR WITH GREEN LID,9,210,2,300,90,1,4
2215,ROSE COTTAGE KEEPSAKE BOX ,5,1239,12,1300,61,1,24
2216,HANGING HEART ZINC T-LIGHT HOLDER,10,167,4,500,333,1,8
2217,PAPER CHAIN KIT VINTAGE CHRISTMAS,6,113,1,200,87,1,2
2218,DISCO BALL CHRISTMAS DECORATION,5,100,0,100,0,1,0
2219,WHITE HANGING HEART T-LIGHT HOLDER,10,625,20,2100,1475,1,40
2220,SMALL POPCORN HOLDER,10,390,23,2400,2010,1,46
2221,LARGE POPCORN HOLDER ,3,412,5,600,188,1,10
2222,RETROSPOT LARGE MILK JUG,10,291,8,900,609,1,16
2223,SET/20 RED RETROSPOT PAPER NAPKINS ,4,1623,23,2400,777,1,46
2224,SET/6 RED SPOTTY PAPER PLATES,5,633,9,1000,367,1,18
2225,SET/6 RED SPOTTY PAPER CUPS,6,732,16,1700,968,1,32
2226,POLKADOT RAIN HAT ,1,1719,21,2200,481,1,42
2227,DELUXE SEWING KIT ,8,2258,22,2300,42,1,44
2228,RETROSPOT HEART HOT WATER BOTTLE,9,116,2,300,184,1,4
2229,KNITTED UNION FLAG HOT WATER BOTTLE,1,111,1,200,89,1,2
2230,ENGLISH ROSE HOT WATER BOTTLE,9,100,0,100,0,1,0
2231,PHOTO CUBE,3,697,16,1700,1003,1,32
2232,HOMEMADE JAM SCENTED CANDLES,4,1915,19,2000,85,1,38
2233,JUMBO BAG RED RETROSPOT,8,271,25,2600,2329,1,50
2234,PLASTERS IN TIN CIRCUS PARADE ,3,1524,17,1800,276,1,34
2235,PACK OF 12 PINK PAISLEY TISSUES ,3,374,12,1300,926,1,24
2236,PACK OF 12 BLUE PAISLEY TISSUES ,10,100,0,100,0,1,0
2237,PACK OF 12 RED RETROSPOT TISSUES ,9,1691,19,2000,309,1,38
2238,CHICK GREY HOT WATER BOTTLE,4,427,21,2200,1773,1,42
2239,PLASTERS IN TIN VINTAGE PAISLEY ,4,225,10,1100,875,1,20
2240,PLASTERS IN TIN SKULLS,3,1636,25,2600,964,1,50
2241,4 STRIPEY MICE FELTCRAFT,8,275,23,2400,2125,1,46
2242,SET OF 6 SOLDIER SKITTLES,4,390,21,2200,1810,1,42
2243,TRADITIONAL WOODEN SKIPPING ROPE,3,1006,11,1200,194,1,22
2244,WOODEN BOX OF DOMINOES,3,1280,15,1600,320,1,30
2245,RUSTIC  SEVENTEEN DRAWER SIDEBOARD,5,257,9,1000,743,1,18
2246,PARTY CONES CARNIVAL ASSORTED,8,1069,14,1500,431,1,28
2247,PARTY CONES CANDY ASSORTED,2,833,22,2300,1467,1,44
2248,PICNIC BASKET WICKER SMALL,8,1192,11,1200,8,1,22
2249,ASSORTED COLOUR BIRD ORNAMENT,3,1500,14,1500,0,1,28
2250,STAR DECORATION PAINTED ZINC ,4,477,24,2500,2023,1,48
2251,RETROSPOT LAMP,5,415,7,800,385,1,14
2252,"FANCY FONT BIRTHDAY CARD, ",2,424,4,500,76,1,8
2253,HAND WARMER UNION JACK,1,190,1,200,10,1,2
2254,HAND WARMER SCOTTY DOG DESIGN,1,282,3,400,118,1,6
2255,HAND WARMER OWL DESIGN,7,1045,14,1500,455,1,28
2256,HAND WARMER RED RETROSPOT,6,742,11,1200,458,1,22
2257,RETROSPOT HEART HOT WATER BOTTLE,5,757,10,1100,343,1,20
2258,DOG BOWL CHASING BALL DESIGN,6,1061,10,1100,39,1,20
2259,CLOTHES PEGS RETROSPOT PACK 25,2,169,1,200,31,1,2
2260,HAND OVER THE CHOCOLATE   SIGN ,5,732,11,1200,468,1,22
2261,WHITE HANGING HEART T-LIGHT HOLDER,2,112,22,2300,2188,1,44
2262,TRAVEL SEWING KIT,8,724,9,1000,276,1,18
2263,BLACK HEART CARD HOLDER,3,597,9,1000,403,1,18
2264,ASSORTED COLOUR BIRD ORNAMENT,7,450,10,1100,650,1,20
2265,PACK OF 60 PINK PAISLEY CAKE CASES,2,2318,25,2600,282,1,50
2266,61 TEATIME FAIRY CAKE CASES,7,178,2,300,122,1,4
2267,PACK OF 72 RETROSPOT CAKE CASES,8,524,23,2400,1876,1,46
2268,CHICK GREY HOT WATER BOTTLE,4,788,22,2300,1512,1,44
2269,SMALL GLASS HEART TRINKET POT,4,475,10,1100,625,1,20
2270,ALARM CLOCK BAKELIKE IVORY,9,190,8,900,710,1,16
2271,ALARM CLOCK BAKELIKE RED ,9,201,6,700,499,1,12
2272,ALARM CLOCK BAKELIKE ORANGE,3,108,12,1300,1192,1,24
2273,ALARM CLOCK BAKELIKE GREEN,8,897,19,2000,1103,1,38
2274,HOT WATER BOTTLE TEA AND SYMPATHY,2,294,7,800,506,1,14
2275,HAND WARMER BIRD DESIGN,2,111,1,200,89,1,2
2276,HAND WARMER SCOTTY DOG DESIGN,1,2294,23,2400,106,1,46
2277,WHITE HANGING HEART T-LIGHT HOLDER,8,2045,20,2100,55,1,40
2278,WHITE METAL LANTERN,7,627,6,700,73,1,12
2279,CREAM CUPID HEARTS COAT HANGER,9,1881,18,1900,19,1,36
2280,EDWARDIAN PARASOL BLACK,5,1694,20,2100,406,1,40
2281,EDWARDIAN PARASOL RED,4,100,0,100,0,1,0
2282,RETRO COFFEE MUGS ASSORTED,7,1539,25,2600,1061,1,50
2283,SAVE THE PLANET MUG,6,356,6,700,344,1,12
2284,VINTAGE BILLBOARD DRINK ME MUG,1,375,3,400,25,1,6
2285,VINTAGE BILLBOARD LOVE/HATE MUG,2,1410,15,1600,190,1,30
2286,WOOD 2 DRAWER CABINET WHITE FINISH,4,954,22,2300,1346,1,44
2287,WOOD S/3 CABINET ANT WHITE FINISH,4,105,17,1800,1695,1,34
2288,WOODEN PICTURE FRAME WHITE FINISH,2,138,5,600,462,1,10
2289,WOODEN FRAME ANTIQUE WHITE ,10,1090,14,1500,410,1,28
2290,KNITTED UNION FLAG HOT WATER BOTTLE,7,1244,15,1600,356,1,30
2291,RED WOOLLY HOTTIE WHITE HEART.,6,305,21,2200,1895,1,42
2292,SET 7 BABUSHKA NESTING BOXES,9,290,8,900,610,1,16
2293,IVORY EMBROIDERED QUILT ,3,707,16,1700,993,1,32
2294,GLASS STAR FROSTED T-LIGHT HOLDER,2,449,17,1800,1351,1,34
2295,SET OF 3 BLACK FLYING DUCKS,9,175,1,200,25,1,2
2296,SET OF 3 COLOURED  FLYING DUCKS,7,282,4,500,218,1,8
2297,PACK OF 12 RED RETROSPOT TISSUES ,4,544,9,1000,456,1,18
2298,RED RETROSPOT MUG,7,127,8,900,773,1,16
2299,BABUSHKA LIGHTS STRING OF 11,4,1349,15,1600,251,1,30
2300,PIGGY BANK RETROSPOT ,1,1558,23,2400,842,1,46
2301,SET 7 BABUSHKA NESTING BOXES,2,539,14,1500,961,1,28
2302,DOORMAT FAIRY CAKE,4,960,12,1300,340,1,24
2303,HAND WARMER RED RETROSPOT,3,1013,10,1100,87,1,20
2304,HAND WARMER SCOTTY DOG DESIGN,9,1011,24,2500,1489,1,48
2305,HAND WARMER OWL DESIGN,5,435,5,600,165,1,10
2306,STRAWBERRY CERAMIC TRINKET BOX,1,795,8,900,105,1,16
2307,PINK DOUGHNUT TRINKET POT ,10,543,6,700,157,1,12
2308,SILK PURSE BABUSHKA PINK,8,100,0,100,0,1,0
2309,HOT WATER BOTTLE TEA AND SYMPATHY,2,2030,20,2100,70,1,40
2310,HOT WATER BOTTLE I AM SO POORLY,7,243,2,300,57,1,4
2311,CHOCOLATE HOT WATER BOTTLE,7,119,21,2200,2081,1,42
2312,WHITE SKULL HOT WATER BOTTLE ,5,942,10,1100,158,1,20
2313,SCOTTIE DOG HOT WATER BOTTLE,9,583,23,2400,1817,1,46
2314,HAND WARMER RED POLKA DOT,1,368,13,1400,1032,1,26
2315,HAND WARMER UNION JACK,5,210,7,800,590,1,14
2316,HOMEMADE JAM SCENTED CANDLES,4,2045,20,2100,55,1,40
2317,BIRD HOUSE HOT WATER BOTTLE,7,711,14,1500,789,1,28
2318,BOUDOIR SQUARE TISSUE BOX,5,205,2,300,95,1,4
2319,SKULLS SQUARE TISSUE BOX,1,122,4,500,378,1,8
2320,PHOTO FRAME CORNICE,4,386,9,1000,614,1,18
2321,SILK PURSE BABUSHKA RED,1,2232,24,2500,268,1,48
2322,PICTURE DOMINOES,5,388,3,400,12,1,6
2323,S/6 SEW ON CROCHET FLOWERS,4,526,10,1100,574,1,20
2324,SCANDINAVIAN REDS RIBBONS,5,100,0,100,0,1,0
2325,BALLOONS  WRITING SET ,1,100,0,100,0,1,0
2326,JAM MAKING SET PRINTED,8,1249,23,2400,1151,1,46
2327,LAVENDER INCENSE IN TIN,10,453,6,700,247,1,12
2328,TV DINNER TRAY VINTAGE PAISLEY,7,679,10,1100,421,1,20
2329,SET OF 4 ENGLISH ROSE PLACEMATS,1,424,20,2100,1676,1,40
2330,SET OF 4 ENGLISH ROSE COASTERS,2,175,23,2400,2225,1,46
2331,TRIPLE PHOTO FRAME CORNICE ,10,1884,20,2100,216,1,40
2332,FAMILY PHOTO FRAME CORNICE,6,1031,18,1900,869,1,36
2333,MIRRORED DISCO BALL ,4,133,1,200,67,1,2
2334,DISCO BALL ROTATOR BATTERY OPERATED,3,549,21,2200,1651,1,42
2335,SILVER LOOKING MIRROR,10,417,5,600,183,1,10
2336,LADIES & GENTLEMEN METAL SIGN,5,1355,24,2500,1145,1,48
2337,METAL SIGN HER DINNER IS SERVED ,3,188,1,200,12,1,2
2338,YOU'RE CONFUSING ME METAL SIGN ,6,891,8,900,9,1,16
2339,DOORMAT TOPIARY,3,2004,20,2100,96,1,40
2340,BATHROOM METAL SIGN,3,754,8,900,146,1,16
2341,KITCHEN METAL SIGN,3,144,1,200,56,1,2
2342,TOILET METAL SIGN,6,786,8,900,114,1,16
2343,METAL SIGN TAKE IT OR LEAVE IT ,5,379,9,1000,621,1,18
2344,I'M ON HOLIDAY METAL SIGN,7,335,7,800,465,1,14
2345,GROW YOUR OWN BASIL IN ENAMEL MUG,5,143,16,1700,1557,1,32
2346,SET/10 PINK POLKADOT PARTY CANDLES,2,200,1,200,0,1,2
2347,SET 20 NAPKINS FAIRY CAKES DESIGN ,3,1630,16,1700,70,1,32
2348,61 TEATIME FAIRY CAKE CASES,6,854,12,1300,446,1,24
2349,SET OF 6 T-LIGHTS SNOWMEN,4,333,14,1500,1167,1,28
2350,SET OF 6 T-LIGHTS SANTA,10,404,4,500,96,1,8
2351,SET OF 9 HEART SHAPED BALLOONS,4,418,4,500,82,1,8
2352,SANDWICH BATH SPONGE,9,387,7,800,413,1,14
2353,APPLE BATH SPONGE,3,247,17,1800,1553,1,34
2354,STRAWBERRY BATH SPONGE ,10,877,9,1000,123,1,18
2355,BLACK PIRATE TREASURE CHEST,8,1012,24,2500,1488,1,48
2356,STAR PORTABLE TABLE LIGHT ,8,170,1,200,30,1,2
2357,SNOWFLAKE PORTABLE TABLE LIGHT ,7,100,0,100,0,1,0
2358,PINK OVAL JEWELLED MIRROR,4,1361,17,1800,439,1,34
2359,RETROSPOT CIGAR BOX MATCHES ,9,947,19,2000,1053,1,38
2360,COSY HOUR GIANT TUBE MATCHES,6,798,18,1900,1102,1,36
2361,JAZZ HEARTS PURSE NOTEBOOK,7,155,9,1000,845,1,18
2362,LUNCH BAG DOLLY GIRL DESIGN,3,1257,25,2600,1343,1,50
2363,WHITE HANGING HEART T-LIGHT HOLDER,1,798,10,1100,302,1,20
2364,CANDLEHOLDER PINK HANGING HEART,5,241,5,600,359,1,10
2365,WOOD 2 DRAWER CABINET WHITE FINISH,9,922,14,1500,578,1,28
2366,ASSORTED COLOUR MINI CASES,1,158,17,1800,1642,1,34
2367,LUNCH BAG RED RETROSPOT,8,396,6,700,304,1,12
2368,LUNCH BAG SPACEBOY DESIGN ,8,307,24,2500,2193,1,48
2369,LUNCH BAG WOODLAND,6,700,20,2100,1400,1,40
2370,LUNCH BAG PINK POLKADOT,1,395,21,2200,1805,1,42
2371,GUMBALL COAT RACK,5,1360,19,2000,640,1,38
2372,BLUE NEW BAROQUE CANDLESTICK CANDLE,9,353,5,600,247,1,10
2373,PINK NEW BAROQUECANDLESTICK CANDLE,7,939,15,1600,661,1,30
2374,FAIRY CAKE FLANNEL ASSORTED COLOUR,10,395,5,600,205,1,10
2375,BREAD BIN DINER STYLE PINK,5,124,1,200,76,1,2
2376,JUMBO BAG CHARLIE AND LOLA TOYS,8,260,5,600,340,1,10
2377,TEA TIME TABLE CLOTH,6,566,5,600,34,1,10
2378,ENGLISH ROSE HOT WATER BOTTLE,5,368,17,1800,1432,1,34
2379,ENAMEL FIRE BUCKET CREAM,3,235,16,1700,1465,1,32
2380,PICNIC BASKET WICKER SMALL,8,263,3,400,137,1,6
2381,PAPER CHAIN KIT 50'S CHRISTMAS ,5,1245,14,1500,255,1,28
2382,PAPER CHAIN KIT VINTAGE CHRISTMAS,8,325,5,600,275,1,10
2383,HOT WATER BOTTLE BABUSHKA ,8,368,6,700,332,1,12
2384,HAND WARMER BIRD DESIGN,2,1587,22,2300,713,1,44
2385,POSTAGE,4,100,0,100,0,1,0
2386,HEART IVORY TRELLIS SMALL,7,975,15,1600,625,1,30
2387,CLEAR DRAWER KNOB ACRYLIC EDWARDIAN,8,342,20,2100,1758,1,40
2388,PINK DRAWER KNOB ACRYLIC EDWARDIAN,6,100,0,100,0,1,0
2389,GREEN DRAWER KNOB ACRYLIC EDWARDIAN,5,742,23,2400,1658,1,46
2390,BLUE DRAWER KNOB ACRYLIC EDWARDIAN,1,1029,11,1200,171,1,22
2391,HEART OF WICKER SMALL,6,635,20,2100,1465,1,40
2392,SMALL POPCORN HOLDER,8,126,3,400,274,1,6
2393,SET 6 FOOTBALL CELEBRATION CANDLES,1,333,14,1500,1167,1,28
2394,SET OF 6 GIRLS CELEBRATION CANDLES,1,509,6,700,191,1,12
2395,ROMANTIC PINKS RIBBONS ,7,1288,14,1500,212,1,28
2396,BRIGHT BLUES RIBBONS ,9,197,1,200,3,1,2
2397,SCANDINAVIAN REDS RIBBONS,8,1386,14,1500,114,1,28
2398,CHOCOLATE BOX RIBBONS ,2,415,15,1600,1185,1,30
2399,PARTY INVITES FOOTBALL,2,2161,23,2400,239,1,46
2400,PARTY INVITES JAZZ HEARTS,6,1315,15,1600,285,1,30
2401,PARTY INVITES SPACEMAN,4,705,9,1000,295,1,18
2402,SET OF 3 BUTTERFLY COOKIE CUTTERS,3,831,8,900,69,1,16
2403,SET OF 3 HEART COOKIE CUTTERS,8,1406,19,2000,594,1,38
2404,4 PIECE SPACEBOY COOKIE CUTTER SET,3,2179,24,2500,321,1,48
2405,PACK OF 72 SKULL CAKE CASES,2,537,23,2400,1863,1,46
2406,PACK OF 60 SPACEBOY CAKE CASES,1,2240,25,2600,360,1,50
2407,PACK OF 72 RETROSPOT CAKE CASES,1,678,12,1300,622,1,24
2408,73 SWEETHEART FAIRY CAKE CASES,1,1372,18,1900,528,1,36
2409,PACK OF 60 DINOSAUR CAKE CASES,4,768,16,1700,932,1,32
2410,LUNCH BAG SUKI  DESIGN ,3,235,5,600,365,1,10
2411,LUNCH BAG CARS BLUE,5,710,11,1200,490,1,22
2412,LUNCH BAG  BLACK SKULL.,3,679,7,800,121,1,14
2413,HEART IVORY TRELLIS LARGE,5,784,17,1800,1016,1,34
2414,SET/5 RED RETROSPOT LID GLASS BOWLS,9,365,25,2600,2235,1,50
2415,WHITE HANGING HEART T-LIGHT HOLDER,9,1950,23,2400,450,1,46
2416,WHITE METAL LANTERN,5,172,2,300,128,1,4
2417,CREAM CUPID HEARTS COAT HANGER,6,1229,12,1300,71,1,24
2418,EDWARDIAN PARASOL RED,5,755,13,1400,645,1,26
2419,RETRO COFFEE MUGS ASSORTED,2,271,23,2400,2129,1,46
2420,SAVE THE PLANET MUG,2,552,22,2300,1748,1,44
2421,VINTAGE BILLBOARD DRINK ME MUG,6,1273,20,2100,827,1,40
2422,VINTAGE BILLBOARD LOVE/HATE MUG,8,796,22,2300,1504,1,44
2423,WOOD 2 DRAWER CABINET WHITE FINISH,2,205,10,1100,895,1,20
2424,WOOD S/3 CABINET ANT WHITE FINISH,7,226,2,300,74,1,4
2425,WOODEN PICTURE FRAME WHITE FINISH,8,443,4,500,57,1,8
2426,WOODEN FRAME ANTIQUE WHITE ,8,545,24,2500,1955,1,48
2427,KNITTED UNION FLAG HOT WATER BOTTLE,8,762,18,1900,1138,1,36
2428,RED WOOLLY HOTTIE WHITE HEART.,2,366,5,600,234,1,10
2429,SET 7 BABUSHKA NESTING BOXES,5,406,8,900,494,1,16
2430,IVORY EMBROIDERED QUILT ,8,1301,13,1400,99,1,26
2431,GLASS STAR FROSTED T-LIGHT HOLDER,8,623,6,700,77,1,12
2432,HAND WARMER RED POLKA DOT,10,743,21,2200,1457,1,42
2433,HAND WARMER UNION JACK,9,691,6,700,9,1,12
2434,MAGIC DRAWING SLATE DINOSAUR,6,1575,23,2400,825,1,46
2435,MAGIC DRAWING SLATE BAKE A CAKE ,4,1724,17,1800,76,1,34
2436,13 PENCILS TALL TUBE SKULLS,1,344,7,800,456,1,14
2437,CHOCOLATE CALCULATOR,1,2356,24,2500,144,1,48
2438,RED  HARMONICA IN BOX ,7,106,17,1800,1694,1,34
2439,BLUE HARMONICA IN BOX ,3,224,5,600,376,1,10
2440,SKULLS  WATER TRANSFER TATTOOS ,5,549,19,2000,1451,1,38
2441,PACK 3 BOXES BIRD PANNETONE ,5,1054,23,2400,1346,1,46
2442,HOT WATER BOTTLE TEA AND SYMPATHY,6,436,12,1300,864,1,24
2443,RED WOOLLY HOTTIE WHITE HEART.,5,559,24,2500,1941,1,48
2444,WHITE SKULL HOT WATER BOTTLE ,9,175,2,300,125,1,4
2445,4 PIECE SPACEBOY COOKIE CUTTER SET,5,785,11,1200,415,1,22
2446,SET OF 20 KIDS COOKIE CUTTERS,4,1356,20,2100,744,1,40
2447,11 COLOUR SPACEBOY PEN,9,125,4,500,375,1,8
2448,VICTORIAN GLASS HANGING T-LIGHT,9,142,1,200,58,1,2
2449,SINGLE HEART ZINC T-LIGHT HOLDER,6,282,6,700,418,1,12
2450,RED HANGING HEART T-LIGHT HOLDER,2,131,22,2300,2169,1,44
2451,HANGING METAL STAR LANTERN,5,412,4,500,88,1,8
2452,SILVER HANGING T-LIGHT HOLDER,10,266,4,500,234,1,8
2453,DOORMAT RED RETROSPOT,1,756,12,1300,544,1,24
2454,DOORMAT HEARTS,2,639,21,2200,1561,1,42
2455,NATURAL SLATE RECTANGLE CHALKBOARD,7,391,4,500,109,1,8
2456,LOVEBIRD HANGING DECORATION WHITE ,5,1457,22,2300,843,1,44
2457,ASSORTED COLOUR BIRD ORNAMENT,5,1261,15,1600,339,1,30
2458,HOME BUILDING BLOCK WORD,9,814,13,1400,586,1,26
2459,LOVE BUILDING BLOCK WORD,5,954,24,2500,1546,1,48
2460,PHOTO FRAME CORNICE,4,262,18,1900,1638,1,36
2461,PENS ASSORTED FUNNY FACE,9,1921,25,2600,679,1,50
2462,CARD CIRCUS PARADE,7,991,12,1300,309,1,24
2463,WRAP COWBOYS  ,9,156,1,200,44,1,2
2464,AIRLINE BAG VINTAGE TOKYO 79,7,570,22,2300,1730,1,44
2465,RED RETROSPOT UMBRELLA,3,1794,21,2200,406,1,42
2466,BLACK/BLUE POLKADOT UMBRELLA,10,111,10,1100,989,1,20
2467,RED 3 PIECE RETROSPOT CUTLERY SET,10,764,8,900,136,1,16
2468,PACK OF 72 RETROSPOT CAKE CASES,5,199,12,1300,1101,1,24
2469,SET OF 72 RETROSPOT PAPER  DOILIES,9,100,7,800,700,1,14
2470,BLUE COAT RACK PARIS FASHION,10,1628,18,1900,272,1,36
2471,PLASTERS IN TIN SKULLS,10,2246,23,2400,154,1,46
2472,SLEEPING CAT ERASERS,1,488,11,1200,712,1,22
2473,CARD BIRTHDAY COWBOY,10,128,22,2300,2172,1,44
2474,PACK 3 BOXES CHRISTMAS PANNETONE,2,1990,21,2200,210,1,42
2475,ROTATING SILVER ANGELS T-LIGHT HLDR,9,213,16,1700,1487,1,32
2476,COSY HOUR GIANT TUBE MATCHES,7,785,13,1400,615,1,26
2477,RIBBON REEL MAKING SNOWMEN ,2,162,21,2200,2038,1,42
2478,MINI PAINT SET VINTAGE ,3,428,5,600,172,1,10
2479,5 TRADITIONAL SPINNING TOPS,3,380,8,900,520,1,16
2480,SET OF 6 SOLDIER SKITTLES,6,566,11,1200,634,1,22
2481,BAG 500g SWIRLY MARBLES,2,2117,21,2200,83,1,42
2482,6 STRAND GLASS NECKLACE CRYSTAL,4,613,23,2400,1787,1,46
2483,WHITE SKULL HOT WATER BOTTLE ,10,1423,20,2100,677,1,40
2484,SCOTTIE DOG HOT WATER BOTTLE,2,534,9,1000,466,1,18
2485,SQUARECUSHION COVER PINK UNION FLAG,3,100,0,100,0,1,0
2486,SPACEBOY CHILDRENS EGG CUP,3,1570,18,1900,330,1,36
2487,CHILDREN'S SPACEBOY MUG,8,1867,22,2300,433,1,44
2488,HAND WARMER SCOTTY DOG DESIGN,4,385,10,1100,715,1,20
2489,FELTCRAFT CUSHION OWL,8,1892,20,2100,208,1,40
2490,BLACK CANDELABRA T-LIGHT HOLDER,6,124,11,1200,1076,1,22
2491,TOY TIDY DOLLY GIRL DESIGN,2,437,5,600,163,1,10
2492,SET 12 LAVENDER  BOTANICAL T-LIGHTS,6,1578,18,1900,322,1,36
2493,UNION JACK FLAG LUGGAGE TAG,4,100,0,100,0,1,0
2494,RED HEART LUGGAGE TAG,9,100,0,100,0,1,0
2495,RED GLASS TASSLE BAG CHARM,4,159,19,2000,1841,1,38
2496,CLEAR ACRYLIC FACETED BANGLE,5,244,15,1600,1356,1,30
2497,6 STRAND GLASS NECKLACE CRYSTAL,3,967,20,2100,1133,1,40
2498,DOORMAT UNION JACK GUNS AND ROSES,7,791,15,1600,809,1,30
2499,VANILLA SCENT CANDLE JEWELLED BOX,5,191,17,1800,1609,1,34
2500,FULL ENGLISH BREAKFAST PLATE,8,922,22,2300,1378,1,44
2501,BLACK CANDELABRA T-LIGHT HOLDER,3,708,8,900,192,1,16
2502,MAGIC DRAWING SLATE CIRCUS PARADE  ,7,380,9,1000,620,1,18
2503,CHRISTMAS HANGING HEART WITH BELL,2,209,6,700,491,1,12
2504,CAKE STAND VICTORIAN FILIGREE MED,3,1123,21,2200,1077,1,42
2505,PAISLEY PATTERN  STICKERS,5,1392,19,2000,608,1,38
2506,FLOWERS  STICKERS,1,1470,19,2000,530,1,38
2507,PINK NEW BAROQUECANDLESTICK CANDLE,4,638,19,2000,1362,1,38
2508,BLUE NEW BAROQUE CANDLESTICK CANDLE,6,794,13,1400,606,1,26
2509,JUMBO STORAGE BAG SUKI,10,2382,24,2500,118,1,48
2510,BLACK LOVE BIRD CANDLE,6,1492,24,2500,1008,1,48
2511,PARTY TIME PENCIL ERASERS,8,366,7,800,434,1,14
2512,DISCO BALL CHRISTMAS DECORATION,5,1182,24,2500,1318,1,48
2513,PINK B'FLY C/COVER W BOBBLES,7,370,4,500,130,1,8
2514,PINK UNION JACK  LUGGAGE TAG,6,1275,16,1700,425,1,32
2515,7 RIBBONS ELEGANT CHRISTMAS ,5,378,3,400,22,1,6
2516,UNION JACK FLAG LUGGAGE TAG,8,247,4,500,253,1,8
2517,AGED GLASS SILVER T-LIGHT HOLDER,10,1556,18,1900,344,1,36
2518,BOOM BOX SPEAKER GIRLS,9,1270,23,2400,1130,1,46
2519,7 RIBBONS SHIMMERING PINKS ,6,2016,25,2600,584,1,50
2520, SET 2 TEA TOWELS I LOVE LONDON ,6,220,13,1400,1180,1,26
2521,JUMBO BAG OWLS,4,100,0,100,0,1,0
2522,SANDWICH BATH SPONGE,2,294,11,1200,906,1,22
2523,OWL DOORSTOP,8,929,14,1500,571,1,28
2524,6 STRAND GLASS NECKLACE CRYSTAL,3,1763,18,1900,137,1,36
2525,HAND WARMER UNION JACK,9,148,12,1300,1152,1,24
2526,HAND WARMER SCOTTY DOG DESIGN,5,139,1,200,61,1,2
2527,LARGE POPCORN HOLDER ,7,168,3,400,232,1,6
2528,PAINTED METAL STAR WITH HOLLY BELLS,4,1846,21,2200,354,1,42
2529,PAINTED METAL HEART WITH HOLLY BELL,4,323,13,1400,1077,1,26
2530,ANGEL DECORATION STARS ON DRESS,4,225,9,1000,775,1,18
2531,SMALL POPCORN HOLDER,3,224,18,1900,1676,1,36
2532,JUMBO BAG RED RETROSPOT,2,176,3,400,224,1,6
2533,JUMBO BAG STRAWBERRY,7,161,16,1700,1539,1,32
2534,STRAWBERRY SHOPPER BAG,9,691,6,700,9,1,12
2535,STRAWBERRY CHARLOTTE BAG,7,100,0,100,0,1,0
2536, SET 2 TEA TOWELS I LOVE LONDON ,1,178,3,400,222,1,6
2537,PACK OF 12 RED RETROSPOT TISSUES ,6,1357,15,1600,243,1,30
2538,SCOTTIE DOG HOT WATER BOTTLE,8,473,23,2400,1927,1,46
2539,CHOCOLATE HOT WATER BOTTLE,9,892,22,2300,1408,1,44
2540,LUNCH BAG CARS BLUE,1,155,2,300,145,1,4
2541,LUNCH BAG SPACEBOY DESIGN ,8,363,4,500,137,1,8
2542,ROUND SNACK BOXES SET OF4 WOODLAND ,10,376,8,900,524,1,16
2543,LUNCH BAG DOLLY GIRL DESIGN,9,312,8,900,588,1,16
2544,LUNCH BAG SUKI  DESIGN ,8,100,0,100,0,1,0
2545,LUNCH BAG  BLACK SKULL.,3,100,0,100,0,1,0
2546,ROUND SNACK BOXES SET OF 4 FRUITS ,6,408,5,600,192,1,10
2547,ROUND SNACK BOXES SET OF 4 SKULLS,2,1069,17,1800,731,1,34
2548,DOLLY GIRL LUNCH BOX,3,1624,16,1700,76,1,32
2549,SPACEBOY LUNCH BOX ,6,323,10,1100,777,1,20
2550,GREEN POLKADOT PLATE ,2,1286,12,1300,14,1,24
2551,BLUE POLKADOT PLATE ,9,1876,24,2500,624,1,48
2552,RED RETROSPOT PLATE ,8,486,5,600,114,1,10
2553,PINK  POLKADOT PLATE ,5,1122,13,1400,278,1,26
2554,ROUND SNACK BOXES SET OF 4 SKULLS,10,939,12,1300,361,1,24
2555,FELTCRAFT DOLL MOLLY,7,104,6,700,596,1,12
2556,FELTCRAFT CHRISTMAS FAIRY,6,1306,24,2500,1194,1,48
2557,TRAVEL SEWING KIT,6,1154,17,1800,646,1,34
2558,SET OF 3 NOTEBOOKS IN PARCEL,9,1932,21,2200,268,1,42
2559,RED RETROSPOT TAPE,7,1755,25,2600,845,1,50
2560,COSY SLIPPER SHOES SMALL  RED ,10,112,2,300,188,1,4
2561,7 RIBBONS RUSTIC CHARM,5,180,3,400,220,1,6
2562,SCANDINAVIAN REDS RIBBONS,10,166,9,1000,834,1,18
2563,JAM MAKING SET PRINTED,2,1026,11,1200,174,1,22
2564,13 DAISY PEGS IN WOOD BOX,3,138,3,400,262,1,6
2565,HOT WATER BOTTLE BABUSHKA ,1,125,11,1200,1075,1,22
2566,FELTCRAFT PRINCESS CHARLOTTE DOLL,8,762,16,1700,938,1,32
2567,FELTCRAFT CHRISTMAS FAIRY,4,274,2,300,26,1,4
2568,FELTCRAFT PRINCESS CHARLOTTE DOLL,2,1513,16,1700,187,1,32
2569,7 RIBBONS RUSTIC CHARM,4,152,1,200,48,1,2
2570,COSY SLIPPER SHOES SMALL  RED ,2,1388,14,1500,112,1,28
2571,SCANDINAVIAN REDS RIBBONS,2,486,8,900,414,1,16
2572,6 HOOK HANGER RED MAGIC TOADSTOOL,3,263,13,1400,1137,1,26
2573,CHRISTMAS CRAFT TREE TOP ANGEL,9,230,3,400,170,1,6
2574,CHRISTMAS CRAFT LITTLE FRIENDS,5,194,2,300,106,1,4
2575,6 HOOK HANGER RED MAGIC TOADSTOOL,9,110,7,800,690,1,14
2576,7 RIBBONS RUSTIC CHARM,8,1413,18,1900,487,1,36
2577,13 DAISY PEGS IN WOOD BOX,6,182,15,1600,1418,1,30
2578,SET OF 3 NOTEBOOKS IN PARCEL,5,141,1,200,59,1,2
2579,6 HOOK HANGER MAGIC TOADSTOOL,10,449,6,700,251,1,12
2580,SCANDINAVIAN REDS RIBBONS,10,1112,21,2200,1088,1,42
2581,RED TOADSTOOL LED NIGHT LIGHT,7,161,3,400,239,1,6
2582,6 HOOK HANGER RED MAGIC TOADSTOOL,7,217,8,900,683,1,16
2583,COSY SLIPPER SHOES SMALL GREEN,7,570,6,700,130,1,12
2584,COSY SLIPPER SHOES SMALL  RED ,9,114,1,200,86,1,2
2585,FELTCRAFT DOLL ROSIE,1,1013,11,1200,187,1,22
2586,FELTCRAFT DOLL MOLLY,1,467,12,1300,833,1,24
2587,FELTCRAFT DOLL EMILY,5,173,1,200,27,1,2
2588,FELTCRAFT PRINCESS CHARLOTTE DOLL,8,1182,16,1700,518,1,32
2589,FELTCRAFT PRINCESS OLIVIA DOLL,2,847,20,2100,1253,1,40
2590,REX CASH+CARRY JUMBO SHOPPER,7,505,14,1500,995,1,28
2591,FELTCRAFT DOLL MOLLY,5,481,14,1500,1019,1,28
2592,FELTCRAFT CUSHION OWL,7,100,0,100,0,1,0
2593,CHRISTMAS CRAFT TREE TOP ANGEL,9,1238,24,2500,1262,1,48
2594,CHRISTMAS CRAFT LITTLE FRIENDS,8,964,14,1500,536,1,28
2595,FELTCRAFT CUSHION RABBIT,2,972,17,1800,828,1,34
2596,FELTCRAFT CUSHION BUTTERFLY,3,151,3,400,249,1,6
2597,13 DAISY PEGS IN WOOD BOX,7,266,9,1000,734,1,18
2598,PAPER CHAIN KIT 50'S CHRISTMAS ,7,1212,13,1400,188,1,26
2599,FELTCRAFT CUSHION BUTTERFLY,5,1895,19,2000,105,1,38
2600,13 DAISY PEGS IN WOOD BOX,6,412,21,2200,1788,1,42
2601,ROSE COTTAGE KEEPSAKE BOX ,8,845,8,900,55,1,16
2602,TOTE BAG I LOVE LONDON,1,642,13,1400,758,1,26
2603,13 DAISY PEGS IN WOOD BOX,7,511,10,1100,589,1,20
2604,TOTE BAG I LOVE LONDON,3,2042,23,2400,358,1,46
2605,FOLDING UMBRELLA PINKWHITE POLKADOT,3,477,19,2000,1523,1,38
2606,FOLDING UMBRELLA CREAM POLKADOT,1,596,5,600,4,1,10
2607,FOLDING UMBRELLA WHITE/RED POLKADOT,4,706,18,1900,1194,1,36
2608,SET 10 LIGHTS NIGHT OWL,5,554,24,2500,1946,1,48
2609,SMALL POPCORN HOLDER,6,389,13,1400,1011,1,26
2610, SET 2 TEA TOWELS I LOVE LONDON ,8,488,4,500,12,1,8
2611,FOLDING UMBRELLA RED/WHITE POLKADOT,1,1486,17,1800,314,1,34
2612,BABUSHKA LIGHTS STRING OF 11,5,983,16,1700,717,1,32
2613,LUNCH BAG RED RETROSPOT,7,1444,24,2500,1056,1,48
2614,S/4 VALENTINE DECOUPAGE HEART BOX,3,1503,19,2000,497,1,38
2615,FOLDING UMBRELLA CREAM POLKADOT,6,1542,23,2400,858,1,46
2616, SET 2 TEA TOWELS I LOVE LONDON ,6,943,10,1100,157,1,20
2617,FOLDING UMBRELLA RED/WHITE POLKADOT,10,648,16,1700,1052,1,32
2618,SOLDIERS EGG CUP ,8,1640,20,2100,460,1,40
2619,S/4 VALENTINE DECOUPAGE HEART BOX,1,154,3,400,246,1,6
2620,RED RETROSPOT MINI CASES,7,1532,21,2200,668,1,42
2621,,6,406,23,2400,1994,1,46
2622,61 CAKE CASES VINTAGE CHRISTMAS,8,1527,15,1600,73,1,30
2623,PAPER CHAIN KIT VINTAGE CHRISTMAS,9,1660,24,2500,840,1,48
2624,RIBBON REEL CHRISTMAS SOCK BAUBLE,6,262,3,400,138,1,6
2625,RIBBON REEL SNOWY VILLAGE,5,622,7,800,178,1,14
2626,RIBBON REEL MAKING SNOWMEN ,5,599,6,700,101,1,12
2627,SET OF 20 VINTAGE CHRISTMAS NAPKINS,5,916,10,1100,184,1,20
2628,TURQUOISE CHRISTMAS TREE ,4,583,7,800,217,1,14
2629,RED STAR CARD HOLDER,10,533,11,1200,667,1,22
2630,WICKER WREATH SMALL,4,159,1,200,41,1,2
2631,HEART OF WICKER LARGE,2,459,25,2600,2141,1,50
2632,ADVENT CALENDAR GINGHAM SACK,5,100,0,100,0,1,0
2633,HEART OF WICKER SMALL,6,1364,25,2600,1236,1,50
2634,FELTCRAFT BUTTERFLY HEARTS,6,1186,19,2000,814,1,38
2635,PARTY CONE CHRISTMAS DECORATION ,10,161,14,1500,1339,1,28
2636,VINTAGE HEADS AND TAILS CARD GAME ,10,563,15,1600,1037,1,30
2637,WICKER STAR ,3,875,11,1200,325,1,22
2638,VINTAGE SNAP CARDS,9,504,5,600,96,1,10
2639,FELTCRAFT 6 FLOWER FRIENDS,5,565,10,1100,535,1,20
2640, SET 2 TEA TOWELS I LOVE LONDON ,10,1091,25,2600,1509,1,50
2641,JAM MAKING SET PRINTED,9,537,11,1200,663,1,22
2642,BIRD DECORATION RED RETROSPOT,6,157,21,2200,2043,1,42
2643,CHRISTMAS GINGHAM TREE,7,195,4,500,305,1,8
2644,CHRISTMAS GINGHAM STAR,8,1543,20,2100,557,1,40
2645,CHRISTMAS GINGHAM HEART,9,1862,22,2300,438,1,44
2646,PACK OF 12 PINK POLKADOT TISSUES,7,809,20,2100,1291,1,40
2647,FELTCRAFT PRINCESS LOLA DOLL,4,100,0,100,0,1,0
2648,PACK OF 12 LONDON TISSUES ,9,143,1,200,57,1,2
2649,PURPLE DRAWERKNOB ACRYLIC EDWARDIAN,7,616,7,800,184,1,14
2650,CHILDREN'S APRON DOLLY GIRL ,4,223,11,1200,977,1,22
2651,CHILDRENS APRON SPACEBOY DESIGN,1,760,7,800,40,1,14
2652,CHRISTMAS LIGHTS 10 SANTAS ,9,172,1,200,28,1,2
2653,CHRISTMAS LIGHTS 10 REINDEER,6,136,9,1000,864,1,18
2654,PAPER CHAIN KIT 50'S CHRISTMAS ,3,977,12,1300,323,1,24
2655,FELTCRAFT CHRISTMAS FAIRY,5,2186,25,2600,414,1,50
2656,PACK OF 72 RETROSPOT CAKE CASES,3,525,23,2400,1875,1,46
2657,PACK OF 60 MUSHROOM CAKE CASES,4,572,5,600,28,1,10
2658,61 CAKE CASES DOLLY GIRL DESIGN,3,1403,24,2500,1097,1,48
2659,PACK OF 60 PINK PAISLEY CAKE CASES,5,291,22,2300,2009,1,44
2660,HAND WARMER BABUSHKA DESIGN,10,100,0,100,0,1,0
2661,HAND WARMER BIRD DESIGN,5,907,19,2000,1093,1,38
2662,HAND WARMER OWL DESIGN,5,1545,20,2100,555,1,40
2663,HAND WARMER RED RETROSPOT,7,100,0,100,0,1,0
2664,SET 12 RETRO WHITE CHALK STICKS,10,728,15,1600,872,1,30
2665,FELTCRAFT HAIRBAND RED AND BLUE,7,743,16,1700,957,1,32
2666,FELTCRAFT HAIRBAND PINK AND PURPLE,1,352,9,1000,648,1,18
2667,FELTCRAFT HAIRBANDS PINK AND WHITE ,6,110,4,500,390,1,8
2668,TV DINNER TRAY DOLLY GIRL,10,243,20,2100,1857,1,40
2669,PLASTERS IN TIN VINTAGE PAISLEY ,4,762,13,1400,638,1,26
2670,PLASTERS IN TIN SPACEBOY,8,429,4,500,71,1,8
2671,PLASTERS IN TIN WOODLAND ANIMALS,10,453,8,900,447,1,16
2672,MAGIC DRAWING SLATE SPACEBOY ,6,100,0,100,0,1,0
2673,MAGIC DRAWING SLATE CIRCUS PARADE  ,1,238,24,2500,2262,1,48
2674,MAGIC DRAWING SLATE GO TO THE FAIR ,8,478,11,1200,722,1,22
2675,MAGIC DRAWING SLATE DOLLY GIRL ,9,1014,11,1200,186,1,22
2676,CHARLIE + LOLA RED HOT WATER BOTTLE,10,277,11,1200,923,1,22
2677,HOT WATER BOTTLE BABUSHKA ,2,187,17,1800,1613,1,34
2678,URBAN BLACK RIBBONS ,8,400,14,1500,1100,1,28
2679,FELTCRAFT PRINCESS CHARLOTTE DOLL,8,331,8,900,569,1,16
2680,SET OF 6 T-LIGHTS TOADSTOOLS,10,868,20,2100,1232,1,40
2681,ROTATING LEAVES T-LIGHT HOLDER,3,1165,15,1600,435,1,30
2682,RED  HARMONICA IN BOX ,5,482,9,1000,518,1,18
2683,CUPCAKE LACE PAPER SET 7,1,1128,12,1300,172,1,24
2684,FAMILY PHOTO FRAME CORNICE,5,1542,18,1900,358,1,36
2685,TRIPLE PHOTO FRAME CORNICE ,3,1255,21,2200,945,1,42
2686,WOODEN FRAME ANTIQUE WHITE ,9,1577,18,1900,323,1,36
2687,WOODEN BOX OF DOMINOES,7,178,18,1900,1722,1,36
2688,TRADITIONAL WOODEN CATCH CUP GAME ,2,627,7,800,173,1,14
2689,TRADITIONAL WOODEN SKIPPING ROPE,6,911,24,2500,1589,1,48
2690,S/6 WOODEN SKITTLES IN COTTON BAG,4,1511,21,2200,689,1,42
2691,RED METAL BEACH SPADE ,5,149,21,2200,2051,1,42
2692,BOYS VINTAGE TIN SEASIDE BUCKET,1,1159,13,1400,241,1,26
2693,GIRLS VINTAGE TIN SEASIDE BUCKET,1,292,3,400,108,1,6
2694,GREY HEART HOT WATER BOTTLE,10,315,3,400,85,1,6
2695,SCOTTIE DOG HOT WATER BOTTLE,7,560,8,900,340,1,16
2696,BIRD HOUSE HOT WATER BOTTLE,4,622,9,1000,378,1,18
2697,KINGS CHOICE TEA CADDY ,1,465,22,2300,1835,1,44
2698,KINGS CHOICE BISCUIT TIN,1,1622,23,2400,778,1,46
2699,METAL SIGN EMPIRE TEA,10,432,14,1500,1068,1,28
2700,HOMEMADE JAM SCENTED CANDLES,10,1759,23,2400,641,1,46
2701,SET OF 6 SOLDIER SKITTLES,1,128,1,200,72,1,2
2702,FAWN BLUE HOT WATER BOTTLE,10,104,10,1100,996,1,20
2703,HAND WARMER RED RETROSPOT,6,967,14,1500,533,1,28
2704,HOT WATER BOTTLE BABUSHKA ,5,751,9,1000,249,1,18
2705,WHITE SKULL HOT WATER BOTTLE ,3,849,13,1400,551,1,26
2706,RETROSPOT HEART HOT WATER BOTTLE,2,508,7,800,292,1,14
2707,RED WOOLLY HOTTIE WHITE HEART.,8,796,18,1900,1104,1,36
2708,SCOTTIE DOG HOT WATER BOTTLE,10,100,0,100,0,1,0
2709,GREY HEART HOT WATER BOTTLE,7,631,9,1000,369,1,18
2710,HOT WATER BOTTLE BABUSHKA ,7,2316,23,2400,84,1,46
2711,PACK OF 6 BIRDY GIFT TAGS,5,518,12,1300,782,1,24
2712,CHILLI LIGHTS,7,100,0,100,0,1,0
2713,PIGGY BANK RETROSPOT ,4,680,12,1300,620,1,24
2714,CERAMIC STRAWBERRY MONEY BOX,10,524,9,1000,476,1,18
2715,CERAMIC STRAWBERRY CAKE MONEY BANK,5,496,6,700,204,1,12
2716,CERAMIC CHERRY CAKE MONEY BANK,9,912,10,1100,188,1,20
2717,CERAMIC HEART FAIRY CAKE MONEY BANK,3,766,12,1300,534,1,24
2718,CERAMIC PIRATE CHEST MONEY BANK,1,1011,11,1200,189,1,22
2719,DOORSTOP RETROSPOT HEART,3,1486,25,2600,1114,1,50
2720,GINGHAM HEART  DOORSTOP RED,4,911,24,2500,1589,1,48
2721,RETROSPOT BABUSHKA DOORSTOP,5,101,20,2100,1999,1,40
2722,SILK PURSE BABUSHKA RED,8,132,5,600,468,1,10
2723,SILK PURSE BABUSHKA PINK,10,100,0,100,0,1,0
2724,FAMILY PHOTO FRAME CORNICE,8,700,13,1400,700,1,26
2725,SWEETHEART WIRE WALL TIDY,7,398,5,600,202,1,10
2726,JAM MAKING SET PRINTED,10,377,4,500,123,1,8
2727,RED RETROSPOT OVEN GLOVE ,7,416,9,1000,584,1,18
2728,CREAM HEART CARD HOLDER,10,753,10,1100,347,1,20
2729,NAMASTE SWAGAT INCENSE,7,2104,25,2600,496,1,50
2730,CERAMIC STRAWBERRY DESIGN MUG,3,1666,24,2500,834,1,48
2731,BLACK HEART CARD HOLDER,6,1899,24,2500,601,1,48
2732,CLASSICAL ROSE SMALL VASE,3,110,7,800,690,1,14
2733,HYACINTH BULB T-LIGHT CANDLES,1,638,13,1400,762,1,26
2734,CHRISTMAS CRAFT WHITE FAIRY ,2,622,21,2200,1578,1,42
2735,CHRISTMAS CRAFT LITTLE FRIENDS,1,139,3,400,261,1,6
2736,COSY HOUR CIGAR BOX MATCHES ,1,116,11,1200,1084,1,22
2737,RED TEA TOWEL CLASSIC DESIGN,7,708,18,1900,1192,1,36
2738,HEART FILIGREE DOVE  SMALL,6,604,13,1400,796,1,26
2739,RETROSPOT CHILDRENS APRON,6,270,16,1700,1430,1,32
2740,COLOURING PENCILS BROWN TUBE,9,333,19,2000,1667,1,38
2741,5 IVORY DINNER CANDLES SILVER FLOCK,9,121,1,200,79,1,2
2742,HEART FILIGREE DOVE  SMALL,2,2076,23,2400,324,1,46
2743,ZINC METAL HEART DECORATION,7,222,2,300,78,1,4
2744,GREEN FERN NOTEBOOK,6,721,14,1500,779,1,28
2745,BLUE PAISLEY NOTEBOOK,10,1062,14,1500,438,1,28
2746,CHRYSANTHEMUM NOTEBOOK,7,225,4,500,275,1,8
2747,LARGE CHINESE STYLE SCISSOR,10,638,9,1000,362,1,18
2748,SMALL CHINESE STYLE SCISSOR,5,445,12,1300,855,1,24
2749,S/6 WOODEN SKITTLES IN COTTON BAG,2,928,13,1400,472,1,26
2750,TRADITIONAL WOODEN SKIPPING ROPE,7,1949,19,2000,51,1,38
2751,SET OF 6 SOLDIER SKITTLES,2,2096,25,2600,504,1,50
2752,5 TRADITIONAL SPINNING TOPS,7,323,15,1600,1277,1,30
2753,ROTATING SILVER ANGELS T-LIGHT HLDR,1,925,16,1700,775,1,32
2754,BLACK LOVE BIRD CANDLE,5,389,3,400,11,1,6
2755,RETROSPOT CHILDRENS APRON,1,1816,21,2200,384,1,42
2756,HANGING GLASS ETCHED TEALIGHT,7,1045,10,1100,55,1,20
2757,HANGING GLASS ETCHED TEALIGHT,2,200,14,1500,1300,1,28
2758,BLUE NEW BAROQUE CANDLESTICK CANDLE,5,1108,21,2200,1092,1,42
2759,COOKING SET RETROSPOT,9,168,7,800,632,1,14
2760,KINGS CHOICE GIANT TUBE MATCHES,1,187,10,1100,913,1,20
2761,COSY HOUR GIANT TUBE MATCHES,10,179,15,1600,1421,1,30
2762,PLACE SETTING WHITE STAR,2,857,18,1900,1043,1,36
2763,HYACINTH BULB T-LIGHT CANDLES,4,157,3,400,243,1,6
2764,S/15 SILVER GLASS BAUBLES IN BAG,5,273,18,1900,1627,1,36
2765,FRENCH WC SIGN BLUE METAL,5,132,2,300,168,1,4
2766,KINGS CHOICE GIANT TUBE MATCHES,7,240,24,2500,2260,1,48
2767,73 SWEETHEART FAIRY CAKE CASES,6,448,7,800,352,1,14
2768,ASSORTED COLOUR BIRD ORNAMENT,4,128,4,500,372,1,8
2769,FAIRY SOAP SOAP HOLDER,4,1923,21,2200,277,1,42
2770,GREEN GIANT GARDEN THERMOMETER,4,349,25,2600,2251,1,50
2771,IVORY GIANT GARDEN THERMOMETER,9,274,2,300,26,1,4
2772,BLUE GIANT GARDEN THERMOMETER,3,1197,12,1300,103,1,24
2773,PACK OF 60 PINK PAISLEY CAKE CASES,6,111,3,400,289,1,6
2774,RETROSPOT HEART HOT WATER BOTTLE,2,412,8,900,488,1,16
2775,CHICK GREY HOT WATER BOTTLE,8,516,18,1900,1384,1,36
2776,VICTORIAN SEWING BOX SMALL ,9,951,21,2200,1249,1,42
2777,VICTORIAN SEWING BOX MEDIUM,4,1594,17,1800,206,1,34
2778,SET/10 RED POLKADOT PARTY CANDLES,5,1059,10,1100,41,1,20
2779,WASHROOM METAL SIGN,1,272,2,300,28,1,4
2780,BLACK SWEETHEART BRACELET,6,1382,19,2000,618,1,38
2781,DIAMANTE HAIR GRIP PACK/2 BLACK DIA,2,512,9,1000,488,1,18
2782,BLACK DIAMANTE EXPANDABLE RING,7,772,11,1200,428,1,22
2783,DIAMANTE HAIR GRIP PACK/2 RUBY,10,661,12,1300,639,1,24
2784,DIAMANTE HAIR GRIP PACK/2 MONTANA,3,869,15,1600,731,1,30
2785,BLUE SWEETHEART BRACELET,5,237,3,400,163,1,6
2786,PINK SWEETHEART BRACELET,3,660,18,1900,1240,1,36
2787,PURPLE SWEETHEART BRACELET,3,685,12,1300,615,1,24
2788,JUMBO BAG PINK POLKADOT,2,199,23,2400,2201,1,46
2789,JUMBO BAG RED RETROSPOT,3,1539,19,2000,461,1,38
2790,ASSORTED COLOUR BIRD ORNAMENT,6,1074,11,1200,126,1,22
2791,PAPER CHAIN KIT 50'S CHRISTMAS ,2,100,0,100,0,1,0
2792,RIBBON REEL CHRISTMAS PRESENT ,1,724,12,1300,576,1,24
2793,FIRST AID TIN,9,131,2,300,169,1,4
2794,MAKE YOUR OWN MONSOON CARD KIT,3,734,17,1800,1066,1,34
2795,PACK OF 12 HEARTS DESIGN TISSUES ,1,212,4,500,288,1,8
2796,PACK OF 12 RED RETROSPOT TISSUES ,2,1905,25,2600,695,1,50
2797,SOLDIERS EGG CUP ,5,1340,16,1700,360,1,32
2798,HEART IVORY TRELLIS SMALL,2,1010,14,1500,490,1,28
2799,HEART FILIGREE DOVE  SMALL,2,217,4,500,283,1,8
2800,HEART FILIGREE DOVE LARGE,9,1065,12,1300,235,1,24
2801,PACK 3 BOXES BIRD PANNETONE ,8,987,12,1300,313,1,24
2802,PACK 3 BOXES CHRISTMAS PANNETONE,5,968,11,1200,232,1,22
2803,SMALL POPCORN HOLDER,1,1798,17,1800,2,1,34
2804,PACK OF 60 PINK PAISLEY CAKE CASES,5,2053,22,2300,247,1,44
2805,SET OF 6 SOLDIER SKITTLES,4,100,0,100,0,1,0
2806,SWIRLY CIRCULAR RUBBERS IN BAG,7,851,12,1300,449,1,24
2807,VINTAGE PAISLEY STATIONERY SET,1,191,16,1700,1509,1,32
2808,PAPER CHAIN KIT VINTAGE CHRISTMAS,8,678,6,700,22,1,12
2809,SET/10 BLUE POLKADOT PARTY CANDLES,1,449,10,1100,651,1,20
2810,RIBBON REEL SOCKS AND MITTENS,10,331,9,1000,669,1,18
2811,61 CAKE CASES VINTAGE CHRISTMAS,4,520,23,2400,1880,1,46
2812,CHRISTMAS METAL TAGS ASSORTED ,5,447,7,800,353,1,14
2813,CHRISTMAS TREE T-LIGHT HOLDER,3,150,17,1800,1650,1,34
2814,STAR  T-LIGHT HOLDER ,6,529,8,900,371,1,16
2815,HEART T-LIGHT HOLDER ,10,1049,13,1400,351,1,26
2816,MINI FUNKY DESIGN TAPES,9,219,4,500,281,1,8
2817,SET OF 6 T-LIGHTS SNOWMEN,9,1122,23,2400,1278,1,46
2818,STAR WOODEN CHRISTMAS DECORATION,1,1037,23,2400,1363,1,46
2819,WOODEN HEART CHRISTMAS SCANDINAVIAN,9,182,13,1400,1218,1,26
2820,CHRISTMAS RETROSPOT TREE WOOD,9,590,21,2200,1610,1,42
2821,SET OF 6 T-LIGHTS SANTA,7,876,14,1500,624,1,28
2822,SET/9 CHRISTMAS T-LIGHTS SCENTED ,3,627,22,2300,1673,1,44
2823,BLUE ROSE FABRIC MIRROR,4,612,7,800,188,1,14
2824,THREE CANVAS LUGGAGE TAGS,2,858,17,1800,942,1,34
2825,RETROSPOT PARTY BAG + STICKER SET,2,100,0,100,0,1,0
2826,PLASTERS IN TIN VINTAGE PAISLEY ,2,628,10,1100,472,1,20
2827,RETROSPOT SMALL TUBE MATCHES,1,307,12,1300,993,1,24
2828,HAND WARMER SCOTTY DOG DESIGN,5,374,4,500,126,1,8
2829,3D CHRISTMAS STAMPS STICKERS ,5,391,11,1200,809,1,22
2830,HAND WARMER SCOTTY DOG DESIGN,3,1435,15,1600,165,1,30
2831,HAND WARMER SCOTTY DOG DESIGN,10,305,3,400,95,1,6
2832,CLOTHES PEGS RETROSPOT PACK 25,1,1452,18,1900,448,1,36
2833,37 FOIL HEART CAKE CASES,5,750,9,1000,250,1,18
2834,CHRISTMAS METAL TAGS ASSORTED ,3,863,8,900,37,1,16
2835,PACK OF 6 SWEETIE GIFT BOXES,5,615,19,2000,1385,1,38
2836,PACK OF 72 RETROSPOT CAKE CASES,9,159,6,700,541,1,12
2837,PACK OF 72 RETROSPOT CAKE CASES,7,280,8,900,620,1,16
2838,PACK OF 6 BIRDY GIFT TAGS,5,1187,20,2100,913,1,40
2839,SET/10 RED POLKADOT PARTY CANDLES,8,270,3,400,130,1,6
2840,SET/10 PINK POLKADOT PARTY CANDLES,8,373,8,900,527,1,16
2841,SET OF 3 NOTEBOOKS IN PARCEL,2,665,10,1100,435,1,20
2842,STAR  T-LIGHT HOLDER ,7,465,9,1000,535,1,18
2843,CINAMMON SET OF 9 T-LIGHTS,3,568,25,2600,2032,1,50
2844,ORANGE SCENTED SET/9 T-LIGHTS,5,326,4,500,174,1,8
2845,RIBBON REEL STRIPES DESIGN ,5,176,1,200,24,1,2
2846,SET OF 2 TINS JARDIN DE PROVENCE,4,799,7,800,1,1,14
2847,MAKE YOUR OWN PLAYTIME CARD KIT,1,129,4,500,371,1,8
2848,DINOSAURS  WRITING SET ,3,549,15,1600,1051,1,30
2849,BALLOONS  WRITING SET ,2,738,23,2400,1662,1,46
2850,SKULLS WRITING SET ,4,195,3,400,205,1,6
2851,VINTAGE PAISLEY STATIONERY SET,3,650,14,1500,850,1,28
2852,COSY SLIPPER SHOES SMALL  RED ,8,100,0,100,0,1,0
2853,DOORMAT BLACK FLOCK ,3,914,17,1800,886,1,34
2854,JUMBO  BAG BAROQUE BLACK WHITE,10,316,24,2500,2184,1,48
2855,JAM MAKING SET WITH JARS,8,1015,21,2200,1185,1,42
2856,ORANGE SCENTED SET/9 T-LIGHTS,4,554,6,700,146,1,12
2857,CINAMMON SET OF 9 T-LIGHTS,4,1358,23,2400,1042,1,46
2858,HAND WARMER SCOTTY DOG DESIGN,5,467,8,900,433,1,16
2859,CHRISTMAS DECOUPAGE CANDLE,8,506,5,600,94,1,10
2860,HEART T-LIGHT HOLDER ,3,199,10,1100,901,1,20
2861,GROW YOUR OWN BASIL IN ENAMEL MUG,6,298,23,2400,2102,1,46
2862,OFFICE MUG WARMER POLKADOT,3,343,17,1800,1457,1,34
2863,SMALL POPCORN HOLDER,2,283,13,1400,1117,1,26
2864,JUMBO BAG DOLLY GIRL DESIGN,4,1597,17,1800,203,1,34
2865,JAM MAKING SET WITH JARS,7,176,16,1700,1524,1,32
2866,JAM MAKING SET PRINTED,6,674,16,1700,1026,1,32
2867,SMALL GLASS HEART TRINKET POT,6,536,22,2300,1764,1,44
2868,RED WOOLLY HOTTIE WHITE HEART.,6,442,15,1600,1158,1,30
2869,BLACK RECORD COVER FRAME,2,1145,20,2100,955,1,40
2870,"RECORD FRAME 7"" SINGLE SIZE ",6,1474,20,2100,626,1,40
2871,37 PENCILS TUBE RED RETROSPOT,2,354,7,800,446,1,14
2872,37 PENCILS TUBE WOODLAND,3,245,2,300,55,1,4
2873,SET OF 6 SOLDIER SKITTLES,5,886,16,1700,814,1,32
2874,ROCKING HORSE RED CHRISTMAS ,8,1733,22,2300,567,1,44
2875,CHRISTMAS GINGHAM HEART,8,1766,20,2100,334,1,40
2876,CHRISTMAS GINGHAM STAR,10,469,13,1400,931,1,26
2877,HAND WARMER UNION JACK,5,238,2,300,62,1,4
2878,HAND WARMER RED RETROSPOT,6,2358,24,2500,142,1,48
2879,REGENCY CAKESTAND 3 TIER,9,907,9,1000,93,1,18
2880,JUMBO SHOPPER VINTAGE RED PAISLEY,9,413,5,600,187,1,10
2881,RIBBON REEL SNOWY VILLAGE,10,257,16,1700,1443,1,32
2882,VINTAGE UNION JACK BUNTING,5,541,5,600,59,1,10
2883,JAM MAKING SET WITH JARS,8,838,8,900,62,1,16
2884,RIBBON REEL STRIPES DESIGN ,1,924,22,2300,1376,1,44
2885,RETRO LONGBOARD IRONING BOARD COVER,2,1109,13,1400,291,1,26
2886,3D DOG PICTURE PLAYING CARDS,2,1567,16,1700,133,1,32
2887,RETROSPOT CIGAR BOX MATCHES ,9,462,23,2400,1938,1,46
2888,SET/9 CHRISTMAS T-LIGHTS SCENTED ,9,1778,24,2500,722,1,48
2889,ROTATING SILVER ANGELS T-LIGHT HLDR,5,142,2,300,158,1,4
2890,ROTATING SILVER ANGELS T-LIGHT HLDR,4,952,9,1000,48,1,18
2891,SAVE THE PLANET COTTON TOTE BAG,7,211,16,1700,1489,1,32
2892,SET OF 20 VINTAGE CHRISTMAS NAPKINS,7,386,17,1800,1414,1,34
2893,PAPER BUNTING WHITE LACE,10,984,21,2200,1216,1,42
2894,GENTLEMAN SHIRT REPAIR KIT ,4,1242,21,2200,958,1,42
2895,CARD I LOVE LONDON ,5,210,6,700,490,1,12
2896,PAPER CHAIN KIT VINTAGE CHRISTMAS,10,293,2,300,7,1,4
2897,MIRRORED WALL ART FOXY,3,116,1,200,84,1,2
2898,MIRRORED WALL ART GENTS,6,814,15,1600,786,1,30
2899,AIRLINE BAG VINTAGE JET SET WHITE,9,835,11,1200,365,1,22
2900,JAM MAKING SET PRINTED,1,425,5,600,175,1,10
2901,POTTING SHED SOW 'N' GROW SET,1,138,13,1400,1262,1,26
2902,BABUSHKA LIGHTS STRING OF 11,2,1021,10,1100,79,1,20
2903,REX CASH+CARRY JUMBO SHOPPER,2,910,20,2100,1190,1,40
2904,AIRLINE BAG VINTAGE WORLD CHAMPION ,7,421,19,2000,1579,1,38
2905,HAND WARMER BIRD DESIGN,9,284,8,900,616,1,16
2906,CHRISTMAS CRAFT LITTLE FRIENDS,9,1200,17,1800,600,1,34
2907,PINK HEARTS PAPER GARLAND,10,217,16,1700,1483,1,32
2908,POTTING SHED SEED ENVELOPES,10,1186,19,2000,814,1,38
2909,HI TEC ALPINE HAND WARMER,8,1494,19,2000,506,1,38
2910,FELTCRAFT CHRISTMAS FAIRY,2,558,7,800,242,1,14
2911,HI TEC ALPINE HAND WARMER,5,687,14,1500,813,1,28
2912,ROTATING SILVER ANGELS T-LIGHT HLDR,2,842,22,2300,1458,1,44
2913,4 STRIPEY MICE FELTCRAFT,1,714,8,900,186,1,16
2914,FELTCRAFT 6 FLOWER FRIENDS,8,208,7,800,592,1,14
2915,CHRISTMAS CRAFT LITTLE FRIENDS,3,100,0,100,0,1,0
2916,VINTAGE UNION JACK CUSHION COVER,7,1607,23,2400,793,1,46
2917,POLYESTER FILLER PAD 45x45cm,5,107,19,2000,1893,1,38
2918,DOLLY GIRL LUNCH BOX,4,1569,22,2300,731,1,44
2919,PACK OF 12 LONDON TISSUES ,4,989,19,2000,1011,1,38
2920,CARD DOLLY GIRL ,5,179,4,500,321,1,8
2921,CARD BILLBOARD FONT,2,762,12,1300,538,1,24
2922,RAINY LADIES BIRTHDAY CARD,8,1139,22,2300,1161,1,44
2923,GREY HEART HOT WATER BOTTLE,4,1560,15,1600,40,1,30
2924,RED WOOLLY HOTTIE WHITE HEART.,5,360,3,400,40,1,6
2925,RED WHITE SCARF  HOT WATER BOTTLE,6,292,2,300,8,1,4
2926, SET 2 TEA TOWELS I LOVE LONDON ,9,195,3,400,205,1,6
2927,SET OF 2 TEA TOWELS APPLE AND PEARS,10,118,12,1300,1182,1,24
2928,SET/2 RED RETROSPOT TEA TOWELS ,8,221,25,2600,2379,1,50
2929,LOVE BUILDING BLOCK WORD,3,1876,23,2400,524,1,46
2930,HOME BUILDING BLOCK WORD,5,533,14,1500,967,1,28
2931,ASSORTED COLOUR BIRD ORNAMENT,10,269,15,1600,1331,1,30
2932,LANTERN CREAM GAZEBO ,6,356,7,800,444,1,14
2933,BLUE BIRDHOUSE DECORATION,10,1850,24,2500,650,1,48
2934,WHITE HANGING HEART T-LIGHT HOLDER,2,500,4,500,0,1,8
2935,REGENCY CAKESTAND 3 TIER,10,195,2,300,105,1,4
2936,ANTIQUE SILVER TEA GLASS ENGRAVED,3,100,0,100,0,1,0
2937,AGED GLASS SILVER T-LIGHT HOLDER,4,805,13,1400,595,1,26
2938,JAM MAKING SET WITH JARS,3,166,9,1000,834,1,18
2939,HAND WARMER OWL DESIGN,9,464,9,1000,536,1,18
2940,SET OF 2 WOODEN MARKET CRATES,1,1043,24,2500,1457,1,48
2941,SET OF 6 T-LIGHTS TOADSTOOLS,1,1233,15,1600,367,1,30
2942,HAND WARMER UNION JACK,10,698,19,2000,1302,1,38
2943,HAND WARMER SCOTTY DOG DESIGN,6,495,8,900,405,1,16
2944,CLASSIC FRENCH STYLE BASKET NATURAL,5,425,4,500,75,1,8
2945,CRAZY DAISY HEART DECORATION,10,1477,22,2300,823,1,44
2946,GIN + TONIC DIET METAL SIGN,7,232,10,1100,868,1,20
2947,IVORY GIANT GARDEN THERMOMETER,8,1034,16,1700,666,1,32
2948,CARD HOLDER GINGHAM HEART,4,862,10,1100,238,1,20
2949,SMALL STRIPES CHOCOLATE GIFT BAG ,6,109,14,1500,1391,1,28
2950,S/6 WOODEN SKITTLES IN COTTON BAG,8,379,22,2300,1921,1,44
2951,HAND WARMER RED RETROSPOT,10,557,12,1300,743,1,24
2952,HAND WARMER UNION JACK,2,554,25,2600,2046,1,50
2953,FRENCH WC SIGN BLUE METAL,10,322,3,400,78,1,6
2954,PINK UNION JACK  LUGGAGE TAG,4,250,12,1300,1050,1,24
2955,"TRAY, BREAKFAST IN BED",1,1327,13,1400,73,1,26
2956,PIZZA PLATE IN BOX,6,343,18,1900,1557,1,36
2957,HEART OF WICKER LARGE,3,389,3,400,11,1,6
2958,PINK HEART DOTS HOT WATER BOTTLE,2,716,9,1000,284,1,18
2959,PLACE SETTING WHITE HEART,10,228,3,400,172,1,6
2960,SET OF 4 NAPKIN CHARMS LEAVES   ,9,284,4,500,216,1,8
2961,SET OF 4 NAPKIN CHARMS STARS   ,7,722,19,2000,1278,1,38
2962,SET OF 4 NAPKIN CHARMS CUTLERY,2,319,17,1800,1481,1,34
2963,CARAVAN SQUARE TISSUE BOX,4,191,1,200,9,1,2
2964,PLASTERS IN TIN SKULLS,5,895,20,2100,1205,1,40
2965,PLASTERS IN TIN SPACEBOY,2,302,8,900,598,1,16
2966,BUTTON BOX ,1,230,9,1000,770,1,18
2967,PLASTERS IN TIN VINTAGE PAISLEY ,2,355,3,400,45,1,6
2968,13 MESSAGE CARDS WITH ENVELOPES,3,160,1,200,40,1,2
2969,SMALL RED BABUSHKA NOTEBOOK ,6,227,8,900,673,1,16
2970,CUPCAKE LACE PAPER SET 7,8,881,19,2000,1119,1,38
2971,PACK 3 BOXES CHRISTMAS PANNETONE,10,578,5,600,22,1,10
2972,HERB MARKER MINT,3,1274,16,1700,426,1,32
2973,HERB MARKER ROSEMARY,7,1727,21,2200,473,1,42
2974,HERB MARKER BASIL,2,785,9,1000,215,1,18
2975,HERB MARKER CHIVES ,3,886,10,1100,214,1,20
2976,HERB MARKER PARSLEY,2,730,22,2300,1570,1,44
2977,HERB MARKER THYME,9,739,24,2500,1761,1,48
2978,WHITE HANGING HEART T-LIGHT HOLDER,5,100,0,100,0,1,0
2979,METAL MERRY CHRISTMAS WREATH,6,146,5,600,454,1,10
2980,WHITE CHRISTMAS GARLAND STARS TREES,5,1048,12,1300,252,1,24
2981,RETROSPOT SMALL TUBE MATCHES,10,112,6,700,588,1,12
2982,RETROSPOT GIANT TUBE MATCHES,8,732,9,1000,268,1,18
2983,PLACE SETTING WHITE STAR,2,457,12,1300,843,1,24
2984,GROW YOUR OWN BASIL IN ENAMEL MUG,5,793,14,1500,707,1,28
2985,37 FOIL STAR CAKE CASES ,2,252,18,1900,1648,1,36
2986,37 FOIL HEART CAKE CASES,7,2154,23,2400,246,1,46
2987,PACK OF 6 SWEETIE GIFT BOXES,3,169,1,200,31,1,2
2988,PACK OF 6 HANDBAG GIFT BOXES,6,134,4,500,366,1,8
2989,GARLAND WOODEN HAPPY EASTER,3,245,6,700,455,1,12
2990,CALENDAR PAPER CUT DESIGN,7,257,2,300,43,1,4
2991,CALENDAR IN SEASON DESIGN,9,894,15,1600,706,1,30
2992,SMALL POPCORN HOLDER,5,373,5,600,227,1,10
2993,BLUE PAISLEY TISSUE BOX,3,1212,25,2600,1388,1,50
2994,HEART OF WICKER SMALL,2,367,4,500,133,1,8
2995,SKULLS SQUARE TISSUE BOX,9,108,10,1100,992,1,20
2996,SKULLS SQUARE TISSUE BOX,7,277,5,600,323,1,10
2997,WHITE HANGING HEART T-LIGHT HOLDER,3,2427,24,2500,73,1,48
2998,WHITE METAL LANTERN,8,136,17,1800,1664,1,34
2999,CREAM CUPID HEARTS COAT HANGER,1,182,3,400,218,1,6
3000,KNITTED UNION FLAG HOT WATER BOTTLE,3,389,3,400,11,1,6
3001,RED WOOLLY HOTTIE WHITE HEART.,2,437,16,1700,1263,1,32
3002,SET 7 BABUSHKA NESTING BOXES,2,211,16,1700,1489,1,32
3003,GLASS STAR FROSTED T-LIGHT HOLDER,8,371,4,500,129,1,8
3004,HAND WARMER UNION JACK,4,1804,24,2500,696,1,48
3005,HAND WARMER RED POLKA DOT,10,355,24,2500,2145,1,48
3006,ASSORTED COLOUR BIRD ORNAMENT,2,455,7,800,345,1,14
3007,POPPY'S PLAYHOUSE BEDROOM ,10,306,7,800,494,1,14
3008,POPPY'S PLAYHOUSE KITCHEN,4,388,10,1100,712,1,20
3009,FELTCRAFT PRINCESS CHARLOTTE DOLL,8,198,17,1800,1602,1,34
3010,IVORY KNITTED MUG COSY ,6,125,1,200,75,1,2
3011,BOX OF 6 ASSORTED COLOUR TEASPOONS,10,1947,19,2000,53,1,38
3012,BOX OF VINTAGE JIGSAW BLOCKS ,2,222,3,400,178,1,6
3013,BOX OF VINTAGE ALPHABET BLOCKS,9,1712,18,1900,188,1,36
3014,HOME BUILDING BLOCK WORD,2,496,5,600,104,1,10
3015,LOVE BUILDING BLOCK WORD,5,398,4,500,102,1,8
3016,RECIPE BOX WITH METAL HEART,2,830,20,2100,1270,1,40
3017,DOORMAT NEW ENGLAND,5,1137,12,1300,163,1,24
3018,JAM MAKING SET WITH JARS,2,1659,20,2100,441,1,40
3019,RED COAT RACK PARIS FASHION,4,809,13,1400,591,1,26
3020,YELLOW COAT RACK PARIS FASHION,2,1063,13,1400,337,1,26
3021,BLUE COAT RACK PARIS FASHION,7,469,5,600,131,1,10
3022,BATH BUILDING BLOCK WORD,8,635,22,2300,1665,1,44
3023,ALARM CLOCK BAKELIKE PINK,8,232,15,1600,1368,1,30
3024,ALARM CLOCK BAKELIKE RED ,5,1269,12,1300,31,1,24
3025,ALARM CLOCK BAKELIKE GREEN,6,336,8,900,564,1,16
3026,PANDA AND BUNNIES STICKER SHEET,7,490,7,800,310,1,14
3027,STARS GIFT TAPE ,6,1025,13,1400,375,1,26
3028,INFLATABLE POLITICAL GLOBE ,4,913,10,1100,187,1,20
3029,VINTAGE HEADS AND TAILS CARD GAME ,9,1998,20,2100,102,1,40
3030,SET/2 RED RETROSPOT TEA TOWELS ,2,174,9,1000,826,1,18
3031,ROUND SNACK BOXES SET OF4 WOODLAND ,2,787,9,1000,213,1,18
3032,SPACEBOY LUNCH BOX ,6,192,20,2100,1908,1,40
3033,LUNCH BOX I LOVE LONDON,3,239,5,600,361,1,10
3034,CIRCUS PARADE LUNCH BOX ,5,644,21,2200,1556,1,42
3035,CHARLOTTE BAG DOLLY GIRL DESIGN,6,441,10,1100,659,1,20
3036,RED TOADSTOOL LED NIGHT LIGHT,5,135,1,200,65,1,2
3037, SET 2 TEA TOWELS I LOVE LONDON ,7,924,23,2400,1476,1,46
3038,VINTAGE SEASIDE JIGSAW PUZZLES,6,599,7,800,201,1,14
3039,MINI JIGSAW CIRCUS PARADE ,6,407,8,900,493,1,16
3040,MINI JIGSAW SPACEBOY,1,411,11,1200,789,1,22
3041,MINI PAINT SET VINTAGE ,6,346,6,700,354,1,12
3042,POSTAGE,1,120,4,500,380,1,8
3043,PAPER CHAIN KIT 50'S CHRISTMAS ,10,201,25,2600,2399,1,50
3044,HAND WARMER RED POLKA DOT,7,881,9,1000,119,1,18
3045,HAND WARMER UNION JACK,7,1380,16,1700,320,1,32
3046,WHITE HANGING HEART T-LIGHT HOLDER,1,583,18,1900,1317,1,36
3047,WHITE METAL LANTERN,8,514,22,2300,1786,1,44
3048,CREAM CUPID HEARTS COAT HANGER,8,949,10,1100,151,1,20
3049,EDWARDIAN PARASOL RED,5,827,16,1700,873,1,32
3050,RETRO COFFEE MUGS ASSORTED,4,1649,19,2000,351,1,38
3051,SAVE THE PLANET MUG,6,1933,19,2000,67,1,38
3052,VINTAGE BILLBOARD DRINK ME MUG,7,747,8,900,153,1,16
3053,VINTAGE BILLBOARD LOVE/HATE MUG,9,1292,16,1700,408,1,32
3054,WOOD 2 DRAWER CABINET WHITE FINISH,1,754,21,2200,1446,1,42
3055,WOOD S/3 CABINET ANT WHITE FINISH,4,2370,25,2600,230,1,50
3056,WOODEN PICTURE FRAME WHITE FINISH,3,251,4,500,249,1,8
3057,WOODEN FRAME ANTIQUE WHITE ,10,355,13,1400,1045,1,26
3058,KNITTED UNION FLAG HOT WATER BOTTLE,7,132,8,900,768,1,16
3059,RED WOOLLY HOTTIE WHITE HEART.,5,553,8,900,347,1,16
3060,SET 7 BABUSHKA NESTING BOXES,3,749,17,1800,1051,1,34
3061,GLASS STAR FROSTED T-LIGHT HOLDER,8,1526,18,1900,374,1,36
3062,VICTORIAN SEWING BOX LARGE,8,1210,15,1600,390,1,30
3063,WHITE HANGING HEART T-LIGHT HOLDER,8,375,8,900,525,1,16
3064,WHITE METAL LANTERN,4,187,16,1700,1513,1,32
3065,CREAM CUPID HEARTS COAT HANGER,2,406,20,2100,1694,1,40
3066,EDWARDIAN PARASOL RED,2,185,15,1600,1415,1,30
3067,RETRO COFFEE MUGS ASSORTED,9,153,1,200,47,1,2
3068,SAVE THE PLANET MUG,3,445,9,1000,555,1,18
3069,VINTAGE BILLBOARD DRINK ME MUG,2,1753,23,2400,647,1,46
3070,VINTAGE BILLBOARD LOVE/HATE MUG,9,577,10,1100,523,1,20
3071,WOOD 2 DRAWER CABINET WHITE FINISH,7,332,11,1200,868,1,22
3072,WOOD S/3 CABINET ANT WHITE FINISH,3,275,2,300,25,1,4
3073,WOODEN PICTURE FRAME WHITE FINISH,4,360,13,1400,1040,1,26
3074,WOODEN FRAME ANTIQUE WHITE ,2,206,2,300,94,1,4
3075,KNITTED UNION FLAG HOT WATER BOTTLE,3,315,8,900,585,1,16
3076,RED WOOLLY HOTTIE WHITE HEART.,6,131,21,2200,2069,1,42
3077,SET 7 BABUSHKA NESTING BOXES,6,809,22,2300,1491,1,44
3078,GLASS STAR FROSTED T-LIGHT HOLDER,9,1338,18,1900,562,1,36
3079,HOT WATER BOTTLE TEA AND SYMPATHY,1,100,2,300,200,1,4
3080,RED HANGING HEART T-LIGHT HOLDER,4,1188,19,2000,812,1,38
3081,HAND WARMER RED POLKA DOT,3,462,8,900,438,1,16
3082,HAND WARMER UNION JACK,7,514,20,2100,1586,1,40
3083,JUMBO BAG PINK POLKADOT,7,283,5,600,317,1,10
3084,JUMBO  BAG BAROQUE BLACK WHITE,3,712,22,2300,1588,1,44
3085,JUMBO BAG CHARLIE AND LOLA TOYS,6,210,2,300,90,1,4
3086,STRAWBERRY CHARLOTTE BAG,5,100,0,100,0,1,0
3087,RED 3 PIECE RETROSPOT CUTLERY SET,6,353,4,500,147,1,8
3088,BLUE 3 PIECE POLKADOT CUTLERY SET,6,778,21,2200,1422,1,42
3089,SET/6 RED SPOTTY PAPER PLATES,6,783,7,800,17,1,14
3090,LUNCH BAG RED RETROSPOT,6,382,9,1000,618,1,18
3091,STRAWBERRY LUNCH BOX WITH CUTLERY,3,438,7,800,362,1,14
3092,LUNCH BOX WITH CUTLERY RETROSPOT ,6,442,4,500,58,1,8
3093,PACK OF 72 RETROSPOT CAKE CASES,4,281,2,300,19,1,4
3094,PACK OF 60 DINOSAUR CAKE CASES,7,699,16,1700,1001,1,32
3095,PACK OF 60 PINK PAISLEY CAKE CASES,1,329,25,2600,2271,1,50
3096,62 TEATIME FAIRY CAKE CASES,8,584,9,1000,416,1,18
3097,TOMATO CHARLIE+LOLA COASTER SET,8,1534,16,1700,166,1,32
3098,CHARLIE & LOLA WASTEPAPER BIN FLORA,5,581,15,1600,1019,1,30
3099,RED CHARLIE+LOLA PERSONAL DOORSIGN,5,165,9,1000,835,1,18
3100,JUMBO STORAGE BAG SUKI,6,144,15,1600,1456,1,30
3101,JUMBO BAG PINK VINTAGE PAISLEY,6,885,8,900,15,1,16
3102,JAM MAKING SET PRINTED,7,312,5,600,288,1,10
3103,RETROSPOT TEA SET CERAMIC 11 PC ,2,159,1,200,41,1,2
3104,GIRLY PINK TOOL SET,5,455,8,900,445,1,16
3105,JUMBO SHOPPER VINTAGE RED PAISLEY,4,481,6,700,219,1,12
3106,"AIRLINE LOUNGE,METAL SIGN",7,1236,13,1400,164,1,26
3107,WHITE SPOT RED CERAMIC DRAWER KNOB,5,1291,24,2500,1209,1,48
3108,RED DRAWER KNOB ACRYLIC EDWARDIAN,6,844,8,900,56,1,16
3109,CLEAR DRAWER KNOB ACRYLIC EDWARDIAN,6,605,20,2100,1495,1,40
3110,PHOTO CLIP LINE,4,131,1,200,69,1,2
3111,FELT EGG COSY CHICKEN,2,449,23,2400,1951,1,46
3112,PIGGY BANK RETROSPOT ,1,214,6,700,486,1,12
3113,SKULL SHOULDER BAG,5,812,11,1200,388,1,22
3114,YOU'RE CONFUSING ME METAL SIGN ,1,672,16,1700,1028,1,32
3115,COOK WITH WINE METAL SIGN ,2,222,4,500,278,1,8
3116,GIN + TONIC DIET METAL SIGN,3,315,16,1700,1385,1,32
3117,YELLOW BREAKFAST CUP AND SAUCER,4,344,3,400,56,1,6
3118,PINK BREAKFAST CUP AND SAUCER ,4,823,10,1100,277,1,20
3119,PAPER CHAIN KIT 50'S CHRISTMAS ,2,718,11,1200,482,1,22
3120,PAPER CHAIN KIT RETROSPOT,5,281,19,2000,1719,1,38
3121,SMALL HEART FLOWERS HOOK ,6,172,4,500,328,1,8
3122,PHOTO CLIP LINE,5,108,1,200,92,1,2
3123,TEA TIME DES TEA COSY,6,352,24,2500,2148,1,48
3124,FELT EGG COSY WHITE RABBIT ,8,596,11,1200,604,1,22
3125,ZINC WILLIE WINKIE  CANDLE STICK,1,353,4,500,147,1,8
3126,CERAMIC CHERRY CAKE MONEY BANK,6,193,6,700,507,1,12
3127,RETROSPOT LARGE MILK JUG,4,336,6,700,364,1,12
3128,SET OF 6 FUNKY BEAKERS,7,351,18,1900,1549,1,36
3129,EDWARDIAN PARASOL BLACK,4,1067,12,1300,233,1,24
3130,EDWARDIAN PARASOL NATURAL,1,615,14,1500,885,1,28
3131,CERAMIC STRAWBERRY CAKE MONEY BANK,1,1004,15,1600,596,1,30
3132,BLUE OWL SOFT TOY,7,223,4,500,277,1,8
3133,BALLOON ART MAKE YOUR OWN FLOWERS,2,100,0,100,0,1,0
3134,RED TOADSTOOL LED NIGHT LIGHT,6,100,0,100,0,1,0
3135,GLASS CLOCHE SMALL,1,1080,20,2100,1020,1,40
3136,GUMBALL MONOCHROME COAT RACK,8,673,24,2500,1827,1,48
3137,DOORMAT FANCY FONT HOME SWEET HOME,1,397,3,400,3,1,6
3138,Discount,3,1074,20,2100,1026,1,40
3139,INFLATABLE POLITICAL GLOBE ,10,1156,13,1400,244,1,26
3140,VINTAGE SNAKES & LADDERS,2,873,14,1500,627,1,28
3141,CHOCOLATE CALCULATOR,9,197,8,900,703,1,16
3142,JUMBO SHOPPER VINTAGE RED PAISLEY,2,534,6,700,166,1,12
3143,RECYCLING BAG RETROSPOT ,10,847,9,1000,153,1,18
3144,TOY TIDY PINK POLKADOT,5,535,8,900,365,1,16
3145,ANTIQUE GLASS DRESSING TABLE POT,9,777,18,1900,1123,1,36
3146,ALARM CLOCK BAKELIKE GREEN,9,1219,20,2100,881,1,40
3147,IVORY GIANT GARDEN THERMOMETER,1,611,8,900,289,1,16
3148,5 TIER CAKE TIN GREEN AND CREAM,5,1275,14,1500,225,1,28
3149,5 TIER CAKE TIN RED AND CREAM,9,963,16,1700,737,1,32
3150,SET 3 WICKER OVAL BASKETS W LIDS,6,154,15,1600,1446,1,30
3151,SET OF 3 COLOURED  FLYING DUCKS,3,1600,25,2600,1000,1,50
3152,WOOD BLACK BOARD ANT WHITE FINISH,3,365,10,1100,735,1,20
3153,COLOUR GLASS T-LIGHT HOLDER HANGING,10,1218,13,1400,182,1,26
3154,HANGING METAL HEART LANTERN,2,409,23,2400,1991,1,46
3155,HANGING MEDINA LANTERN SMALL,6,128,12,1300,1172,1,24
3156,NATURAL SLATE HEART CHALKBOARD ,1,143,3,400,257,1,6
3157,HEART OF WICKER SMALL,5,373,21,2200,1827,1,42
3158,HEART OF WICKER LARGE,6,623,8,900,277,1,16
3159,WHITE LOVEBIRD LANTERN,7,122,7,800,678,1,14
3160,CLASSIC METAL BIRDCAGE PLANT HOLDER,2,984,24,2500,1516,1,48
3161,CREAM HEART CARD HOLDER,7,353,8,900,547,1,16
3162,ENAMEL FLOWER JUG CREAM,6,1604,24,2500,896,1,48
3163,ENAMEL FIRE BUCKET CREAM,1,1007,16,1700,693,1,32
3164,ENAMEL BREAD BIN CREAM,5,150,19,2000,1850,1,38
3165,SET 3 WICKER OVAL BASKETS W LIDS,2,1405,21,2200,795,1,42
3166,JAM MAKING SET PRINTED,9,250,3,400,150,1,6
3167,JAM MAKING SET WITH JARS,4,660,16,1700,1040,1,32
3168,JUMBO BAG DOLLY GIRL DESIGN,7,589,7,800,211,1,14
3169,TRADITIONAL CHRISTMAS RIBBONS,9,468,17,1800,1332,1,34
3170,ORGANISER WOOD ANTIQUE WHITE ,8,267,22,2300,2033,1,44
3171,LUNCH BAG DOLLY GIRL DESIGN,3,486,5,600,114,1,10
3172,WHITE WIRE EGG HOLDER,7,489,8,900,411,1,16
3173,JUMBO  BAG BAROQUE BLACK WHITE,4,1723,24,2500,777,1,48
3174,JUMBO BAG RED RETROSPOT,6,479,8,900,421,1,16
3175,CHILLI LIGHTS,10,606,8,900,294,1,16
3176,LIGHT GARLAND BUTTERFILES PINK,4,1325,19,2000,675,1,38
3177,WOODEN OWLS LIGHT GARLAND ,9,521,5,600,79,1,10
3178,FAIRY TALE COTTAGE NIGHTLIGHT,5,501,15,1600,1099,1,30
3179,RED TOADSTOOL LED NIGHT LIGHT,6,1026,14,1500,474,1,28
3180,HOME BUILDING BLOCK WORD,10,1354,25,2600,1246,1,50
3181,LOVE BUILDING BLOCK WORD,4,795,11,1200,405,1,22
3182,DOORMAT FANCY FONT HOME SWEET HOME,9,352,23,2400,2048,1,46
3183,HOME SMALL WOOD LETTERS,3,891,11,1200,309,1,22
3184,GINGHAM HEART  DOORSTOP RED,7,169,1,200,31,1,2
3185,FIVE HEART HANGING DECORATION,9,360,23,2400,2040,1,46
3186,HANGING METAL HEART LANTERN,2,112,5,600,488,1,10
3187,ASSORTED BOTTLE TOP  MAGNETS ,2,402,5,600,198,1,10
3188,FRIDGE MAGNETS US DINER ASSORTED,1,481,5,600,119,1,10
3189,HOMEMADE JAM SCENTED CANDLES,9,415,22,2300,1885,1,44
3190,FRIDGE MAGNETS LES ENFANTS ASSORTED,9,959,10,1100,141,1,20
3191,ROSE CARAVAN DOORSTOP,3,1450,18,1900,450,1,36
3192,HEART OF WICKER SMALL,6,101,12,1300,1199,1,24
3193,7 HOOK HANGER MAGIC TOADSTOOL,8,103,12,1300,1197,1,24
3194,CHRISTMAS LIGHTS 10 REINDEER,7,1129,12,1300,171,1,24
3195,VINTAGE UNION JACK CUSHION COVER,3,1732,23,2400,668,1,46
3196,VINTAGE HEADS AND TAILS CARD GAME ,5,108,17,1800,1692,1,34
3197,SET OF 3 COLOURED  FLYING DUCKS,3,325,10,1100,775,1,20
3198,SET OF 3 GOLD FLYING DUCKS,4,1226,22,2300,1074,1,44
3199,RED RETROSPOT UMBRELLA,10,346,4,500,154,1,8
3200,BLACK/BLUE POLKADOT UMBRELLA,8,799,10,1100,301,1,20
3201,RED DINER WALL CLOCK,6,1857,18,1900,43,1,36
3202,ALARM CLOCK BAKELIKE GREEN,2,119,1,200,81,1,2
3203,ALARM CLOCK BAKELIKE RED ,5,215,12,1300,1085,1,24
3204,BLUE DINER WALL CLOCK,8,119,1,200,81,1,2
3205,IVORY DINER WALL CLOCK,2,901,13,1400,499,1,26
3206,LARGE HEART MEASURING SPOONS,4,150,12,1300,1150,1,24
3207,SMALL HEART MEASURING SPOONS,8,214,8,900,686,1,16
3208,CHRISTMAS LIGHTS 10 REINDEER,9,1077,18,1900,823,1,36
3209,JAM MAKING SET WITH JARS,8,194,25,2600,2406,1,50
3210,JAM MAKING SET PRINTED,7,901,23,2400,1499,1,46
3211,JAM JAR WITH PINK LID,5,1213,17,1800,587,1,34
3212,JAM JAR WITH GREEN LID,5,148,5,600,452,1,10
3213,ROSE COTTAGE KEEPSAKE BOX ,8,1172,24,2500,1328,1,48
3214,HANGING HEART ZINC T-LIGHT HOLDER,1,594,15,1600,1006,1,30
3215,PAPER CHAIN KIT VINTAGE CHRISTMAS,8,1606,24,2500,894,1,48
3216,DISCO BALL CHRISTMAS DECORATION,9,189,1,200,11,1,2
3217,WHITE HANGING HEART T-LIGHT HOLDER,10,305,18,1900,1595,1,36
3218,SMALL POPCORN HOLDER,10,800,8,900,100,1,16
3219,LARGE POPCORN HOLDER ,1,424,15,1600,1176,1,30
3220,RETROSPOT LARGE MILK JUG,1,866,8,900,34,1,16
3221,SET/20 RED RETROSPOT PAPER NAPKINS ,10,986,22,2300,1314,1,44
3222,SET/6 RED SPOTTY PAPER PLATES,2,1085,15,1600,515,1,30
3223,SET/6 RED SPOTTY PAPER CUPS,9,1469,20,2100,631,1,40
3224,POLKADOT RAIN HAT ,5,132,1,200,68,1,2
3225,DELUXE SEWING KIT ,6,1235,13,1400,165,1,26
3226,RETROSPOT HEART HOT WATER BOTTLE,7,1468,18,1900,432,1,36
3227,KNITTED UNION FLAG HOT WATER BOTTLE,7,1284,12,1300,16,1,24
3228,ENGLISH ROSE HOT WATER BOTTLE,5,728,16,1700,972,1,32
3229,PHOTO CUBE,10,250,9,1000,750,1,18
3230,HOMEMADE JAM SCENTED CANDLES,6,457,8,900,443,1,16
3231,JUMBO BAG RED RETROSPOT,4,852,12,1300,448,1,24
3232,PLASTERS IN TIN CIRCUS PARADE ,8,561,13,1400,839,1,26
3233,PACK OF 12 PINK PAISLEY TISSUES ,2,449,11,1200,751,1,22
3234,PACK OF 12 BLUE PAISLEY TISSUES ,2,1574,23,2400,826,1,46
3235,PACK OF 12 RED RETROSPOT TISSUES ,6,397,19,2000,1603,1,38
3236,CHICK GREY HOT WATER BOTTLE,2,989,11,1200,211,1,22
3237,PLASTERS IN TIN VINTAGE PAISLEY ,4,566,10,1100,534,1,20
3238,PLASTERS IN TIN SKULLS,10,248,11,1200,952,1,22
3239,5 STRIPEY MICE FELTCRAFT,4,375,4,500,125,1,8
3240,SET OF 6 SOLDIER SKITTLES,10,417,23,2400,1983,1,46
3241,TRADITIONAL WOODEN SKIPPING ROPE,1,115,25,2600,2485,1,50
3242,WOODEN BOX OF DOMINOES,8,612,25,2600,1988,1,50
3243,RUSTIC  SEVENTEEN DRAWER SIDEBOARD,5,408,5,600,192,1,10
3244,PARTY CONES CARNIVAL ASSORTED,4,188,6,700,512,1,12
3245,PARTY CONES CANDY ASSORTED,1,1388,15,1600,212,1,30
3246,PICNIC BASKET WICKER SMALL,10,784,19,2000,1216,1,38
3247,ASSORTED COLOUR BIRD ORNAMENT,7,650,19,2000,1350,1,38
3248,STAR DECORATION PAINTED ZINC ,9,574,6,700,126,1,12
3249,RETROSPOT LAMP,7,188,12,1300,1112,1,24
3250,"FANCY FONT BIRTHDAY CARD, ",3,364,6,700,336,1,12
3251,HAND WARMER UNION JACK,7,1519,20,2100,581,1,40
3252,HAND WARMER SCOTTY DOG DESIGN,8,1460,17,1800,340,1,34
3253,HAND WARMER OWL DESIGN,4,114,7,800,686,1,14
3254,HAND WARMER RED RETROSPOT,4,482,24,2500,2018,1,48
3255,RETROSPOT HEART HOT WATER BOTTLE,8,580,14,1500,920,1,28
3256,DOG BOWL CHASING BALL DESIGN,10,1313,17,1800,487,1,34
3257,CLOTHES PEGS RETROSPOT PACK 26,10,1036,24,2500,1464,1,48
3258,HAND OVER THE CHOCOLATE   SIGN ,8,567,25,2600,2033,1,50
3259,WHITE HANGING HEART T-LIGHT HOLDER,6,161,14,1500,1339,1,28
3260,TRAVEL SEWING KIT,5,100,0,100,0,1,0
3261,BLACK HEART CARD HOLDER,9,246,3,400,154,1,6
3262,ASSORTED COLOUR BIRD ORNAMENT,8,1063,11,1200,137,1,22
3263,PACK OF 60 PINK PAISLEY CAKE CASES,5,158,5,600,442,1,10
3264,62 TEATIME FAIRY CAKE CASES,5,1879,19,2000,121,1,38
3265,PACK OF 72 RETROSPOT CAKE CASES,3,418,18,1900,1482,1,36
3266,CHICK GREY HOT WATER BOTTLE,1,839,19,2000,1161,1,38
3267,SMALL GLASS HEART TRINKET POT,3,379,8,900,521,1,16
3268,ALARM CLOCK BAKELIKE IVORY,4,720,16,1700,980,1,32
3269,ALARM CLOCK BAKELIKE RED ,6,1043,13,1400,357,1,26
3270,ALARM CLOCK BAKELIKE ORANGE,5,769,13,1400,631,1,26
3271,ALARM CLOCK BAKELIKE GREEN,10,572,16,1700,1128,1,32
3272,HOT WATER BOTTLE TEA AND SYMPATHY,3,824,8,900,76,1,16
3273,HAND WARMER BIRD DESIGN,2,149,1,200,51,1,2
3274,HAND WARMER SCOTTY DOG DESIGN,8,188,1,200,12,1,2
3275,WHITE HANGING HEART T-LIGHT HOLDER,9,1317,15,1600,283,1,30
3276,WHITE METAL LANTERN,6,250,11,1200,950,1,22
3277,CREAM CUPID HEARTS COAT HANGER,2,1941,20,2100,159,1,40
3278,EDWARDIAN PARASOL BLACK,6,1791,20,2100,309,1,40
3279,EDWARDIAN PARASOL RED,8,211,6,700,489,1,12
3280,RETRO COFFEE MUGS ASSORTED,5,926,10,1100,174,1,20
3281,SAVE THE PLANET MUG,3,130,3,400,270,1,6
3282,VINTAGE BILLBOARD DRINK ME MUG,8,325,3,400,75,1,6
3283,VINTAGE BILLBOARD LOVE/HATE MUG,10,1024,12,1300,276,1,24
3284,WOOD 2 DRAWER CABINET WHITE FINISH,5,100,0,100,0,1,0
3285,WOOD S/3 CABINET ANT WHITE FINISH,5,1284,21,2200,916,1,42
3286,WOODEN PICTURE FRAME WHITE FINISH,9,719,11,1200,481,1,22
3287,WOODEN FRAME ANTIQUE WHITE ,6,794,7,800,6,1,14
3288,KNITTED UNION FLAG HOT WATER BOTTLE,5,123,14,1500,1377,1,28
3289,RED WOOLLY HOTTIE WHITE HEART.,6,106,2,300,194,1,4
3290,SET 7 BABUSHKA NESTING BOXES,6,363,6,700,337,1,12
3291,IVORY EMBROIDERED QUILT ,8,1959,19,2000,41,1,38
3292,GLASS STAR FROSTED T-LIGHT HOLDER,2,326,4,500,174,1,8
3293,SET OF 3 BLACK FLYING DUCKS,2,164,5,600,436,1,10
3294,SET OF 3 COLOURED  FLYING DUCKS,8,331,21,2200,1869,1,42
3295,PACK OF 12 RED RETROSPOT TISSUES ,1,410,12,1300,890,1,24
3296,RED RETROSPOT MUG,10,1365,20,2100,735,1,40
3297,BABUSHKA LIGHTS STRING OF 12,6,171,1,200,29,1,2
3298,PIGGY BANK RETROSPOT ,9,794,11,1200,406,1,22
3299,SET 7 BABUSHKA NESTING BOXES,8,1750,17,1800,50,1,34
3300,DOORMAT FAIRY CAKE,7,1127,25,2600,1473,1,50
3301,HAND WARMER RED RETROSPOT,6,558,9,1000,442,1,18
3302,HAND WARMER SCOTTY DOG DESIGN,5,708,21,2200,1492,1,42
3303,HAND WARMER OWL DESIGN,7,1121,15,1600,479,1,30
3304,STRAWBERRY CERAMIC TRINKET BOX,2,2170,21,2200,30,1,42
3305,PINK DOUGHNUT TRINKET POT ,2,411,7,800,389,1,14
3306,SILK PURSE BABUSHKA PINK,5,1239,25,2600,1361,1,50
3307,HOT WATER BOTTLE TEA AND SYMPATHY,3,161,10,1100,939,1,20
3308,HOT WATER BOTTLE I AM SO POORLY,10,1365,17,1800,435,1,34
3309,CHOCOLATE HOT WATER BOTTLE,9,331,4,500,169,1,8
3310,WHITE SKULL HOT WATER BOTTLE ,8,1493,14,1500,7,1,28
3311,SCOTTIE DOG HOT WATER BOTTLE,5,124,2,300,176,1,4
3312,HAND WARMER RED POLKA DOT,10,145,3,400,255,1,6
3313,HAND WARMER UNION JACK,4,228,7,800,572,1,14
3314,HOMEMADE JAM SCENTED CANDLES,4,976,9,1000,24,1,18
3315,BIRD HOUSE HOT WATER BOTTLE,6,850,24,2500,1650,1,48
3316,BOUDOIR SQUARE TISSUE BOX,3,229,3,400,171,1,6
3317,SKULLS SQUARE TISSUE BOX,3,1171,14,1500,329,1,28
3318,PHOTO FRAME CORNICE,2,288,17,1800,1512,1,34
3319,SILK PURSE BABUSHKA RED,2,367,19,2000,1633,1,38
3320,PICTURE DOMINOES,1,144,1,200,56,1,2
3321,S/6 SEW ON CROCHET FLOWERS,9,240,2,300,60,1,4
3322,SCANDINAVIAN REDS RIBBONS,5,555,16,1700,1145,1,32
3323,BALLOONS  WRITING SET ,8,1255,24,2500,1245,1,48
3324,JAM MAKING SET PRINTED,5,703,24,2500,1797,1,48
3325,LAVENDER INCENSE IN TIN,6,1125,16,1700,575,1,32
3326,TV DINNER TRAY VINTAGE PAISLEY,9,157,7,800,643,1,14
3327,SET OF 4 ENGLISH ROSE PLACEMATS,6,320,15,1600,1280,1,30
3328,SET OF 4 ENGLISH ROSE COASTERS,2,184,2,300,116,1,4
3329,TRIPLE PHOTO FRAME CORNICE ,2,814,18,1900,1086,1,36
3330,FAMILY PHOTO FRAME CORNICE,8,372,4,500,128,1,8
3331,MIRRORED DISCO BALL ,1,261,6,700,439,1,12
3332,DISCO BALL ROTATOR BATTERY OPERATED,8,376,18,1900,1524,1,36
3333,SILVER LOOKING MIRROR,7,1169,20,2100,931,1,40
3334,LADIES & GENTLEMEN METAL SIGN,2,930,17,1800,870,1,34
3335,METAL SIGN HER DINNER IS SERVED ,3,1805,24,2500,695,1,48
3336,YOU'RE CONFUSING ME METAL SIGN ,7,1076,19,2000,924,1,38
3337,DOORMAT TOPIARY,1,1665,21,2200,535,1,42
3338,BATHROOM METAL SIGN,7,1798,20,2100,302,1,40
3339,KITCHEN METAL SIGN,1,171,4,500,329,1,8
3340,TOILET METAL SIGN,6,195,8,900,705,1,16
3341,METAL SIGN TAKE IT OR LEAVE IT ,8,261,2,300,39,1,4
3342,I'M ON HOLIDAY METAL SIGN,5,921,12,1300,379,1,24
3343,GROW YOUR OWN BASIL IN ENAMEL MUG,7,356,4,500,144,1,8
3344,SET/10 PINK POLKADOT PARTY CANDLES,1,309,17,1800,1491,1,34
3345,SET 20 NAPKINS FAIRY CAKES DESIGN ,4,430,12,1300,870,1,24
3346,62 TEATIME FAIRY CAKE CASES,6,171,17,1800,1629,1,34
3347,SET OF 6 T-LIGHTS SNOWMEN,3,1206,14,1500,294,1,28
3348,SET OF 6 T-LIGHTS SANTA,2,177,8,900,723,1,16
3349,SET OF 9 HEART SHAPED BALLOONS,4,498,21,2200,1702,1,42
3350,SANDWICH BATH SPONGE,8,221,5,600,379,1,10
3351,APPLE BATH SPONGE,3,1113,18,1900,787,1,36
3352,STRAWBERRY BATH SPONGE ,3,553,11,1200,647,1,22
3353,BLACK PIRATE TREASURE CHEST,6,1475,23,2400,925,1,46
3354,STAR PORTABLE TABLE LIGHT ,1,554,5,600,46,1,10
3355,SNOWFLAKE PORTABLE TABLE LIGHT ,8,881,13,1400,519,1,26
3356,PINK OVAL JEWELLED MIRROR,1,393,6,700,307,1,12
3357,RETROSPOT CIGAR BOX MATCHES ,3,896,14,1500,604,1,28
3358,COSY HOUR GIANT TUBE MATCHES,9,159,11,1200,1041,1,22
3359,JAZZ HEARTS PURSE NOTEBOOK,6,135,4,500,365,1,8
3360,LUNCH BAG DOLLY GIRL DESIGN,8,837,23,2400,1563,1,46
3361,WHITE HANGING HEART T-LIGHT HOLDER,1,2387,24,2500,113,1,48
3362,CANDLEHOLDER PINK HANGING HEART,1,1839,24,2500,661,1,48
3363,WOOD 2 DRAWER CABINET WHITE FINISH,10,223,10,1100,877,1,20
3364,ASSORTED COLOUR MINI CASES,4,417,5,600,183,1,10
3365,LUNCH BAG RED RETROSPOT,10,100,0,100,0,1,0
3366,LUNCH BAG SPACEBOY DESIGN ,2,1273,13,1400,127,1,26
3367,LUNCH BAG WOODLAND,5,269,3,400,131,1,6
3368,LUNCH BAG PINK POLKADOT,4,329,19,2000,1671,1,38
3369,GUMBALL COAT RACK,10,215,17,1800,1585,1,34
3370,BLUE NEW BAROQUE CANDLESTICK CANDLE,2,346,4,500,154,1,8
3371,PINK NEW BAROQUECANDLESTICK CANDLE,6,310,6,700,390,1,12
3372,FAIRY CAKE FLANNEL ASSORTED COLOUR,6,2378,23,2400,22,1,46
3373,BREAD BIN DINER STYLE PINK,2,323,15,1600,1277,1,30
3374,JUMBO BAG CHARLIE AND LOLA TOYS,10,1731,18,1900,169,1,36
3375,TEA TIME TABLE CLOTH,5,282,2,300,18,1,4
3376,ENGLISH ROSE HOT WATER BOTTLE,8,169,3,400,231,1,6
3377,ENAMEL FIRE BUCKET CREAM,1,1469,20,2100,631,1,40
3378,PICNIC BASKET WICKER SMALL,8,353,9,1000,647,1,18
3379,PAPER CHAIN KIT 50'S CHRISTMAS ,4,100,1,200,100,1,2
3380,PAPER CHAIN KIT VINTAGE CHRISTMAS,5,1982,24,2500,518,1,48
3381,HOT WATER BOTTLE BABUSHKA ,3,1114,21,2200,1086,1,42
3382,HAND WARMER BIRD DESIGN,5,132,21,2200,2068,1,42
3383,POSTAGE,6,506,13,1400,894,1,26
3384,HEART IVORY TRELLIS SMALL,8,449,4,500,51,1,8
3385,CLEAR DRAWER KNOB ACRYLIC EDWARDIAN,2,1270,12,1300,30,1,24
3386,PINK DRAWER KNOB ACRYLIC EDWARDIAN,4,1590,24,2500,910,1,48
3387,GREEN DRAWER KNOB ACRYLIC EDWARDIAN,3,924,18,1900,976,1,36
3388,BLUE DRAWER KNOB ACRYLIC EDWARDIAN,6,175,5,600,425,1,10
3389,HEART OF WICKER SMALL,4,401,5,600,199,1,10
3390,SMALL POPCORN HOLDER,7,719,19,2000,1281,1,38
3391,SET 6 FOOTBALL CELEBRATION CANDLES,7,138,12,1300,1162,1,24
3392,SET OF 6 GIRLS CELEBRATION CANDLES,4,310,9,1000,690,1,18
3393,ROMANTIC PINKS RIBBONS ,9,788,8,900,112,1,16
3394,BRIGHT BLUES RIBBONS ,3,1374,15,1600,226,1,30
3395,SCANDINAVIAN REDS RIBBONS,3,553,8,900,347,1,16
3396,CHOCOLATE BOX RIBBONS ,4,133,21,2200,2067,1,42
3397,PARTY INVITES FOOTBALL,2,681,9,1000,319,1,18
3398,PARTY INVITES JAZZ HEARTS,1,642,21,2200,1558,1,42
3399,PARTY INVITES SPACEMAN,3,100,0,100,0,1,0
3400,SET OF 3 BUTTERFLY COOKIE CUTTERS,6,669,6,700,31,1,12
3401,SET OF 3 HEART COOKIE CUTTERS,9,824,12,1300,476,1,24
3402,5 PIECE SPACEBOY COOKIE CUTTER SET,3,1751,17,1800,49,1,34
3403,PACK OF 72 SKULL CAKE CASES,9,100,0,100,0,1,0
3404,PACK OF 60 SPACEBOY CAKE CASES,6,1374,17,1800,426,1,34
3405,PACK OF 72 RETROSPOT CAKE CASES,9,2107,22,2300,193,1,44
3406,74 SWEETHEART FAIRY CAKE CASES,3,133,6,700,567,1,12
3407,PACK OF 60 DINOSAUR CAKE CASES,1,802,19,2000,1198,1,38
3408,LUNCH BAG SUKI  DESIGN ,10,1656,17,1800,144,1,34
3409,LUNCH BAG CARS BLUE,3,465,8,900,435,1,16
3410,LUNCH BAG  BLACK SKULL.,9,126,2,300,174,1,4
3411,HEART IVORY TRELLIS LARGE,1,923,13,1400,477,1,26
3412,SET/5 RED RETROSPOT LID GLASS BOWLS,1,230,10,1100,870,1,20
3413,WHITE HANGING HEART T-LIGHT HOLDER,3,636,24,2500,1864,1,48
3414,WHITE METAL LANTERN,4,105,13,1400,1295,1,26
3415,CREAM CUPID HEARTS COAT HANGER,6,1376,22,2300,924,1,44
3416,EDWARDIAN PARASOL RED,2,609,6,700,91,1,12
3417,RETRO COFFEE MUGS ASSORTED,3,302,4,500,198,1,8
3418,SAVE THE PLANET MUG,4,262,2,300,38,1,4
3419,VINTAGE BILLBOARD DRINK ME MUG,4,626,14,1500,874,1,28
3420,VINTAGE BILLBOARD LOVE/HATE MUG,10,823,24,2500,1677,1,48
3421,WOOD 2 DRAWER CABINET WHITE FINISH,3,712,23,2400,1688,1,46
3422,WOOD S/3 CABINET ANT WHITE FINISH,2,170,6,700,530,1,12
3423,WOODEN PICTURE FRAME WHITE FINISH,2,232,18,1900,1668,1,36
3424,WOODEN FRAME ANTIQUE WHITE ,8,270,11,1200,930,1,22
3425,KNITTED UNION FLAG HOT WATER BOTTLE,8,2259,22,2300,41,1,44
3426,RED WOOLLY HOTTIE WHITE HEART.,4,949,12,1300,351,1,24
3427,SET 7 BABUSHKA NESTING BOXES,2,1159,22,2300,1141,1,44
3428,IVORY EMBROIDERED QUILT ,1,341,19,2000,1659,1,38
3429,GLASS STAR FROSTED T-LIGHT HOLDER,3,223,15,1600,1377,1,30
3430,HAND WARMER RED POLKA DOT,3,180,24,2500,2320,1,48
3431,HAND WARMER UNION JACK,6,313,10,1100,787,1,20
3432,MAGIC DRAWING SLATE DINOSAUR,4,1053,10,1100,47,1,20
3433,MAGIC DRAWING SLATE BAKE A CAKE ,8,1193,24,2500,1307,1,48
3434,14 PENCILS TALL TUBE SKULLS,7,283,5,600,317,1,10
3435,CHOCOLATE CALCULATOR,3,236,3,400,164,1,6
3436,RED  HARMONICA IN BOX ,7,793,17,1800,1007,1,34
3437,BLUE HARMONICA IN BOX ,6,699,16,1700,1001,1,32
3438,SKULLS  WATER TRANSFER TATTOOS ,6,432,5,600,168,1,10
3439,PACK 3 BOXES BIRD PANNETONE ,7,1675,24,2500,825,1,48
3440,HOT WATER BOTTLE TEA AND SYMPATHY,10,543,12,1300,757,1,24
3441,RED WOOLLY HOTTIE WHITE HEART.,2,1050,16,1700,650,1,32
3442,WHITE SKULL HOT WATER BOTTLE ,7,779,9,1000,221,1,18
3443,5 PIECE SPACEBOY COOKIE CUTTER SET,8,100,0,100,0,1,0
3444,SET OF 20 KIDS COOKIE CUTTERS,10,241,6,700,459,1,12
3445,12 COLOUR SPACEBOY PEN,9,2267,23,2400,133,1,46
3446,VICTORIAN GLASS HANGING T-LIGHT,5,1204,16,1700,496,1,32
3447,SINGLE HEART ZINC T-LIGHT HOLDER,9,914,20,2100,1186,1,40
3448,RED HANGING HEART T-LIGHT HOLDER,1,1446,17,1800,354,1,34
3449,HANGING METAL STAR LANTERN,3,528,5,600,72,1,10
3450,SILVER HANGING T-LIGHT HOLDER,4,100,0,100,0,1,0
3451,DOORMAT RED RETROSPOT,1,275,10,1100,825,1,20
3452,DOORMAT HEARTS,10,232,3,400,168,1,6
3453,NATURAL SLATE RECTANGLE CHALKBOARD,2,375,5,600,225,1,10
3454,LOVEBIRD HANGING DECORATION WHITE ,9,1117,19,2000,883,1,38
3455,ASSORTED COLOUR BIRD ORNAMENT,6,216,4,500,284,1,8
3456,HOME BUILDING BLOCK WORD,3,377,4,500,123,1,8
3457,LOVE BUILDING BLOCK WORD,4,1230,15,1600,370,1,30
3458,PHOTO FRAME CORNICE,2,910,12,1300,390,1,24
3459,PENS ASSORTED FUNNY FACE,8,298,12,1300,1002,1,24
3460,CARD CIRCUS PARADE,5,578,8,900,322,1,16
3461,WRAP COWBOYS  ,8,122,1,200,78,1,2
3462,AIRLINE BAG VINTAGE TOKYO 80,4,730,7,800,70,1,14
3463,RED RETROSPOT UMBRELLA,8,106,17,1800,1694,1,34
3464,BLACK/BLUE POLKADOT UMBRELLA,8,133,5,600,467,1,10
3465,RED 3 PIECE RETROSPOT CUTLERY SET,3,490,13,1400,910,1,26
3466,PACK OF 72 RETROSPOT CAKE CASES,2,446,9,1000,554,1,18
3467,SET OF 72 RETROSPOT PAPER  DOILIES,8,1314,17,1800,486,1,34
3468,BLUE COAT RACK PARIS FASHION,3,1568,16,1700,132,1,32
3469,PLASTERS IN TIN SKULLS,10,637,7,800,163,1,14
3470,SLEEPING CAT ERASERS,9,807,11,1200,393,1,22
3471,CARD BIRTHDAY COWBOY,10,110,18,1900,1790,1,36
3472,PACK 3 BOXES CHRISTMAS PANNETONE,3,296,3,400,104,1,6
3473,ROTATING SILVER ANGELS T-LIGHT HLDR,1,939,12,1300,361,1,24
3474,COSY HOUR GIANT TUBE MATCHES,2,762,18,1900,1138,1,36
3475,RIBBON REEL MAKING SNOWMEN ,1,1354,24,2500,1146,1,48
3476,MINI PAINT SET VINTAGE ,10,333,4,500,167,1,8
3477,6 TRADITIONAL SPINNING TOPS,5,1105,18,1900,795,1,36
3478,SET OF 6 SOLDIER SKITTLES,7,204,3,400,196,1,6
3479,BAG 500g SWIRLY MARBLES,8,994,12,1300,306,1,24
3480,7 STRAND GLASS NECKLACE CRYSTAL,2,376,17,1800,1424,1,34
3481,WHITE SKULL HOT WATER BOTTLE ,6,319,3,400,81,1,6
3482,SCOTTIE DOG HOT WATER BOTTLE,1,591,7,800,209,1,14
3483,SQUARECUSHION COVER PINK UNION FLAG,10,100,0,100,0,1,0
3484,SPACEBOY CHILDRENS EGG CUP,4,1308,23,2400,1092,1,46
3485,CHILDREN'S SPACEBOY MUG,10,1384,22,2300,916,1,44
3486,HAND WARMER SCOTTY DOG DESIGN,2,428,11,1200,772,1,22
3487,FELTCRAFT CUSHION OWL,10,100,0,100,0,1,0
3488,BLACK CANDELABRA T-LIGHT HOLDER,5,927,25,2600,1673,1,50
3489,TOY TIDY DOLLY GIRL DESIGN,8,1158,11,1200,42,1,22
3490,SET 12 LAVENDER  BOTANICAL T-LIGHTS,2,1256,23,2400,1144,1,46
3491,UNION JACK FLAG LUGGAGE TAG,1,100,0,100,0,1,0
3492,RED HEART LUGGAGE TAG,1,1427,14,1500,73,1,28
3493,RED GLASS TASSLE BAG CHARM,2,675,11,1200,525,1,22
3494,CLEAR ACRYLIC FACETED BANGLE,10,306,17,1800,1494,1,34
3495,7 STRAND GLASS NECKLACE CRYSTAL,3,1283,25,2600,1317,1,50
3496,DOORMAT UNION JACK GUNS AND ROSES,4,213,8,900,687,1,16
3497,VANILLA SCENT CANDLE JEWELLED BOX,10,172,6,700,528,1,12
3498,FULL ENGLISH BREAKFAST PLATE,5,570,16,1700,1130,1,32
3499,BLACK CANDELABRA T-LIGHT HOLDER,7,696,21,2200,1504,1,42
3500,MAGIC DRAWING SLATE CIRCUS PARADE  ,7,1610,18,1900,290,1,36
3501,CHRISTMAS HANGING HEART WITH BELL,3,226,8,900,674,1,16
3502,CAKE STAND VICTORIAN FILIGREE MED,10,334,6,700,366,1,12
3503,PAISLEY PATTERN  STICKERS,4,902,18,1900,998,1,36
3504,FLOWERS  STICKERS,3,318,11,1200,882,1,22
3505,PINK NEW BAROQUECANDLESTICK CANDLE,5,874,21,2200,1326,1,42
3506,BLUE NEW BAROQUE CANDLESTICK CANDLE,2,166,1,200,34,1,2
3507,JUMBO STORAGE BAG SUKI,6,699,7,800,101,1,14
3508,BLACK LOVE BIRD CANDLE,5,1256,13,1400,144,1,26
3509,PARTY TIME PENCIL ERASERS,2,388,20,2100,1712,1,40
3510,DISCO BALL CHRISTMAS DECORATION,2,238,3,400,162,1,6
3511,PINK B'FLY C/COVER W BOBBLES,4,1456,20,2100,644,1,40
3512,PINK UNION JACK  LUGGAGE TAG,4,220,11,1200,980,1,22
3513,8 RIBBONS ELEGANT CHRISTMAS ,1,1021,21,2200,1179,1,42
3514,UNION JACK FLAG LUGGAGE TAG,4,1671,20,2100,429,1,40
3515,AGED GLASS SILVER T-LIGHT HOLDER,3,2415,24,2500,85,1,48
3516,BOOM BOX SPEAKER GIRLS,1,186,11,1200,1014,1,22
3517,8 RIBBONS SHIMMERING PINKS ,7,869,10,1100,231,1,20
3518, SET 2 TEA TOWELS I LOVE LONDON ,9,919,12,1300,381,1,24
3519,JUMBO BAG OWLS,6,100,0,100,0,1,0
3520,SANDWICH BATH SPONGE,10,1347,14,1500,153,1,28
3521,OWL DOORSTOP,7,131,1,200,69,1,2
3522,7 STRAND GLASS NECKLACE CRYSTAL,5,285,15,1600,1315,1,30
3523,HAND WARMER UNION JACK,9,1550,15,1600,50,1,30
3524,HAND WARMER SCOTTY DOG DESIGN,10,529,9,1000,471,1,18
3525,LARGE POPCORN HOLDER ,4,100,0,100,0,1,0
3526,PAINTED METAL STAR WITH HOLLY BELLS,5,937,24,2500,1563,1,48
3527,PAINTED METAL HEART WITH HOLLY BELL,8,1998,19,2000,2,1,38
3528,ANGEL DECORATION STARS ON DRESS,3,989,12,1300,311,1,24
3529,SMALL POPCORN HOLDER,9,928,11,1200,272,1,22
3530,JUMBO BAG RED RETROSPOT,7,594,9,1000,406,1,18
3531,JUMBO BAG STRAWBERRY,2,1260,17,1800,540,1,34
3532,STRAWBERRY SHOPPER BAG,8,100,0,100,0,1,0
3533,STRAWBERRY CHARLOTTE BAG,3,939,10,1100,161,1,20
3534, SET 2 TEA TOWELS I LOVE LONDON ,9,844,10,1100,256,1,20
3535,PACK OF 12 RED RETROSPOT TISSUES ,10,1140,11,1200,60,1,22
3536,SCOTTIE DOG HOT WATER BOTTLE,8,231,3,400,169,1,6
3537,CHOCOLATE HOT WATER BOTTLE,1,398,21,2200,1802,1,42
3538,LUNCH BAG CARS BLUE,10,190,4,500,310,1,8
3539,LUNCH BAG SPACEBOY DESIGN ,5,345,22,2300,1955,1,44
3540,ROUND SNACK BOXES SET OF4 WOODLAND ,10,158,13,1400,1242,1,26
3541,LUNCH BAG DOLLY GIRL DESIGN,9,572,20,2100,1528,1,40
3542,LUNCH BAG SUKI  DESIGN ,6,536,13,1400,864,1,26
3543,LUNCH BAG  BLACK SKULL.,9,1144,21,2200,1056,1,42
3544,ROUND SNACK BOXES SET OF 4 FRUITS ,5,100,0,100,0,1,0
3545,ROUND SNACK BOXES SET OF 4 SKULLS,6,706,10,1100,394,1,20
3546,DOLLY GIRL LUNCH BOX,9,123,6,700,577,1,12
3547,SPACEBOY LUNCH BOX ,4,281,5,600,319,1,10
3548,GREEN POLKADOT PLATE ,8,362,6,700,338,1,12
3549,BLUE POLKADOT PLATE ,8,2281,23,2400,119,1,46
3550,RED RETROSPOT PLATE ,10,201,2,300,99,1,4
3551,PINK  POLKADOT PLATE ,3,1636,19,2000,364,1,38
3552,ROUND SNACK BOXES SET OF 4 SKULLS,5,635,10,1100,465,1,20
3553,FELTCRAFT DOLL MOLLY,7,1527,15,1600,73,1,30
3554,FELTCRAFT CHRISTMAS FAIRY,9,134,5,600,466,1,10
3555,TRAVEL SEWING KIT,10,161,3,400,239,1,6
3556,SET OF 3 NOTEBOOKS IN PARCEL,8,567,10,1100,533,1,20
3557,RED RETROSPOT TAPE,10,1400,19,2000,600,1,38
3558,COSY SLIPPER SHOES SMALL  RED ,5,242,13,1400,1158,1,26
3559,8 RIBBONS RUSTIC CHARM,8,637,14,1500,863,1,28
3560,SCANDINAVIAN REDS RIBBONS,2,1105,11,1200,95,1,22
3561,JAM MAKING SET PRINTED,2,2340,25,2600,260,1,50
3562,14 DAISY PEGS IN WOOD BOX,7,1301,20,2100,799,1,40
3563,HOT WATER BOTTLE BABUSHKA ,7,1255,22,2300,1045,1,44
3564,FELTCRAFT PRINCESS CHARLOTTE DOLL,3,627,13,1400,773,1,26
3565,FELTCRAFT CHRISTMAS FAIRY,9,1040,15,1600,560,1,30
3566,FELTCRAFT PRINCESS CHARLOTTE DOLL,10,1907,19,2000,93,1,38
3567,8 RIBBONS RUSTIC CHARM,10,485,12,1300,815,1,24
3568,COSY SLIPPER SHOES SMALL  RED ,9,477,4,500,23,1,8
3569,SCANDINAVIAN REDS RIBBONS,5,609,20,2100,1491,1,40
3570,7 HOOK HANGER RED MAGIC TOADSTOOL,4,355,12,1300,945,1,24
3571,CHRISTMAS CRAFT TREE TOP ANGEL,6,429,7,800,371,1,14
3572,CHRISTMAS CRAFT LITTLE FRIENDS,1,150,9,1000,850,1,18
3573,7 HOOK HANGER RED MAGIC TOADSTOOL,6,358,8,900,542,1,16
3574,8 RIBBONS RUSTIC CHARM,2,265,17,1800,1535,1,34
3575,14 DAISY PEGS IN WOOD BOX,3,401,23,2400,1999,1,46
3576,SET OF 3 NOTEBOOKS IN PARCEL,9,722,8,900,178,1,16
3577,7 HOOK HANGER MAGIC TOADSTOOL,9,122,9,1000,878,1,18
3578,SCANDINAVIAN REDS RIBBONS,1,149,12,1300,1151,1,24
3579,RED TOADSTOOL LED NIGHT LIGHT,3,892,8,900,8,1,16
3580,7 HOOK HANGER RED MAGIC TOADSTOOL,1,108,4,500,392,1,8
3581,COSY SLIPPER SHOES SMALL GREEN,3,1298,18,1900,602,1,36
3582,COSY SLIPPER SHOES SMALL  RED ,9,1184,17,1800,616,1,34
3583,FELTCRAFT DOLL ROSIE,3,1266,14,1500,234,1,28
3584,FELTCRAFT DOLL MOLLY,9,1600,17,1800,200,1,34
3585,FELTCRAFT DOLL EMILY,10,136,1,200,64,1,2
3586,FELTCRAFT PRINCESS CHARLOTTE DOLL,7,777,9,1000,223,1,18
3587,FELTCRAFT PRINCESS OLIVIA DOLL,9,1572,19,2000,428,1,38
3588,REX CASH+CARRY JUMBO SHOPPER,4,468,23,2400,1932,1,46
3589,FELTCRAFT DOLL MOLLY,5,102,1,200,98,1,2
3590,FELTCRAFT CUSHION OWL,8,276,20,2100,1824,1,40
3591,CHRISTMAS CRAFT TREE TOP ANGEL,5,912,9,1000,88,1,18
3592,CHRISTMAS CRAFT LITTLE FRIENDS,10,323,3,400,77,1,6
3593,FELTCRAFT CUSHION RABBIT,9,188,2,300,112,1,4
3594,FELTCRAFT CUSHION BUTTERFLY,4,177,2,300,123,1,4
3595,14 DAISY PEGS IN WOOD BOX,1,983,22,2300,1317,1,44
3596,PAPER CHAIN KIT 50'S CHRISTMAS ,2,1197,14,1500,303,1,28
3597,FELTCRAFT CUSHION BUTTERFLY,8,2097,24,2500,403,1,48
3598,14 DAISY PEGS IN WOOD BOX,5,128,20,2100,1972,1,40
3599,ROSE COTTAGE KEEPSAKE BOX ,7,184,18,1900,1716,1,36
3600,TOTE BAG I LOVE LONDON,6,1349,14,1500,151,1,28
3601,14 DAISY PEGS IN WOOD BOX,2,1306,18,1900,594,1,36
3602,TOTE BAG I LOVE LONDON,10,235,15,1600,1365,1,30
3603,FOLDING UMBRELLA PINKWHITE POLKADOT,8,1429,18,1900,471,1,36
3604,FOLDING UMBRELLA CREAM POLKADOT,3,123,2,300,177,1,4
3605,FOLDING UMBRELLA WHITE/RED POLKADOT,2,314,3,400,86,1,6
3606,SET 10 LIGHTS NIGHT OWL,3,153,10,1100,947,1,20
3607,SMALL POPCORN HOLDER,2,2367,24,2500,133,1,48
3608, SET 2 TEA TOWELS I LOVE LONDON ,9,588,6,700,112,1,12
3609,FOLDING UMBRELLA RED/WHITE POLKADOT,5,1088,11,1200,112,1,22
3610,BABUSHKA LIGHTS STRING OF 12,9,1565,25,2600,1035,1,50
3611,LUNCH BAG RED RETROSPOT,7,755,25,2600,1845,1,50
3612,S/4 VALENTINE DECOUPAGE HEART BOX,2,111,10,1100,989,1,20
3613,FOLDING UMBRELLA CREAM POLKADOT,7,356,23,2400,2044,1,46
3614, SET 2 TEA TOWELS I LOVE LONDON ,10,253,21,2200,1947,1,42
3615,FOLDING UMBRELLA RED/WHITE POLKADOT,1,824,13,1400,576,1,26
3616,SOLDIERS EGG CUP ,2,860,21,2200,1340,1,42
3617,S/4 VALENTINE DECOUPAGE HEART BOX,3,916,25,2600,1684,1,50
3618,RED RETROSPOT MINI CASES,3,807,9,1000,193,1,18
3619,,9,1748,24,2500,752,1,48
3620,62 CAKE CASES VINTAGE CHRISTMAS,7,103,8,900,797,1,16
3621,PAPER CHAIN KIT VINTAGE CHRISTMAS,6,708,16,1700,992,1,32
3622,RIBBON REEL CHRISTMAS SOCK BAUBLE,1,1446,22,2300,854,1,44
3623,RIBBON REEL SNOWY VILLAGE,7,148,8,900,752,1,16
3624,RIBBON REEL MAKING SNOWMEN ,6,1100,14,1500,400,1,28
3625,SET OF 20 VINTAGE CHRISTMAS NAPKINS,3,267,9,1000,733,1,18
3626,TURQUOISE CHRISTMAS TREE ,4,245,2,300,55,1,4
3627,RED STAR CARD HOLDER,4,2273,24,2500,227,1,48
3628,WICKER WREATH SMALL,4,1313,13,1400,87,1,26
3629,HEART OF WICKER LARGE,7,508,13,1400,892,1,26
3630,ADVENT CALENDAR GINGHAM SACK,1,1080,12,1300,220,1,24
3631,HEART OF WICKER SMALL,4,310,17,1800,1490,1,34
3632,FELTCRAFT BUTTERFLY HEARTS,5,407,10,1100,693,1,20
3633,PARTY CONE CHRISTMAS DECORATION ,9,239,20,2100,1861,1,40
3634,VINTAGE HEADS AND TAILS CARD GAME ,2,140,2,300,160,1,4
3635,WICKER STAR ,4,226,2,300,74,1,4
3636,VINTAGE SNAP CARDS,10,242,22,2300,2058,1,44
3637,FELTCRAFT 6 FLOWER FRIENDS,5,493,21,2200,1707,1,42
3638, SET 2 TEA TOWELS I LOVE LONDON ,6,545,5,600,55,1,10
3639,JAM MAKING SET PRINTED,4,2473,24,2500,27,1,48
3640,BIRD DECORATION RED RETROSPOT,3,164,4,500,336,1,8
3641,CHRISTMAS GINGHAM TREE,6,1589,20,2100,511,1,40
3642,CHRISTMAS GINGHAM STAR,2,386,16,1700,1314,1,32
3643,CHRISTMAS GINGHAM HEART,9,197,21,2200,2003,1,42
3644,PACK OF 12 PINK POLKADOT TISSUES,6,830,15,1600,770,1,30
3645,FELTCRAFT PRINCESS LOLA DOLL,9,399,3,400,1,1,6
3646,PACK OF 12 LONDON TISSUES ,7,451,19,2000,1549,1,38
3647,PURPLE DRAWERKNOB ACRYLIC EDWARDIAN,2,782,9,1000,218,1,18
3648,CHILDREN'S APRON DOLLY GIRL ,9,1209,20,2100,891,1,40
3649,CHILDRENS APRON SPACEBOY DESIGN,10,100,0,100,0,1,0
3650,CHRISTMAS LIGHTS 10 SANTAS ,7,100,0,100,0,1,0
3651,CHRISTMAS LIGHTS 10 REINDEER,1,217,25,2600,2383,1,50
3652,PAPER CHAIN KIT 50'S CHRISTMAS ,6,225,20,2100,1875,1,40
3653,FELTCRAFT CHRISTMAS FAIRY,5,190,15,1600,1410,1,30
3654,PACK OF 72 RETROSPOT CAKE CASES,8,1659,23,2400,741,1,46
3655,PACK OF 60 MUSHROOM CAKE CASES,7,620,16,1700,1080,1,32
3656,62 CAKE CASES DOLLY GIRL DESIGN,6,315,3,400,85,1,6
3657,PACK OF 60 PINK PAISLEY CAKE CASES,8,351,11,1200,849,1,22
3658,HAND WARMER BABUSHKA DESIGN,4,900,23,2400,1500,1,46
3659,HAND WARMER BIRD DESIGN,4,1097,20,2100,1003,1,40
3660,HAND WARMER OWL DESIGN,6,929,13,1400,471,1,26
3661,HAND WARMER RED RETROSPOT,6,265,6,700,435,1,12
3662,SET 12 RETRO WHITE CHALK STICKS,1,427,6,700,273,1,12
3663,FELTCRAFT HAIRBAND RED AND BLUE,5,143,1,200,57,1,2
3664,FELTCRAFT HAIRBAND PINK AND PURPLE,10,1200,15,1600,400,1,30
3665,FELTCRAFT HAIRBANDS PINK AND WHITE ,3,334,12,1300,966,1,24
3666,TV DINNER TRAY DOLLY GIRL,10,126,1,200,74,1,2
3667,PLASTERS IN TIN VINTAGE PAISLEY ,1,1007,19,2000,993,1,38
3668,PLASTERS IN TIN SPACEBOY,1,900,20,2100,1200,1,40
3669,PLASTERS IN TIN WOODLAND ANIMALS,10,169,1,200,31,1,2
3670,MAGIC DRAWING SLATE SPACEBOY ,5,651,8,900,249,1,16
3671,MAGIC DRAWING SLATE CIRCUS PARADE  ,8,247,6,700,453,1,12
3672,MAGIC DRAWING SLATE GO TO THE FAIR ,3,195,2,300,105,1,4
3673,MAGIC DRAWING SLATE DOLLY GIRL ,3,1281,16,1700,419,1,32
3674,CHARLIE + LOLA RED HOT WATER BOTTLE,6,323,8,900,577,1,16
3675,HOT WATER BOTTLE BABUSHKA ,7,258,5,600,342,1,10
3676,URBAN BLACK RIBBONS ,3,594,5,600,6,1,10
3677,FELTCRAFT PRINCESS CHARLOTTE DOLL,10,455,13,1400,945,1,26
3678,SET OF 6 T-LIGHTS TOADSTOOLS,1,1328,17,1800,472,1,34
3679,ROTATING LEAVES T-LIGHT HOLDER,3,205,12,1300,1095,1,24
3680,RED  HARMONICA IN BOX ,8,449,5,600,151,1,10
3681,CUPCAKE LACE PAPER SET 8,3,1633,24,2500,867,1,48
3682,FAMILY PHOTO FRAME CORNICE,6,404,4,500,96,1,8
3683,TRIPLE PHOTO FRAME CORNICE ,1,158,4,500,342,1,8
3684,WOODEN FRAME ANTIQUE WHITE ,1,1676,17,1800,124,1,34
3685,WOODEN BOX OF DOMINOES,1,145,4,500,355,1,8
3686,TRADITIONAL WOODEN CATCH CUP GAME ,4,1205,19,2000,795,1,38
3687,TRADITIONAL WOODEN SKIPPING ROPE,10,208,20,2100,1892,1,40
3688,S/6 WOODEN SKITTLES IN COTTON BAG,10,693,12,1300,607,1,24
3689,RED METAL BEACH SPADE ,3,199,6,700,501,1,12
3690,BOYS VINTAGE TIN SEASIDE BUCKET,6,599,25,2600,2001,1,50
3691,GIRLS VINTAGE TIN SEASIDE BUCKET,1,831,18,1900,1069,1,36
3692,GREY HEART HOT WATER BOTTLE,2,354,8,900,546,1,16
3693,SCOTTIE DOG HOT WATER BOTTLE,7,1323,23,2400,1077,1,46
3694,BIRD HOUSE HOT WATER BOTTLE,3,1962,21,2200,238,1,42
3695,KINGS CHOICE TEA CADDY ,7,122,21,2200,2078,1,42
3696,KINGS CHOICE BISCUIT TIN,2,589,7,800,211,1,14
3697,METAL SIGN EMPIRE TEA,2,196,6,700,504,1,12
3698,HOMEMADE JAM SCENTED CANDLES,1,1677,19,2000,323,1,38
3699,SET OF 6 SOLDIER SKITTLES,9,195,3,400,205,1,6
3700,FAWN BLUE HOT WATER BOTTLE,1,300,25,2600,2300,1,50
3701,HAND WARMER RED RETROSPOT,1,597,6,700,103,1,12
3702,HOT WATER BOTTLE BABUSHKA ,1,875,20,2100,1225,1,40
3703,WHITE SKULL HOT WATER BOTTLE ,10,526,6,700,174,1,12
3704,RETROSPOT HEART HOT WATER BOTTLE,9,389,13,1400,1011,1,26
3705,RED WOOLLY HOTTIE WHITE HEART.,4,1763,24,2500,737,1,48
3706,SCOTTIE DOG HOT WATER BOTTLE,7,333,9,1000,667,1,18
3707,GREY HEART HOT WATER BOTTLE,2,395,12,1300,905,1,24
3708,HOT WATER BOTTLE BABUSHKA ,3,238,4,500,262,1,8
3709,PACK OF 6 BIRDY GIFT TAGS,8,1343,25,2600,1257,1,50
3710,CHILLI LIGHTS,4,164,12,1300,1136,1,24
3711,PIGGY BANK RETROSPOT ,5,954,15,1600,646,1,30
3712,CERAMIC STRAWBERRY MONEY BOX,3,400,21,2200,1800,1,42
3713,CERAMIC STRAWBERRY CAKE MONEY BANK,2,311,15,1600,1289,1,30
3714,CERAMIC CHERRY CAKE MONEY BANK,3,366,24,2500,2134,1,48
3715,CERAMIC HEART FAIRY CAKE MONEY BANK,8,1120,21,2200,1080,1,42
3716,CERAMIC PIRATE CHEST MONEY BANK,6,1503,16,1700,197,1,32
3717,DOORSTOP RETROSPOT HEART,8,1484,19,2000,516,1,38
3718,GINGHAM HEART  DOORSTOP RED,6,782,8,900,118,1,16
3719,RETROSPOT BABUSHKA DOORSTOP,4,246,2,300,54,1,4
3720,SILK PURSE BABUSHKA RED,1,744,17,1800,1056,1,34
3721,SILK PURSE BABUSHKA PINK,2,813,22,2300,1487,1,44
3722,FAMILY PHOTO FRAME CORNICE,8,553,13,1400,847,1,26
3723,SWEETHEART WIRE WALL TIDY,4,260,2,300,40,1,4
3724,JAM MAKING SET PRINTED,2,2082,20,2100,18,1,40
3725,RED RETROSPOT OVEN GLOVE ,2,989,12,1300,311,1,24
3726,CREAM HEART CARD HOLDER,9,186,17,1800,1614,1,34
3727,NAMASTE SWAGAT INCENSE,3,708,16,1700,992,1,32
3728,CERAMIC STRAWBERRY DESIGN MUG,8,396,7,800,404,1,14
3729,BLACK HEART CARD HOLDER,2,204,3,400,196,1,6
3730,CLASSICAL ROSE SMALL VASE,1,584,9,1000,416,1,18
3731,HYACINTH BULB T-LIGHT CANDLES,2,102,1,200,98,1,2
3732,CHRISTMAS CRAFT WHITE FAIRY ,8,1295,15,1600,305,1,30
3733,CHRISTMAS CRAFT LITTLE FRIENDS,6,696,6,700,4,1,12
3734,COSY HOUR CIGAR BOX MATCHES ,3,112,1,200,88,1,2
3735,RED TEA TOWEL CLASSIC DESIGN,10,464,12,1300,836,1,24
3736,HEART FILIGREE DOVE  SMALL,7,709,12,1300,591,1,24
3737,RETROSPOT CHILDRENS APRON,6,640,11,1200,560,1,22
3738,COLOURING PENCILS BROWN TUBE,5,1042,10,1100,58,1,20
3739,6 IVORY DINNER CANDLES SILVER FLOCK,4,293,8,900,607,1,16
3740,HEART FILIGREE DOVE  SMALL,10,1986,24,2500,514,1,48
3741,ZINC METAL HEART DECORATION,6,833,16,1700,867,1,32
3742,GREEN FERN NOTEBOOK,7,258,12,1300,1042,1,24
3743,BLUE PAISLEY NOTEBOOK,3,1974,23,2400,426,1,46
3744,CHRYSANTHEMUM NOTEBOOK,9,1247,18,1900,653,1,36
3745,LARGE CHINESE STYLE SCISSOR,3,637,6,700,63,1,12
3746,SMALL CHINESE STYLE SCISSOR,5,331,5,600,269,1,10
3747,S/6 WOODEN SKITTLES IN COTTON BAG,6,1466,18,1900,434,1,36
3748,TRADITIONAL WOODEN SKIPPING ROPE,4,837,11,1200,363,1,22
3749,SET OF 6 SOLDIER SKITTLES,9,2400,25,2600,200,1,50
3750,6 TRADITIONAL SPINNING TOPS,9,1447,19,2000,553,1,38
3751,ROTATING SILVER ANGELS T-LIGHT HLDR,10,813,12,1300,487,1,24
3752,BLACK LOVE BIRD CANDLE,6,760,15,1600,840,1,30
3753,RETROSPOT CHILDRENS APRON,10,258,8,900,642,1,16
3754,HANGING GLASS ETCHED TEALIGHT,2,1648,16,1700,52,1,32
3755,HANGING GLASS ETCHED TEALIGHT,9,303,18,1900,1597,1,36
3756,BLUE NEW BAROQUE CANDLESTICK CANDLE,6,202,2,300,98,1,4
3757,COOKING SET RETROSPOT,3,526,6,700,174,1,12
3758,KINGS CHOICE GIANT TUBE MATCHES,9,440,8,900,460,1,16
3759,COSY HOUR GIANT TUBE MATCHES,3,2187,24,2500,313,1,48
3760,PLACE SETTING WHITE STAR,4,100,0,100,0,1,0
3761,HYACINTH BULB T-LIGHT CANDLES,9,1169,22,2300,1131,1,44
3762,S/15 SILVER GLASS BAUBLES IN BAG,1,759,17,1800,1041,1,34
3763,FRENCH WC SIGN BLUE METAL,10,802,15,1600,798,1,30
3764,KINGS CHOICE GIANT TUBE MATCHES,1,602,15,1600,998,1,30
3765,74 SWEETHEART FAIRY CAKE CASES,1,143,13,1400,1257,1,26
3766,ASSORTED COLOUR BIRD ORNAMENT,8,1430,23,2400,970,1,46
3767,FAIRY SOAP SOAP HOLDER,8,1571,25,2600,1029,1,50
3768,GREEN GIANT GARDEN THERMOMETER,1,1304,25,2600,1296,1,50
3769,IVORY GIANT GARDEN THERMOMETER,7,1479,20,2100,621,1,40
3770,BLUE GIANT GARDEN THERMOMETER,5,289,10,1100,811,1,20
3771,PACK OF 60 PINK PAISLEY CAKE CASES,1,531,7,800,269,1,14
3772,RETROSPOT HEART HOT WATER BOTTLE,10,1021,15,1600,579,1,30
3773,CHICK GREY HOT WATER BOTTLE,1,336,20,2100,1764,1,40
3774,VICTORIAN SEWING BOX SMALL ,9,180,1,200,20,1,2
3775,VICTORIAN SEWING BOX MEDIUM,9,1471,16,1700,229,1,32
3776,SET/10 RED POLKADOT PARTY CANDLES,1,831,15,1600,769,1,30
3777,WASHROOM METAL SIGN,5,621,21,2200,1579,1,42
3778,BLACK SWEETHEART BRACELET,8,177,10,1100,923,1,20
3779,DIAMANTE HAIR GRIP PACK/2 BLACK DIA,10,1696,16,1700,4,1,32
3780,BLACK DIAMANTE EXPANDABLE RING,6,588,14,1500,912,1,28
3781,DIAMANTE HAIR GRIP PACK/2 RUBY,2,254,3,400,146,1,6
3782,DIAMANTE HAIR GRIP PACK/2 MONTANA,8,628,14,1500,872,1,28
3783,BLUE SWEETHEART BRACELET,7,682,6,700,18,1,12
3784,PINK SWEETHEART BRACELET,1,628,8,900,272,1,16
3785,PURPLE SWEETHEART BRACELET,2,590,14,1500,910,1,28
3786,JUMBO BAG PINK POLKADOT,3,2419,24,2500,81,1,48
3787,JUMBO BAG RED RETROSPOT,2,1123,17,1800,677,1,34
3788,ASSORTED COLOUR BIRD ORNAMENT,6,1116,18,1900,784,1,36
3789,PAPER CHAIN KIT 50'S CHRISTMAS ,4,925,15,1600,675,1,30
3790,RIBBON REEL CHRISTMAS PRESENT ,1,228,15,1600,1372,1,30
3791,FIRST AID TIN,2,551,20,2100,1549,1,40
3792,MAKE YOUR OWN MONSOON CARD KIT,4,379,20,2100,1721,1,40
3793,PACK OF 12 HEARTS DESIGN TISSUES ,7,451,6,700,249,1,12
3794,PACK OF 12 RED RETROSPOT TISSUES ,5,773,9,1000,227,1,18
3795,SOLDIERS EGG CUP ,8,100,0,100,0,1,0
3796,HEART IVORY TRELLIS SMALL,4,119,4,500,381,1,8
3797,HEART FILIGREE DOVE  SMALL,10,1264,17,1800,536,1,34
3798,HEART FILIGREE DOVE LARGE,7,805,8,900,95,1,16
3799,PACK 3 BOXES BIRD PANNETONE ,7,322,19,2000,1678,1,38
3800,PACK 3 BOXES CHRISTMAS PANNETONE,4,123,10,1100,977,1,20
3801,SMALL POPCORN HOLDER,9,885,11,1200,315,1,22
3802,PACK OF 60 PINK PAISLEY CAKE CASES,7,1630,21,2200,570,1,42
3803,SET OF 6 SOLDIER SKITTLES,2,1311,24,2500,1189,1,48
3804,SWIRLY CIRCULAR RUBBERS IN BAG,6,465,18,1900,1435,1,36
3805,VINTAGE PAISLEY STATIONERY SET,6,259,6,700,441,1,12
3806,PAPER CHAIN KIT VINTAGE CHRISTMAS,8,165,1,200,35,1,2
3807,SET/10 BLUE POLKADOT PARTY CANDLES,4,304,20,2100,1796,1,40
3808,RIBBON REEL SOCKS AND MITTENS,2,662,25,2600,1938,1,50
3809,62 CAKE CASES VINTAGE CHRISTMAS,3,101,2,300,199,1,4
3810,CHRISTMAS METAL TAGS ASSORTED ,5,100,9,1000,900,1,18
3811,CHRISTMAS TREE T-LIGHT HOLDER,9,1434,15,1600,166,1,30
3812,STAR  T-LIGHT HOLDER ,3,260,14,1500,1240,1,28
3813,HEART T-LIGHT HOLDER ,1,701,20,2100,1399,1,40
3814,MINI FUNKY DESIGN TAPES,7,1332,16,1700,368,1,32
3815,SET OF 6 T-LIGHTS SNOWMEN,10,376,11,1200,824,1,22
3816,STAR WOODEN CHRISTMAS DECORATION,1,100,0,100,0,1,0
3817,WOODEN HEART CHRISTMAS SCANDINAVIAN,1,866,9,1000,134,1,18
3818,CHRISTMAS RETROSPOT TREE WOOD,9,281,11,1200,919,1,22
3819,SET OF 6 T-LIGHTS SANTA,9,1573,17,1800,227,1,34
3820,SET/9 CHRISTMAS T-LIGHTS SCENTED ,6,563,9,1000,437,1,18
3821,BLUE ROSE FABRIC MIRROR,3,2179,21,2200,21,1,42
3822,THREE CANVAS LUGGAGE TAGS,2,501,7,800,299,1,14
3823,RETROSPOT PARTY BAG + STICKER SET,4,902,21,2200,1298,1,42
3824,PLASTERS IN TIN VINTAGE PAISLEY ,8,215,7,800,585,1,14
3825,RETROSPOT SMALL TUBE MATCHES,8,628,6,700,72,1,12
3826,HAND WARMER SCOTTY DOG DESIGN,9,403,22,2300,1897,1,44
3827,3D CHRISTMAS STAMPS STICKERS ,1,1966,22,2300,334,1,44
3828,HAND WARMER SCOTTY DOG DESIGN,5,379,11,1200,821,1,22
3829,HAND WARMER SCOTTY DOG DESIGN,3,243,12,1300,1057,1,24
3830,CLOTHES PEGS RETROSPOT PACK 26,9,981,23,2400,1419,1,46
3831,38 FOIL HEART CAKE CASES,1,688,8,900,212,1,16
3832,CHRISTMAS METAL TAGS ASSORTED ,9,108,7,800,692,1,14
3833,PACK OF 6 SWEETIE GIFT BOXES,4,507,11,1200,693,1,22
3834,PACK OF 72 RETROSPOT CAKE CASES,2,458,7,800,342,1,14
3835,PACK OF 72 RETROSPOT CAKE CASES,9,2283,23,2400,117,1,46
3836,PACK OF 6 BIRDY GIFT TAGS,10,211,24,2500,2289,1,48
3837,SET/10 RED POLKADOT PARTY CANDLES,8,496,12,1300,804,1,24
3838,SET/10 PINK POLKADOT PARTY CANDLES,4,100,0,100,0,1,0
3839,SET OF 3 NOTEBOOKS IN PARCEL,3,998,9,1000,2,1,18
3840,STAR  T-LIGHT HOLDER ,6,1614,22,2300,686,1,44
3841,CINAMMON SET OF 9 T-LIGHTS,9,1189,22,2300,1111,1,44
3842,ORANGE SCENTED SET/9 T-LIGHTS,3,256,14,1500,1244,1,28
3843,RIBBON REEL STRIPES DESIGN ,9,939,12,1300,361,1,24
3844,SET OF 2 TINS JARDIN DE PROVENCE,6,154,10,1100,946,1,20
3845,MAKE YOUR OWN PLAYTIME CARD KIT,4,1518,24,2500,982,1,48
3846,DINOSAURS  WRITING SET ,4,864,18,1900,1036,1,36
3847,BALLOONS  WRITING SET ,2,351,7,800,449,1,14
3848,SKULLS WRITING SET ,1,104,8,900,796,1,16
3849,VINTAGE PAISLEY STATIONERY SET,9,607,23,2400,1793,1,46
3850,COSY SLIPPER SHOES SMALL  RED ,8,164,4,500,336,1,8
3851,DOORMAT BLACK FLOCK ,4,1322,17,1800,478,1,34
3852,JUMBO  BAG BAROQUE BLACK WHITE,6,489,6,700,211,1,12
3853,JAM MAKING SET WITH JARS,2,209,2,300,91,1,4
3854,ORANGE SCENTED SET/9 T-LIGHTS,7,1096,10,1100,4,1,20
3855,CINAMMON SET OF 9 T-LIGHTS,7,189,1,200,11,1,2
3856,HAND WARMER SCOTTY DOG DESIGN,9,767,13,1400,633,1,26
3857,CHRISTMAS DECOUPAGE CANDLE,10,217,7,800,583,1,14
3858,HEART T-LIGHT HOLDER ,2,1808,24,2500,692,1,48
3859,GROW YOUR OWN BASIL IN ENAMEL MUG,9,180,12,1300,1120,1,24
3860,OFFICE MUG WARMER POLKADOT,5,1017,12,1300,283,1,24
3861,SMALL POPCORN HOLDER,9,100,0,100,0,1,0
3862,JUMBO BAG DOLLY GIRL DESIGN,10,383,7,800,417,1,14
3863,JAM MAKING SET WITH JARS,9,235,2,300,65,1,4
3864,JAM MAKING SET PRINTED,1,1176,24,2500,1324,1,48
3865,SMALL GLASS HEART TRINKET POT,9,787,14,1500,713,1,28
3866,RED WOOLLY HOTTIE WHITE HEART.,5,2046,21,2200,154,1,42
3867,BLACK RECORD COVER FRAME,8,772,10,1100,328,1,20
3868,"RECORD FRAME 7"" SINGLE SIZE ",1,1331,18,1900,569,1,36
3869,38 PENCILS TUBE RED RETROSPOT,5,344,5,600,256,1,10
3870,38 PENCILS TUBE WOODLAND,7,1158,20,2100,942,1,40
3871,SET OF 6 SOLDIER SKITTLES,6,1564,17,1800,236,1,34
3872,ROCKING HORSE RED CHRISTMAS ,3,582,5,600,18,1,10
3873,CHRISTMAS GINGHAM HEART,10,772,22,2300,1528,1,44
3874,CHRISTMAS GINGHAM STAR,8,749,14,1500,751,1,28
3875,HAND WARMER UNION JACK,7,1006,19,2000,994,1,38
3876,HAND WARMER RED RETROSPOT,3,168,2,300,132,1,4
3877,REGENCY CAKESTAND 3 TIER,4,564,17,1800,1236,1,34
3878,JUMBO SHOPPER VINTAGE RED PAISLEY,10,1515,22,2300,785,1,44
3879,RIBBON REEL SNOWY VILLAGE,4,1872,22,2300,428,1,44
3880,VINTAGE UNION JACK BUNTING,3,661,20,2100,1439,1,40
3881,JAM MAKING SET WITH JARS,3,206,21,2200,1994,1,42
3882,RIBBON REEL STRIPES DESIGN ,8,682,19,2000,1318,1,38
3883,RETRO LONGBOARD IRONING BOARD COVER,10,507,9,1000,493,1,18
3884,3D DOG PICTURE PLAYING CARDS,1,738,10,1100,362,1,20
3885,RETROSPOT CIGAR BOX MATCHES ,7,320,21,2200,1880,1,42
3886,SET/9 CHRISTMAS T-LIGHTS SCENTED ,2,698,9,1000,302,1,18
3887,ROTATING SILVER ANGELS T-LIGHT HLDR,9,392,8,900,508,1,16
3888,ROTATING SILVER ANGELS T-LIGHT HLDR,9,529,10,1100,571,1,20
3889,SAVE THE PLANET COTTON TOTE BAG,10,1866,20,2100,234,1,40
3890,SET OF 20 VINTAGE CHRISTMAS NAPKINS,6,2055,21,2200,145,1,42
3891,PAPER BUNTING WHITE LACE,6,1554,20,2100,546,1,40
3892,GENTLEMAN SHIRT REPAIR KIT ,1,100,0,100,0,1,0
3893,CARD I LOVE LONDON ,3,323,5,600,277,1,10
3894,PAPER CHAIN KIT VINTAGE CHRISTMAS,2,420,17,1800,1380,1,34
3895,MIRRORED WALL ART FOXY,3,960,23,2400,1440,1,46
3896,MIRRORED WALL ART GENTS,10,2040,23,2400,360,1,46
3897,AIRLINE BAG VINTAGE JET SET WHITE,3,461,17,1800,1339,1,34
3898,JAM MAKING SET PRINTED,8,1094,20,2100,1006,1,40
3899,POTTING SHED SOW 'N' GROW SET,4,253,2,300,47,1,4
3900,BABUSHKA LIGHTS STRING OF 12,7,788,10,1100,312,1,20
3901,REX CASH+CARRY JUMBO SHOPPER,4,780,17,1800,1020,1,34
3902,AIRLINE BAG VINTAGE WORLD CHAMPION ,7,159,18,1900,1741,1,36
3903,HAND WARMER BIRD DESIGN,4,309,4,500,191,1,8
3904,CHRISTMAS CRAFT LITTLE FRIENDS,2,775,11,1200,425,1,22
3905,PINK HEARTS PAPER GARLAND,6,755,15,1600,845,1,30
3906,POTTING SHED SEED ENVELOPES,10,817,15,1600,783,1,30
3907,HI TEC ALPINE HAND WARMER,3,305,12,1300,995,1,24
3908,FELTCRAFT CHRISTMAS FAIRY,4,531,15,1600,1069,1,30
3909,HI TEC ALPINE HAND WARMER,2,544,5,600,56,1,10
3910,ROTATING SILVER ANGELS T-LIGHT HLDR,1,441,20,2100,1659,1,40
3911,5 STRIPEY MICE FELTCRAFT,8,1372,14,1500,128,1,28
3912,FELTCRAFT 6 FLOWER FRIENDS,10,139,5,600,461,1,10
3913,CHRISTMAS CRAFT LITTLE FRIENDS,5,632,9,1000,368,1,18
3914,VINTAGE UNION JACK CUSHION COVER,1,968,11,1200,232,1,22
3915,POLYESTER FILLER PAD 45x45cm,2,269,21,2200,1931,1,42
3916,DOLLY GIRL LUNCH BOX,6,589,20,2100,1511,1,40
3917,PACK OF 12 LONDON TISSUES ,4,1277,15,1600,323,1,30
3918,CARD DOLLY GIRL ,3,441,4,500,59,1,8
3919,CARD BILLBOARD FONT,4,800,23,2400,1600,1,46
3920,RAINY LADIES BIRTHDAY CARD,10,746,21,2200,1454,1,42
3921,GREY HEART HOT WATER BOTTLE,9,148,7,800,652,1,14
3922,RED WOOLLY HOTTIE WHITE HEART.,9,1099,21,2200,1101,1,42
3923,RED WHITE SCARF  HOT WATER BOTTLE,4,1552,19,2000,448,1,38
3924, SET 2 TEA TOWELS I LOVE LONDON ,4,395,19,2000,1605,1,38
3925,SET OF 2 TEA TOWELS APPLE AND PEARS,8,1328,20,2100,772,1,40
3926,SET/2 RED RETROSPOT TEA TOWELS ,9,787,7,800,13,1,14
3927,LOVE BUILDING BLOCK WORD,5,761,7,800,39,1,14
3928,HOME BUILDING BLOCK WORD,6,380,21,2200,1820,1,42
3929,ASSORTED COLOUR BIRD ORNAMENT,3,222,4,500,278,1,8
3930,LANTERN CREAM GAZEBO ,1,116,25,2600,2484,1,50
3931,BLUE BIRDHOUSE DECORATION,5,1599,15,1600,1,1,30
3932,WHITE HANGING HEART T-LIGHT HOLDER,8,115,8,900,785,1,16
3933,REGENCY CAKESTAND 3 TIER,6,586,15,1600,1014,1,30
3934,ANTIQUE SILVER TEA GLASS ENGRAVED,10,2013,22,2300,287,1,44
3935,AGED GLASS SILVER T-LIGHT HOLDER,4,1217,25,2600,1383,1,50
3936,JAM MAKING SET WITH JARS,5,1084,20,2100,1016,1,40
3937,HAND WARMER OWL DESIGN,2,113,5,600,487,1,10
3938,SET OF 2 WOODEN MARKET CRATES,4,1417,22,2300,883,1,44
3939,SET OF 6 T-LIGHTS TOADSTOOLS,8,245,4,500,255,1,8
3940,HAND WARMER UNION JACK,8,564,6,700,136,1,12
3941,HAND WARMER SCOTTY DOG DESIGN,5,477,12,1300,823,1,24
3942,CLASSIC FRENCH STYLE BASKET NATURAL,5,312,13,1400,1088,1,26
3943,CRAZY DAISY HEART DECORATION,9,106,1,200,94,1,2
3944,GIN + TONIC DIET METAL SIGN,1,331,5,600,269,1,10
3945,IVORY GIANT GARDEN THERMOMETER,5,1342,16,1700,358,1,32
3946,CARD HOLDER GINGHAM HEART,9,287,7,800,513,1,14
3947,SMALL STRIPES CHOCOLATE GIFT BAG ,1,614,20,2100,1486,1,40
3948,S/6 WOODEN SKITTLES IN COTTON BAG,5,362,21,2200,1838,1,42
3949,HAND WARMER RED RETROSPOT,6,577,18,1900,1323,1,36
3950,HAND WARMER UNION JACK,1,821,21,2200,1379,1,42
3951,FRENCH WC SIGN BLUE METAL,6,210,9,1000,790,1,18
3952,PINK UNION JACK  LUGGAGE TAG,4,1806,21,2200,394,1,42
3953,"TRAY, BREAKFAST IN BED",1,113,3,400,287,1,6
3954,PIZZA PLATE IN BOX,3,137,1,200,63,1,2
3955,HEART OF WICKER LARGE,3,242,23,2400,2158,1,46
3956,PINK HEART DOTS HOT WATER BOTTLE,3,806,20,2100,1294,1,40
3957,PLACE SETTING WHITE HEART,5,148,6,700,552,1,12
3958,SET OF 4 NAPKIN CHARMS LEAVES   ,4,457,8,900,443,1,16
3959,SET OF 4 NAPKIN CHARMS STARS   ,9,359,14,1500,1141,1,28
3960,SET OF 4 NAPKIN CHARMS CUTLERY,5,1027,25,2600,1573,1,50
3961,CARAVAN SQUARE TISSUE BOX,10,818,17,1800,982,1,34
3962,PLASTERS IN TIN SKULLS,10,1808,22,2300,492,1,44
3963,PLASTERS IN TIN SPACEBOY,5,148,11,1200,1052,1,22
3964,BUTTON BOX ,7,1003,15,1600,597,1,30
3965,PLASTERS IN TIN VINTAGE PAISLEY ,3,696,8,900,204,1,16
3966,14 MESSAGE CARDS WITH ENVELOPES,8,516,7,800,284,1,14
3967,SMALL RED BABUSHKA NOTEBOOK ,3,1895,23,2400,505,1,46
3968,CUPCAKE LACE PAPER SET 8,1,1988,19,2000,12,1,38
3969,PACK 3 BOXES CHRISTMAS PANNETONE,4,340,10,1100,760,1,20
3970,HERB MARKER MINT,10,600,7,800,200,1,14
3971,HERB MARKER ROSEMARY,1,138,4,500,362,1,8
3972,HERB MARKER BASIL,6,949,9,1000,51,1,18
3973,HERB MARKER CHIVES ,2,2187,23,2400,213,1,46
3974,HERB MARKER PARSLEY,2,189,5,600,411,1,10
3975,HERB MARKER THYME,1,679,23,2400,1721,1,46
3976,WHITE HANGING HEART T-LIGHT HOLDER,1,530,6,700,170,1,12
3977,METAL MERRY CHRISTMAS WREATH,8,220,3,400,180,1,6
3978,WHITE CHRISTMAS GARLAND STARS TREES,9,687,8,900,213,1,16
3979,RETROSPOT SMALL TUBE MATCHES,4,974,20,2100,1126,1,40
3980,RETROSPOT GIANT TUBE MATCHES,1,336,24,2500,2164,1,48
3981,PLACE SETTING WHITE STAR,7,928,16,1700,772,1,32
3982,GROW YOUR OWN BASIL IN ENAMEL MUG,2,410,20,2100,1690,1,40
3983,38 FOIL STAR CAKE CASES ,1,230,3,400,170,1,6
3984,38 FOIL HEART CAKE CASES,5,396,11,1200,804,1,22
3985,PACK OF 6 SWEETIE GIFT BOXES,8,480,10,1100,620,1,20
3986,PACK OF 6 HANDBAG GIFT BOXES,10,1350,19,2000,650,1,38
3987,GARLAND WOODEN HAPPY EASTER,3,2538,25,2600,62,1,50
3988,CALENDAR PAPER CUT DESIGN,4,212,14,1500,1288,1,28
3989,CALENDAR IN SEASON DESIGN,9,523,18,1900,1377,1,36
3990,SMALL POPCORN HOLDER,3,740,9,1000,260,1,18
3991,BLUE PAISLEY TISSUE BOX,9,773,8,900,127,1,16
3992,HEART OF WICKER SMALL,8,229,2,300,71,1,4
3993,SKULLS SQUARE TISSUE BOX,4,734,8,900,166,1,16
3994,SKULLS SQUARE TISSUE BOX,10,268,15,1600,1332,1,30
3995,WHITE HANGING HEART T-LIGHT HOLDER,9,1344,19,2000,656,1,38
3996,WHITE METAL LANTERN,1,472,23,2400,1928,1,46
3997,CREAM CUPID HEARTS COAT HANGER,9,616,16,1700,1084,1,32
3998,KNITTED UNION FLAG HOT WATER BOTTLE,4,474,16,1700,1226,1,32
3999,RED WOOLLY HOTTIE WHITE HEART.,9,443,11,1200,757,1,22
4000,SET 7 BABUSHKA NESTING BOXES,9,1184,22,2300,1116,1,44
4001,GLASS STAR FROSTED T-LIGHT HOLDER,9,114,1,200,86,1,2
4002,HAND WARMER UNION JACK,3,415,11,1200,785,1,22
4003,HAND WARMER RED POLKA DOT,5,632,20,2100,1468,1,40
4004,ASSORTED COLOUR BIRD ORNAMENT,6,1063,18,1900,837,1,36
4005,POPPY'S PLAYHOUSE BEDROOM ,2,376,15,1600,1224,1,30
4006,POPPY'S PLAYHOUSE KITCHEN,2,1199,12,1300,101,1,24
4007,FELTCRAFT PRINCESS CHARLOTTE DOLL,7,1588,20,2100,512,1,40
4008,IVORY KNITTED MUG COSY ,8,209,5,600,391,1,10
4009,BOX OF 6 ASSORTED COLOUR TEASPOONS,2,1654,18,1900,246,1,36
4010,BOX OF VINTAGE JIGSAW BLOCKS ,8,647,7,800,153,1,14
4011,BOX OF VINTAGE ALPHABET BLOCKS,6,174,2,300,126,1,4
4012,HOME BUILDING BLOCK WORD,3,720,13,1400,680,1,26
4013,LOVE BUILDING BLOCK WORD,6,100,0,100,0,1,0
4014,RECIPE BOX WITH METAL HEART,8,652,8,900,248,1,16
4015,DOORMAT NEW ENGLAND,1,305,21,2200,1895,1,42
4016,JAM MAKING SET WITH JARS,2,748,20,2100,1352,1,40
4017,RED COAT RACK PARIS FASHION,8,1074,16,1700,626,1,32
4018,YELLOW COAT RACK PARIS FASHION,9,190,4,500,310,1,8
4019,BLUE COAT RACK PARIS FASHION,3,2236,23,2400,164,1,46
4020,BATH BUILDING BLOCK WORD,9,1625,19,2000,375,1,38
4021,ALARM CLOCK BAKELIKE PINK,3,456,5,600,144,1,10
4022,ALARM CLOCK BAKELIKE RED ,3,782,15,1600,818,1,30
4023,ALARM CLOCK BAKELIKE GREEN,1,234,2,300,66,1,4
4024,PANDA AND BUNNIES STICKER SHEET,1,451,6,700,249,1,12
4025,STARS GIFT TAPE ,1,1378,13,1400,22,1,26
4026,INFLATABLE POLITICAL GLOBE ,8,995,25,2600,1605,1,50
4027,VINTAGE HEADS AND TAILS CARD GAME ,1,1469,20,2100,631,1,40
4028,SET/2 RED RETROSPOT TEA TOWELS ,4,211,6,700,489,1,12
4029,ROUND SNACK BOXES SET OF4 WOODLAND ,6,498,6,700,202,1,12
4030,SPACEBOY LUNCH BOX ,10,132,25,2600,2468,1,50
4031,LUNCH BOX I LOVE LONDON,1,419,14,1500,1081,1,28
4032,CIRCUS PARADE LUNCH BOX ,6,158,1,200,42,1,2
4033,CHARLOTTE BAG DOLLY GIRL DESIGN,8,828,8,900,72,1,16
4034,RED TOADSTOOL LED NIGHT LIGHT,7,197,2,300,103,1,4
4035, SET 2 TEA TOWELS I LOVE LONDON ,6,1003,13,1400,397,1,26
4036,VINTAGE SEASIDE JIGSAW PUZZLES,6,1108,19,2000,892,1,38
4037,MINI JIGSAW CIRCUS PARADE ,7,606,9,1000,394,1,18
4038,MINI JIGSAW SPACEBOY,6,924,11,1200,276,1,22
4039,MINI PAINT SET VINTAGE ,1,1531,21,2200,669,1,42
4040,POSTAGE,1,144,5,600,456,1,10
4041,PAPER CHAIN KIT 50'S CHRISTMAS ,8,415,7,800,385,1,14
4042,HAND WARMER RED POLKA DOT,8,666,11,1200,534,1,22
4043,HAND WARMER UNION JACK,6,897,9,1000,103,1,18
4044,WHITE HANGING HEART T-LIGHT HOLDER,6,1162,11,1200,38,1,22
4045,WHITE METAL LANTERN,2,1603,25,2600,997,1,50
4046,CREAM CUPID HEARTS COAT HANGER,1,310,6,700,390,1,12
4047,EDWARDIAN PARASOL RED,10,1486,17,1800,314,1,34
4048,RETRO COFFEE MUGS ASSORTED,4,100,0,100,0,1,0
4049,SAVE THE PLANET MUG,9,257,2,300,43,1,4
4050,VINTAGE BILLBOARD DRINK ME MUG,5,1820,20,2100,280,1,40
4051,VINTAGE BILLBOARD LOVE/HATE MUG,5,823,15,1600,777,1,30
4052,WOOD 2 DRAWER CABINET WHITE FINISH,6,1193,12,1300,107,1,24
4053,WOOD S/3 CABINET ANT WHITE FINISH,7,1155,21,2200,1045,1,42
4054,WOODEN PICTURE FRAME WHITE FINISH,1,189,10,1100,911,1,20
4055,WOODEN FRAME ANTIQUE WHITE ,6,2006,24,2500,494,1,48
4056,KNITTED UNION FLAG HOT WATER BOTTLE,9,738,14,1500,762,1,28
4057,RED WOOLLY HOTTIE WHITE HEART.,4,265,20,2100,1835,1,40
4058,SET 7 BABUSHKA NESTING BOXES,10,174,1,200,26,1,2
4059,GLASS STAR FROSTED T-LIGHT HOLDER,1,687,11,1200,513,1,22
4060,VICTORIAN SEWING BOX LARGE,2,276,4,500,224,1,8
4061,WHITE HANGING HEART T-LIGHT HOLDER,4,783,18,1900,1117,1,36
4062,WHITE METAL LANTERN,8,1399,25,2600,1201,1,50
4063,CREAM CUPID HEARTS COAT HANGER,3,174,11,1200,1026,1,22
4064,EDWARDIAN PARASOL RED,9,100,0,100,0,1,0
4065,RETRO COFFEE MUGS ASSORTED,4,1766,17,1800,34,1,34
4066,SAVE THE PLANET MUG,1,729,7,800,71,1,14
4067,VINTAGE BILLBOARD DRINK ME MUG,7,301,13,1400,1099,1,26
4068,VINTAGE BILLBOARD LOVE/HATE MUG,3,549,6,700,151,1,12
4069,WOOD 2 DRAWER CABINET WHITE FINISH,2,453,19,2000,1547,1,38
4070,WOOD S/3 CABINET ANT WHITE FINISH,10,698,17,1800,1102,1,34
4071,WOODEN PICTURE FRAME WHITE FINISH,2,1203,14,1500,297,1,28
4072,WOODEN FRAME ANTIQUE WHITE ,8,348,23,2400,2052,1,46
4073,KNITTED UNION FLAG HOT WATER BOTTLE,7,1389,16,1700,311,1,32
4074,RED WOOLLY HOTTIE WHITE HEART.,7,943,12,1300,357,1,24
4075,SET 7 BABUSHKA NESTING BOXES,4,222,2,300,78,1,4
4076,GLASS STAR FROSTED T-LIGHT HOLDER,4,1016,21,2200,1184,1,42
4077,HOT WATER BOTTLE TEA AND SYMPATHY,8,209,10,1100,891,1,20
4078,RED HANGING HEART T-LIGHT HOLDER,6,297,3,400,103,1,6
4079,HAND WARMER RED POLKA DOT,5,110,1,200,90,1,2
4080,HAND WARMER UNION JACK,9,1289,12,1300,11,1,24
4081,JUMBO BAG PINK POLKADOT,3,886,14,1500,614,1,28
4082,JUMBO  BAG BAROQUE BLACK WHITE,4,429,4,500,71,1,8
4083,JUMBO BAG CHARLIE AND LOLA TOYS,1,1785,23,2400,615,1,46
4084,STRAWBERRY CHARLOTTE BAG,2,136,4,500,364,1,8
4085,RED 3 PIECE RETROSPOT CUTLERY SET,2,443,4,500,57,1,8
4086,BLUE 3 PIECE POLKADOT CUTLERY SET,6,996,14,1500,504,1,28
4087,SET/6 RED SPOTTY PAPER PLATES,2,904,10,1100,196,1,20
4088,LUNCH BAG RED RETROSPOT,3,219,4,500,281,1,8
4089,STRAWBERRY LUNCH BOX WITH CUTLERY,8,232,4,500,268,1,8
4090,LUNCH BOX WITH CUTLERY RETROSPOT ,5,358,25,2600,2242,1,50
4091,PACK OF 72 RETROSPOT CAKE CASES,4,225,4,500,275,1,8
4092,PACK OF 60 DINOSAUR CAKE CASES,6,378,15,1600,1222,1,30
4093,PACK OF 60 PINK PAISLEY CAKE CASES,7,1170,17,1800,630,1,34
4094,63 TEATIME FAIRY CAKE CASES,6,694,9,1000,306,1,18
4095,TOMATO CHARLIE+LOLA COASTER SET,3,690,10,1100,410,1,20
4096,CHARLIE & LOLA WASTEPAPER BIN FLORA,6,530,18,1900,1370,1,36
4097,RED CHARLIE+LOLA PERSONAL DOORSIGN,6,169,1,200,31,1,2
4098,JUMBO STORAGE BAG SUKI,8,653,6,700,47,1,12
4099,JUMBO BAG PINK VINTAGE PAISLEY,10,479,6,700,221,1,12
4100,JAM MAKING SET PRINTED,2,1095,12,1300,205,1,24
4101,RETROSPOT TEA SET CERAMIC 11 PC ,7,499,10,1100,601,1,20
4102,GIRLY PINK TOOL SET,2,1568,24,2500,932,1,48
4103,JUMBO SHOPPER VINTAGE RED PAISLEY,7,142,6,700,558,1,12
4104,"AIRLINE LOUNGE,METAL SIGN",6,259,6,700,441,1,12
4105,WHITE SPOT RED CERAMIC DRAWER KNOB,8,226,13,1400,1174,1,26
4106,RED DRAWER KNOB ACRYLIC EDWARDIAN,9,1649,17,1800,151,1,34
4107,CLEAR DRAWER KNOB ACRYLIC EDWARDIAN,7,914,12,1300,386,1,24
4108,PHOTO CLIP LINE,10,1427,16,1700,273,1,32
4109,FELT EGG COSY CHICKEN,4,2509,25,2600,91,1,50
4110,PIGGY BANK RETROSPOT ,5,1348,25,2600,1252,1,50
4111,SKULL SHOULDER BAG,2,747,11,1200,453,1,22
4112,YOU'RE CONFUSING ME METAL SIGN ,6,396,3,400,4,1,6
4113,COOK WITH WINE METAL SIGN ,10,561,13,1400,839,1,26
4114,GIN + TONIC DIET METAL SIGN,10,217,4,500,283,1,8
4115,YELLOW BREAKFAST CUP AND SAUCER,7,1076,14,1500,424,1,28
4116,PINK BREAKFAST CUP AND SAUCER ,2,444,18,1900,1456,1,36
4117,PAPER CHAIN KIT 50'S CHRISTMAS ,7,657,25,2600,1943,1,50
4118,PAPER CHAIN KIT RETROSPOT,7,858,11,1200,342,1,22
4119,SMALL HEART FLOWERS HOOK ,8,137,25,2600,2463,1,50
4120,PHOTO CLIP LINE,1,111,2,300,189,1,4
4121,TEA TIME DES TEA COSY,7,1042,19,2000,958,1,38
4122,FELT EGG COSY WHITE RABBIT ,7,526,18,1900,1374,1,36
4123,ZINC WILLIE WINKIE  CANDLE STICK,2,130,16,1700,1570,1,32
4124,CERAMIC CHERRY CAKE MONEY BANK,10,199,1,200,1,1,2
4125,RETROSPOT LARGE MILK JUG,3,1196,17,1800,604,1,34
4126,SET OF 6 FUNKY BEAKERS,7,100,0,100,0,1,0
4127,EDWARDIAN PARASOL BLACK,1,1035,13,1400,365,1,26
4128,EDWARDIAN PARASOL NATURAL,9,364,4,500,136,1,8
4129,CERAMIC STRAWBERRY CAKE MONEY BANK,3,782,13,1400,618,1,26
4130,BLUE OWL SOFT TOY,9,150,2,300,150,1,4
4131,BALLOON ART MAKE YOUR OWN FLOWERS,9,264,5,600,336,1,10
4132,RED TOADSTOOL LED NIGHT LIGHT,2,313,5,600,287,1,10
4133,GLASS CLOCHE SMALL,1,542,14,1500,958,1,28
4134,GUMBALL MONOCHROME COAT RACK,6,1147,13,1400,253,1,26
4135,DOORMAT FANCY FONT HOME SWEET HOME,1,136,10,1100,964,1,20
4136,Discount,10,130,25,2600,2470,1,50
4137,INFLATABLE POLITICAL GLOBE ,3,447,8,900,453,1,16
4138,VINTAGE SNAKES & LADDERS,2,670,8,900,230,1,16
4139,CHOCOLATE CALCULATOR,1,852,9,1000,148,1,18
4140,JUMBO SHOPPER VINTAGE RED PAISLEY,5,660,17,1800,1140,1,34
4141,RECYCLING BAG RETROSPOT ,6,257,3,400,143,1,6
4142,TOY TIDY PINK POLKADOT,5,593,6,700,107,1,12
4143,ANTIQUE GLASS DRESSING TABLE POT,8,100,0,100,0,1,0
4144,ALARM CLOCK BAKELIKE GREEN,2,488,4,500,12,1,8
4145,IVORY GIANT GARDEN THERMOMETER,10,530,6,700,170,1,12
4146,6 TIER CAKE TIN GREEN AND CREAM,8,381,20,2100,1719,1,40
4147,6 TIER CAKE TIN RED AND CREAM,3,749,19,2000,1251,1,38
4148,SET 3 WICKER OVAL BASKETS W LIDS,1,138,2,300,162,1,4
4149,SET OF 3 COLOURED  FLYING DUCKS,9,984,9,1000,16,1,18
4150,WOOD BLACK BOARD ANT WHITE FINISH,5,470,5,600,130,1,10
4151,COLOUR GLASS T-LIGHT HOLDER HANGING,3,1537,23,2400,863,1,46
4152,HANGING METAL HEART LANTERN,7,241,2,300,59,1,4
4153,HANGING MEDINA LANTERN SMALL,1,699,19,2000,1301,1,38
4154,NATURAL SLATE HEART CHALKBOARD ,3,1758,22,2300,542,1,44
4155,HEART OF WICKER SMALL,4,1016,14,1500,484,1,28
4156,HEART OF WICKER LARGE,5,475,7,800,325,1,14
4157,WHITE LOVEBIRD LANTERN,6,434,4,500,66,1,8
4158,CLASSIC METAL BIRDCAGE PLANT HOLDER,2,411,4,500,89,1,8
4159,CREAM HEART CARD HOLDER,2,878,13,1400,522,1,26
4160,ENAMEL FLOWER JUG CREAM,9,283,6,700,417,1,12
4161,ENAMEL FIRE BUCKET CREAM,4,505,12,1300,795,1,24
4162,ENAMEL BREAD BIN CREAM,4,165,16,1700,1535,1,32
4163,SET 3 WICKER OVAL BASKETS W LIDS,3,1871,21,2200,329,1,42
4164,JAM MAKING SET PRINTED,6,165,24,2500,2335,1,48
4165,JAM MAKING SET WITH JARS,7,109,2,300,191,1,4
4166,JUMBO BAG DOLLY GIRL DESIGN,9,1005,18,1900,895,1,36
4167,TRADITIONAL CHRISTMAS RIBBONS,6,216,3,400,184,1,6
4168,ORGANISER WOOD ANTIQUE WHITE ,5,967,9,1000,33,1,18
4169,LUNCH BAG DOLLY GIRL DESIGN,8,2289,24,2500,211,1,48
4170,WHITE WIRE EGG HOLDER,4,408,19,2000,1592,1,38
4171,JUMBO  BAG BAROQUE BLACK WHITE,1,1142,15,1600,458,1,30
4172,JUMBO BAG RED RETROSPOT,10,2139,25,2600,461,1,50
4173,CHILLI LIGHTS,8,189,1,200,11,1,2
4174,LIGHT GARLAND BUTTERFILES PINK,4,1514,18,1900,386,1,36
4175,WOODEN OWLS LIGHT GARLAND ,6,347,9,1000,653,1,18
4176,FAIRY TALE COTTAGE NIGHTLIGHT,9,338,9,1000,662,1,18
4177,RED TOADSTOOL LED NIGHT LIGHT,5,1010,11,1200,190,1,22
4178,HOME BUILDING BLOCK WORD,8,120,1,200,80,1,2
4179,LOVE BUILDING BLOCK WORD,2,266,3,400,134,1,6
4180,DOORMAT FANCY FONT HOME SWEET HOME,8,140,2,300,160,1,4
4181,HOME SMALL WOOD LETTERS,3,105,3,400,295,1,6
4182,GINGHAM HEART  DOORSTOP RED,8,156,1,200,44,1,2
4183,FIVE HEART HANGING DECORATION,4,143,12,1300,1157,1,24
4184,HANGING METAL HEART LANTERN,5,516,19,2000,1484,1,38
4185,ASSORTED BOTTLE TOP  MAGNETS ,3,1778,23,2400,622,1,46
4186,FRIDGE MAGNETS US DINER ASSORTED,9,536,10,1100,564,1,20
4187,HOMEMADE JAM SCENTED CANDLES,5,1220,22,2300,1080,1,44
4188,FRIDGE MAGNETS LES ENFANTS ASSORTED,8,979,25,2600,1621,1,50
4189,ROSE CARAVAN DOORSTOP,5,847,15,1600,753,1,30
4190,HEART OF WICKER SMALL,9,512,5,600,88,1,10
4191,8 HOOK HANGER MAGIC TOADSTOOL,3,1910,21,2200,290,1,42
4192,CHRISTMAS LIGHTS 10 REINDEER,10,152,1,200,48,1,2
4193,VINTAGE UNION JACK CUSHION COVER,10,228,3,400,172,1,6
4194,VINTAGE HEADS AND TAILS CARD GAME ,5,157,4,500,343,1,8
4195,SET OF 3 COLOURED  FLYING DUCKS,10,620,16,1700,1080,1,32
4196,SET OF 3 GOLD FLYING DUCKS,3,565,16,1700,1135,1,32
4197,RED RETROSPOT UMBRELLA,10,158,5,600,442,1,10
4198,BLACK/BLUE POLKADOT UMBRELLA,1,100,0,100,0,1,0
4199,RED DINER WALL CLOCK,7,134,1,200,66,1,2
4200,ALARM CLOCK BAKELIKE GREEN,5,509,7,800,291,1,14
4201,ALARM CLOCK BAKELIKE RED ,4,100,0,100,0,1,0
4202,BLUE DINER WALL CLOCK,1,105,3,400,295,1,6
4203,IVORY DINER WALL CLOCK,4,733,9,1000,267,1,18
4204,LARGE HEART MEASURING SPOONS,1,657,8,900,243,1,16
4205,SMALL HEART MEASURING SPOONS,9,2201,24,2500,299,1,48
4206,CHRISTMAS LIGHTS 10 REINDEER,6,1099,10,1100,1,1,20
4207,JAM MAKING SET WITH JARS,4,278,11,1200,922,1,22
4208,JAM MAKING SET PRINTED,9,583,12,1300,717,1,24
4209,JAM JAR WITH PINK LID,3,488,21,2200,1712,1,42
4210,JAM JAR WITH GREEN LID,7,1171,15,1600,429,1,30
4211,ROSE COTTAGE KEEPSAKE BOX ,3,169,9,1000,831,1,18
4212,HANGING HEART ZINC T-LIGHT HOLDER,10,786,13,1400,614,1,26
4213,PAPER CHAIN KIT VINTAGE CHRISTMAS,6,323,9,1000,677,1,18
4214,DISCO BALL CHRISTMAS DECORATION,7,708,11,1200,492,1,22
4215,WHITE HANGING HEART T-LIGHT HOLDER,3,900,16,1700,800,1,32
4216,SMALL POPCORN HOLDER,7,911,15,1600,689,1,30
4217,LARGE POPCORN HOLDER ,5,656,8,900,244,1,16
4218,RETROSPOT LARGE MILK JUG,4,555,5,600,45,1,10
4219,SET/20 RED RETROSPOT PAPER NAPKINS ,2,892,10,1100,208,1,20
4220,SET/6 RED SPOTTY PAPER PLATES,5,468,7,800,332,1,14
4221,SET/6 RED SPOTTY PAPER CUPS,9,1352,14,1500,148,1,28
4222,POLKADOT RAIN HAT ,8,200,2,300,100,1,4
4223,DELUXE SEWING KIT ,7,566,16,1700,1134,1,32
4224,RETROSPOT HEART HOT WATER BOTTLE,9,1903,24,2500,597,1,48
4225,KNITTED UNION FLAG HOT WATER BOTTLE,1,836,12,1300,464,1,24
4226,ENGLISH ROSE HOT WATER BOTTLE,3,684,9,1000,316,1,18
4227,PHOTO CUBE,9,2122,24,2500,378,1,48
4228,HOMEMADE JAM SCENTED CANDLES,8,300,9,1000,700,1,18
4229,JUMBO BAG RED RETROSPOT,4,595,16,1700,1105,1,32
4230,PLASTERS IN TIN CIRCUS PARADE ,3,941,11,1200,259,1,22
4231,PACK OF 12 PINK PAISLEY TISSUES ,5,100,0,100,0,1,0
4232,PACK OF 12 BLUE PAISLEY TISSUES ,10,944,13,1400,456,1,26
4233,PACK OF 12 RED RETROSPOT TISSUES ,8,826,17,1800,974,1,34
4234,CHICK GREY HOT WATER BOTTLE,3,466,4,500,34,1,8
4235,PLASTERS IN TIN VINTAGE PAISLEY ,10,197,3,400,203,1,6
4236,PLASTERS IN TIN SKULLS,9,274,2,300,26,1,4
4237,6 STRIPEY MICE FELTCRAFT,9,891,23,2400,1509,1,46
4238,SET OF 6 SOLDIER SKITTLES,9,100,0,100,0,1,0
4239,TRADITIONAL WOODEN SKIPPING ROPE,2,196,3,400,204,1,6
4240,WOODEN BOX OF DOMINOES,7,100,0,100,0,1,0
4241,RUSTIC  SEVENTEEN DRAWER SIDEBOARD,1,462,25,2600,2138,1,50
4242,PARTY CONES CARNIVAL ASSORTED,1,772,8,900,128,1,16
4243,PARTY CONES CANDY ASSORTED,5,126,3,400,274,1,6
4244,PICNIC BASKET WICKER SMALL,9,477,14,1500,1023,1,28
4245,ASSORTED COLOUR BIRD ORNAMENT,3,384,9,1000,616,1,18
4246,STAR DECORATION PAINTED ZINC ,3,1763,19,2000,237,1,38
4247,RETROSPOT LAMP,10,337,6,700,363,1,12
4248,"FANCY FONT BIRTHDAY CARD, ",9,408,12,1300,892,1,24
4249,HAND WARMER UNION JACK,10,270,12,1300,1030,1,24
4250,HAND WARMER SCOTTY DOG DESIGN,5,354,14,1500,1146,1,28
4251,HAND WARMER OWL DESIGN,10,661,11,1200,539,1,22
4252,HAND WARMER RED RETROSPOT,9,100,0,100,0,1,0
4253,RETROSPOT HEART HOT WATER BOTTLE,2,493,16,1700,1207,1,32
4254,DOG BOWL CHASING BALL DESIGN,8,2454,24,2500,46,1,48
4255,CLOTHES PEGS RETROSPOT PACK 27,2,1036,10,1100,64,1,20
4256,HAND OVER THE CHOCOLATE   SIGN ,2,515,7,800,285,1,14
4257,WHITE HANGING HEART T-LIGHT HOLDER,9,1690,21,2200,510,1,42
4258,TRAVEL SEWING KIT,3,875,8,900,25,1,16
4259,BLACK HEART CARD HOLDER,9,1228,13,1400,172,1,26
4260,ASSORTED COLOUR BIRD ORNAMENT,9,522,11,1200,678,1,22
4261,PACK OF 60 PINK PAISLEY CAKE CASES,6,133,6,700,567,1,12
4262,63 TEATIME FAIRY CAKE CASES,6,1296,14,1500,204,1,28
4263,PACK OF 72 RETROSPOT CAKE CASES,3,191,2,300,109,1,4
4264,CHICK GREY HOT WATER BOTTLE,1,1333,13,1400,67,1,26
4265,SMALL GLASS HEART TRINKET POT,3,100,0,100,0,1,0
4266,ALARM CLOCK BAKELIKE IVORY,7,1255,20,2100,845,1,40
4267,ALARM CLOCK BAKELIKE RED ,3,2260,25,2600,340,1,50
4268,ALARM CLOCK BAKELIKE ORANGE,6,1136,11,1200,64,1,22
4269,ALARM CLOCK BAKELIKE GREEN,3,1157,20,2100,943,1,40
4270,HOT WATER BOTTLE TEA AND SYMPATHY,6,1118,16,1700,582,1,32
4271,HAND WARMER BIRD DESIGN,8,189,20,2100,1911,1,40
4272,HAND WARMER SCOTTY DOG DESIGN,8,1513,18,1900,387,1,36
4273,WHITE HANGING HEART T-LIGHT HOLDER,1,117,2,300,183,1,4
4274,WHITE METAL LANTERN,10,116,2,300,184,1,4
4275,CREAM CUPID HEARTS COAT HANGER,8,2347,24,2500,153,1,48
4276,EDWARDIAN PARASOL BLACK,1,319,10,1100,781,1,20
4277,EDWARDIAN PARASOL RED,6,271,2,300,29,1,4
4278,RETRO COFFEE MUGS ASSORTED,4,265,2,300,35,1,4
4279,SAVE THE PLANET MUG,7,748,7,800,52,1,14
4280,VINTAGE BILLBOARD DRINK ME MUG,3,230,10,1100,870,1,20
4281,VINTAGE BILLBOARD LOVE/HATE MUG,8,1209,14,1500,291,1,28
4282,WOOD 2 DRAWER CABINET WHITE FINISH,5,1112,13,1400,288,1,26
4283,WOOD S/3 CABINET ANT WHITE FINISH,3,462,6,700,238,1,12
4284,WOODEN PICTURE FRAME WHITE FINISH,9,264,3,400,136,1,6
4285,WOODEN FRAME ANTIQUE WHITE ,10,503,8,900,397,1,16
4286,KNITTED UNION FLAG HOT WATER BOTTLE,4,1652,18,1900,248,1,36
4287,RED WOOLLY HOTTIE WHITE HEART.,9,1367,15,1600,233,1,30
4288,SET 7 BABUSHKA NESTING BOXES,6,1024,11,1200,176,1,22
4289,IVORY EMBROIDERED QUILT ,2,1372,21,2200,828,1,42
4290,GLASS STAR FROSTED T-LIGHT HOLDER,1,1667,18,1900,233,1,36
4291,SET OF 3 BLACK FLYING DUCKS,8,718,14,1500,782,1,28
4292,SET OF 3 COLOURED  FLYING DUCKS,6,461,18,1900,1439,1,36
4293,PACK OF 12 RED RETROSPOT TISSUES ,6,290,17,1800,1510,1,34
4294,RED RETROSPOT MUG,8,1465,14,1500,35,1,28
4295,BABUSHKA LIGHTS STRING OF 13,4,2209,23,2400,191,1,46
4296,PIGGY BANK RETROSPOT ,9,278,18,1900,1622,1,36
4297,SET 7 BABUSHKA NESTING BOXES,3,571,5,600,29,1,10
4298,DOORMAT FAIRY CAKE,6,147,4,500,353,1,8
4299,HAND WARMER RED RETROSPOT,7,676,8,900,224,1,16
4300,HAND WARMER SCOTTY DOG DESIGN,8,1781,19,2000,219,1,38
4301,HAND WARMER OWL DESIGN,6,489,13,1400,911,1,26
4302,STRAWBERRY CERAMIC TRINKET BOX,9,1032,24,2500,1468,1,48
4303,PINK DOUGHNUT TRINKET POT ,4,241,4,500,259,1,8
4304,SILK PURSE BABUSHKA PINK,9,104,5,600,496,1,10
4305,HOT WATER BOTTLE TEA AND SYMPATHY,6,1038,18,1900,862,1,36
4306,HOT WATER BOTTLE I AM SO POORLY,4,1017,21,2200,1183,1,42
4307,CHOCOLATE HOT WATER BOTTLE,6,1088,10,1100,12,1,20
4308,WHITE SKULL HOT WATER BOTTLE ,7,742,11,1200,458,1,22
4309,SCOTTIE DOG HOT WATER BOTTLE,7,400,8,900,500,1,16
4310,HAND WARMER RED POLKA DOT,7,120,14,1500,1380,1,28
4311,HAND WARMER UNION JACK,9,564,18,1900,1336,1,36
4312,HOMEMADE JAM SCENTED CANDLES,4,1762,20,2100,338,1,40
4313,BIRD HOUSE HOT WATER BOTTLE,7,1466,24,2500,1034,1,48
4314,BOUDOIR SQUARE TISSUE BOX,2,994,9,1000,6,1,18
4315,SKULLS SQUARE TISSUE BOX,9,1304,18,1900,596,1,36
4316,PHOTO FRAME CORNICE,8,485,9,1000,515,1,18
4317,SILK PURSE BABUSHKA RED,7,1248,16,1700,452,1,32
4318,PICTURE DOMINOES,6,399,3,400,1,1,6
4319,S/6 SEW ON CROCHET FLOWERS,4,100,0,100,0,1,0
4320,SCANDINAVIAN REDS RIBBONS,2,867,14,1500,633,1,28
4321,BALLOONS  WRITING SET ,4,1805,21,2200,395,1,42
4322,JAM MAKING SET PRINTED,9,836,17,1800,964,1,34
4323,LAVENDER INCENSE IN TIN,9,196,3,400,204,1,6
4324,TV DINNER TRAY VINTAGE PAISLEY,9,162,14,1500,1338,1,28
4325,SET OF 4 ENGLISH ROSE PLACEMATS,1,675,14,1500,825,1,28
4326,SET OF 4 ENGLISH ROSE COASTERS,5,492,12,1300,808,1,24
4327,TRIPLE PHOTO FRAME CORNICE ,7,572,11,1200,628,1,22
4328,FAMILY PHOTO FRAME CORNICE,9,107,3,400,293,1,6
4329,MIRRORED DISCO BALL ,9,568,8,900,332,1,16
4330,DISCO BALL ROTATOR BATTERY OPERATED,10,1819,18,1900,81,1,36
4331,SILVER LOOKING MIRROR,4,1001,19,2000,999,1,38
4332,LADIES & GENTLEMEN METAL SIGN,10,474,5,600,126,1,10
4333,METAL SIGN HER DINNER IS SERVED ,10,1434,25,2600,1166,1,50
4334,YOU'RE CONFUSING ME METAL SIGN ,10,1014,22,2300,1286,1,44
4335,DOORMAT TOPIARY,3,818,9,1000,182,1,18
4336,BATHROOM METAL SIGN,6,167,9,1000,833,1,18
4337,KITCHEN METAL SIGN,1,631,8,900,269,1,16
4338,TOILET METAL SIGN,8,1474,19,2000,526,1,38
4339,METAL SIGN TAKE IT OR LEAVE IT ,1,563,23,2400,1837,1,46
4340,I'M ON HOLIDAY METAL SIGN,9,572,15,1600,1028,1,30
4341,GROW YOUR OWN BASIL IN ENAMEL MUG,4,813,12,1300,487,1,24
4342,SET/10 PINK POLKADOT PARTY CANDLES,5,428,14,1500,1072,1,28
4343,SET 20 NAPKINS FAIRY CAKES DESIGN ,7,432,6,700,268,1,12
4344,63 TEATIME FAIRY CAKE CASES,2,357,24,2500,2143,1,48
4345,SET OF 6 T-LIGHTS SNOWMEN,7,613,9,1000,387,1,18
4346,SET OF 6 T-LIGHTS SANTA,2,935,12,1300,365,1,24
4347,SET OF 9 HEART SHAPED BALLOONS,9,509,10,1100,591,1,20
4348,SANDWICH BATH SPONGE,8,246,12,1300,1054,1,24
4349,APPLE BATH SPONGE,6,466,13,1400,934,1,26
4350,STRAWBERRY BATH SPONGE ,3,109,1,200,91,1,2
4351,BLACK PIRATE TREASURE CHEST,8,432,14,1500,1068,1,28
4352,STAR PORTABLE TABLE LIGHT ,2,1003,12,1300,297,1,24
4353,SNOWFLAKE PORTABLE TABLE LIGHT ,8,2110,23,2400,290,1,46
4354,PINK OVAL JEWELLED MIRROR,2,406,7,800,394,1,14
4355,RETROSPOT CIGAR BOX MATCHES ,4,100,0,100,0,1,0
4356,COSY HOUR GIANT TUBE MATCHES,3,277,15,1600,1323,1,30
4357,JAZZ HEARTS PURSE NOTEBOOK,2,262,5,600,338,1,10
4358,LUNCH BAG DOLLY GIRL DESIGN,4,660,18,1900,1240,1,36
4359,WHITE HANGING HEART T-LIGHT HOLDER,7,202,18,1900,1698,1,36
4360,CANDLEHOLDER PINK HANGING HEART,8,880,9,1000,120,1,18
4361,WOOD 2 DRAWER CABINET WHITE FINISH,5,102,2,300,198,1,4
4362,ASSORTED COLOUR MINI CASES,10,280,8,900,620,1,16
4363,LUNCH BAG RED RETROSPOT,9,195,9,1000,805,1,18
4364,LUNCH BAG SPACEBOY DESIGN ,8,840,9,1000,160,1,18
4365,LUNCH BAG WOODLAND,7,623,11,1200,577,1,22
4366,LUNCH BAG PINK POLKADOT,5,1396,21,2200,804,1,42
4367,GUMBALL COAT RACK,8,209,2,300,91,1,4
4368,BLUE NEW BAROQUE CANDLESTICK CANDLE,1,200,1,200,0,1,2
4369,PINK NEW BAROQUECANDLESTICK CANDLE,4,307,4,500,193,1,8
4370,FAIRY CAKE FLANNEL ASSORTED COLOUR,5,470,13,1400,930,1,26
4371,BREAD BIN DINER STYLE PINK,4,1521,16,1700,179,1,32
4372,JUMBO BAG CHARLIE AND LOLA TOYS,8,280,8,900,620,1,16
4373,TEA TIME TABLE CLOTH,9,125,9,1000,875,1,18
4374,ENGLISH ROSE HOT WATER BOTTLE,9,477,14,1500,1023,1,28
4375,ENAMEL FIRE BUCKET CREAM,10,571,24,2500,1929,1,48
4376,PICNIC BASKET WICKER SMALL,1,1883,18,1900,17,1,36
4377,PAPER CHAIN KIT 50'S CHRISTMAS ,5,1834,22,2300,466,1,44
4378,PAPER CHAIN KIT VINTAGE CHRISTMAS,6,2227,25,2600,373,1,50
4379,HOT WATER BOTTLE BABUSHKA ,5,2180,22,2300,120,1,44
4380,HAND WARMER BIRD DESIGN,1,768,19,2000,1232,1,38
4381,POSTAGE,2,1887,20,2100,213,1,40
4382,HEART IVORY TRELLIS SMALL,7,1900,21,2200,300,1,42
4383,CLEAR DRAWER KNOB ACRYLIC EDWARDIAN,9,128,1,200,72,1,2
4384,PINK DRAWER KNOB ACRYLIC EDWARDIAN,10,276,2,300,24,1,4
4385,GREEN DRAWER KNOB ACRYLIC EDWARDIAN,4,265,8,900,635,1,16
4386,BLUE DRAWER KNOB ACRYLIC EDWARDIAN,1,153,19,2000,1847,1,38
4387,HEART OF WICKER SMALL,10,435,9,1000,565,1,18
4388,SMALL POPCORN HOLDER,1,1767,17,1800,33,1,34
4389,SET 6 FOOTBALL CELEBRATION CANDLES,1,666,9,1000,334,1,18
4390,SET OF 6 GIRLS CELEBRATION CANDLES,6,2138,25,2600,462,1,50
4391,ROMANTIC PINKS RIBBONS ,2,1186,12,1300,114,1,24
4392,BRIGHT BLUES RIBBONS ,4,518,6,700,182,1,12
4393,SCANDINAVIAN REDS RIBBONS,10,355,15,1600,1245,1,30
4394,CHOCOLATE BOX RIBBONS ,4,2063,24,2500,437,1,48
4395,PARTY INVITES FOOTBALL,2,461,12,1300,839,1,24
4396,PARTY INVITES JAZZ HEARTS,8,780,14,1500,720,1,28
4397,PARTY INVITES SPACEMAN,10,879,13,1400,521,1,26
4398,SET OF 3 BUTTERFLY COOKIE CUTTERS,5,1744,20,2100,356,1,40
4399,SET OF 3 HEART COOKIE CUTTERS,9,278,8,900,622,1,16
4400,6 PIECE SPACEBOY COOKIE CUTTER SET,9,649,14,1500,851,1,28
4401,PACK OF 72 SKULL CAKE CASES,10,476,24,2500,2024,1,48
4402,PACK OF 60 SPACEBOY CAKE CASES,6,1202,17,1800,598,1,34
4403,PACK OF 72 RETROSPOT CAKE CASES,2,100,0,100,0,1,0
4404,75 SWEETHEART FAIRY CAKE CASES,8,100,0,100,0,1,0
4405,PACK OF 60 DINOSAUR CAKE CASES,1,1457,19,2000,543,1,38
4406,LUNCH BAG SUKI  DESIGN ,10,262,11,1200,938,1,22
4407,LUNCH BAG CARS BLUE,9,132,20,2100,1968,1,40
4408,LUNCH BAG  BLACK SKULL.,1,100,22,2300,2200,1,44
4409,HEART IVORY TRELLIS LARGE,6,578,7,800,222,1,14
4410,SET/5 RED RETROSPOT LID GLASS BOWLS,9,568,23,2400,1832,1,46
4411,WHITE HANGING HEART T-LIGHT HOLDER,3,551,14,1500,949,1,28
4412,WHITE METAL LANTERN,5,1109,14,1500,391,1,28
4413,CREAM CUPID HEARTS COAT HANGER,6,459,22,2300,1841,1,44
4414,EDWARDIAN PARASOL RED,2,1026,18,1900,874,1,36
4415,RETRO COFFEE MUGS ASSORTED,7,129,13,1400,1271,1,26
4416,SAVE THE PLANET MUG,9,353,14,1500,1147,1,28
4417,VINTAGE BILLBOARD DRINK ME MUG,6,1128,11,1200,72,1,22
4418,VINTAGE BILLBOARD LOVE/HATE MUG,2,218,5,600,382,1,10
4419,WOOD 2 DRAWER CABINET WHITE FINISH,7,100,0,100,0,1,0
4420,WOOD S/3 CABINET ANT WHITE FINISH,5,967,14,1500,533,1,28
4421,WOODEN PICTURE FRAME WHITE FINISH,5,241,12,1300,1059,1,24
4422,WOODEN FRAME ANTIQUE WHITE ,2,177,3,400,223,1,6
4423,KNITTED UNION FLAG HOT WATER BOTTLE,3,129,2,300,171,1,4
4424,RED WOOLLY HOTTIE WHITE HEART.,10,526,12,1300,774,1,24
4425,SET 7 BABUSHKA NESTING BOXES,7,582,5,600,18,1,10
4426,IVORY EMBROIDERED QUILT ,7,210,7,800,590,1,14
4427,GLASS STAR FROSTED T-LIGHT HOLDER,8,2572,25,2600,28,1,50
4428,HAND WARMER RED POLKA DOT,10,152,10,1100,948,1,20
4429,HAND WARMER UNION JACK,4,256,11,1200,944,1,22
4430,MAGIC DRAWING SLATE DINOSAUR,1,100,0,100,0,1,0
4431,MAGIC DRAWING SLATE BAKE A CAKE ,6,829,13,1400,571,1,26
4432,15 PENCILS TALL TUBE SKULLS,3,1697,25,2600,903,1,50
4433,CHOCOLATE CALCULATOR,6,538,10,1100,562,1,20
4434,RED  HARMONICA IN BOX ,8,1412,16,1700,288,1,32
4435,BLUE HARMONICA IN BOX ,9,140,1,200,60,1,2
4436,SKULLS  WATER TRANSFER TATTOOS ,1,1310,21,2200,890,1,42
4437,PACK 3 BOXES BIRD PANNETONE ,2,493,18,1900,1407,1,36
4438,HOT WATER BOTTLE TEA AND SYMPATHY,8,2009,21,2200,191,1,42
4439,RED WOOLLY HOTTIE WHITE HEART.,5,280,2,300,20,1,4
4440,WHITE SKULL HOT WATER BOTTLE ,7,1712,23,2400,688,1,46
4441,6 PIECE SPACEBOY COOKIE CUTTER SET,6,391,19,2000,1609,1,38
4442,SET OF 20 KIDS COOKIE CUTTERS,5,714,25,2600,1886,1,50
4443,13 COLOUR SPACEBOY PEN,2,821,22,2300,1479,1,44
4444,VICTORIAN GLASS HANGING T-LIGHT,2,100,0,100,0,1,0
4445,SINGLE HEART ZINC T-LIGHT HOLDER,6,142,7,800,658,1,14
4446,RED HANGING HEART T-LIGHT HOLDER,9,144,2,300,156,1,4
4447,HANGING METAL STAR LANTERN,4,100,0,100,0,1,0
4448,SILVER HANGING T-LIGHT HOLDER,5,898,10,1100,202,1,20
4449,DOORMAT RED RETROSPOT,4,196,1,200,4,1,2
4450,DOORMAT HEARTS,6,257,5,600,343,1,10
4451,NATURAL SLATE RECTANGLE CHALKBOARD,7,596,12,1300,704,1,24
4452,LOVEBIRD HANGING DECORATION WHITE ,6,1126,23,2400,1274,1,46
4453,ASSORTED COLOUR BIRD ORNAMENT,7,337,3,400,63,1,6
4454,HOME BUILDING BLOCK WORD,4,1036,15,1600,564,1,30
4455,LOVE BUILDING BLOCK WORD,2,855,17,1800,945,1,34
4456,PHOTO FRAME CORNICE,8,2456,24,2500,44,1,48
4457,PENS ASSORTED FUNNY FACE,8,2006,24,2500,494,1,48
4458,CARD CIRCUS PARADE,10,326,4,500,174,1,8
4459,WRAP COWBOYS  ,10,1788,17,1800,12,1,34
4460,AIRLINE BAG VINTAGE TOKYO 81,2,373,3,400,27,1,6
4461,RED RETROSPOT UMBRELLA,2,1258,21,2200,942,1,42
4462,BLACK/BLUE POLKADOT UMBRELLA,1,1097,12,1300,203,1,24
4463,RED 3 PIECE RETROSPOT CUTLERY SET,5,775,25,2600,1825,1,50
4464,PACK OF 72 RETROSPOT CAKE CASES,7,392,8,900,508,1,16
4465,SET OF 72 RETROSPOT PAPER  DOILIES,10,399,4,500,101,1,8
4466,BLUE COAT RACK PARIS FASHION,6,683,9,1000,317,1,18
4467,PLASTERS IN TIN SKULLS,10,2248,23,2400,152,1,46
4468,SLEEPING CAT ERASERS,1,591,10,1100,509,1,20
4469,CARD BIRTHDAY COWBOY,5,1301,20,2100,799,1,40
4470,PACK 3 BOXES CHRISTMAS PANNETONE,10,1140,25,2600,1460,1,50
4471,ROTATING SILVER ANGELS T-LIGHT HLDR,5,855,8,900,45,1,16
4472,COSY HOUR GIANT TUBE MATCHES,1,165,4,500,335,1,8
4473,RIBBON REEL MAKING SNOWMEN ,5,1400,21,2200,800,1,42
4474,MINI PAINT SET VINTAGE ,5,1637,17,1800,163,1,34
4475,7 TRADITIONAL SPINNING TOPS,9,311,5,600,289,1,10
4476,SET OF 6 SOLDIER SKITTLES,6,261,15,1600,1339,1,30
4477,BAG 500g SWIRLY MARBLES,5,2300,23,2400,100,1,46
4478,8 STRAND GLASS NECKLACE CRYSTAL,5,1095,22,2300,1205,1,44
4479,WHITE SKULL HOT WATER BOTTLE ,6,646,8,900,254,1,16
4480,SCOTTIE DOG HOT WATER BOTTLE,2,218,14,1500,1282,1,28
4481,SQUARECUSHION COVER PINK UNION FLAG,10,105,9,1000,895,1,18
4482,SPACEBOY CHILDRENS EGG CUP,8,1157,12,1300,143,1,24
4483,CHILDREN'S SPACEBOY MUG,5,548,15,1600,1052,1,30
4484,HAND WARMER SCOTTY DOG DESIGN,4,411,8,900,489,1,16
4485,FELTCRAFT CUSHION OWL,5,1031,13,1400,369,1,26
4486,BLACK CANDELABRA T-LIGHT HOLDER,6,1677,20,2100,423,1,40
4487,TOY TIDY DOLLY GIRL DESIGN,2,208,14,1500,1292,1,28
4488,SET 12 LAVENDER  BOTANICAL T-LIGHTS,6,2086,21,2200,114,1,42
4489,UNION JACK FLAG LUGGAGE TAG,4,750,11,1200,450,1,22
4490,RED HEART LUGGAGE TAG,9,100,0,100,0,1,0
4491,RED GLASS TASSLE BAG CHARM,5,368,16,1700,1332,1,32
4492,CLEAR ACRYLIC FACETED BANGLE,9,913,10,1100,187,1,20
4493,8 STRAND GLASS NECKLACE CRYSTAL,1,791,18,1900,1109,1,36
4494,DOORMAT UNION JACK GUNS AND ROSES,8,495,8,900,405,1,16
4495,VANILLA SCENT CANDLE JEWELLED BOX,7,894,8,900,6,1,16
4496,FULL ENGLISH BREAKFAST PLATE,9,1113,17,1800,687,1,34
4497,BLACK CANDELABRA T-LIGHT HOLDER,9,171,9,1000,829,1,18
4498,MAGIC DRAWING SLATE CIRCUS PARADE  ,10,127,23,2400,2273,1,46
4499,CHRISTMAS HANGING HEART WITH BELL,10,100,0,100,0,1,0
4500,CAKE STAND VICTORIAN FILIGREE MED,8,213,24,2500,2287,1,48
4501,PAISLEY PATTERN  STICKERS,7,100,0,100,0,1,0
4502,FLOWERS  STICKERS,7,1859,19,2000,141,1,38
4503,PINK NEW BAROQUECANDLESTICK CANDLE,2,1189,19,2000,811,1,38
4504,BLUE NEW BAROQUE CANDLESTICK CANDLE,1,579,25,2600,2021,1,50
4505,JUMBO STORAGE BAG SUKI,8,1581,19,2000,419,1,38
4506,BLACK LOVE BIRD CANDLE,5,1541,17,1800,259,1,34
4507,PARTY TIME PENCIL ERASERS,4,1043,10,1100,57,1,20
4508,DISCO BALL CHRISTMAS DECORATION,8,119,2,300,181,1,4
4509,PINK B'FLY C/COVER W BOBBLES,8,944,12,1300,356,1,24
4510,PINK UNION JACK  LUGGAGE TAG,10,134,2,300,166,1,4
4511,9 RIBBONS ELEGANT CHRISTMAS ,7,565,7,800,235,1,14
4512,UNION JACK FLAG LUGGAGE TAG,5,653,9,1000,347,1,18
4513,AGED GLASS SILVER T-LIGHT HOLDER,5,158,21,2200,2042,1,42
4514,BOOM BOX SPEAKER GIRLS,3,164,6,700,536,1,12
4515,9 RIBBONS SHIMMERING PINKS ,2,237,2,300,63,1,4
4516, SET 2 TEA TOWELS I LOVE LONDON ,7,227,4,500,273,1,8
4517,JUMBO BAG OWLS,7,223,8,900,677,1,16
4518,SANDWICH BATH SPONGE,10,673,12,1300,627,1,24
4519,OWL DOORSTOP,2,1659,25,2600,941,1,50
4520,8 STRAND GLASS NECKLACE CRYSTAL,9,122,7,800,678,1,14
4521,HAND WARMER UNION JACK,10,207,10,1100,893,1,20
4522,HAND WARMER SCOTTY DOG DESIGN,2,289,2,300,11,1,4
4523,LARGE POPCORN HOLDER ,3,444,6,700,256,1,12
4524,PAINTED METAL STAR WITH HOLLY BELLS,9,1377,17,1800,423,1,34
4525,PAINTED METAL HEART WITH HOLLY BELL,3,283,22,2300,2017,1,44
4526,ANGEL DECORATION STARS ON DRESS,4,677,11,1200,523,1,22
4527,SMALL POPCORN HOLDER,10,496,4,500,4,1,8
4528,JUMBO BAG RED RETROSPOT,8,107,12,1300,1193,1,24
4529,JUMBO BAG STRAWBERRY,5,289,10,1100,811,1,20
4530,STRAWBERRY SHOPPER BAG,5,235,3,400,165,1,6
4531,STRAWBERRY CHARLOTTE BAG,1,531,8,900,369,1,16
4532, SET 2 TEA TOWELS I LOVE LONDON ,3,153,2,300,147,1,4
4533,PACK OF 12 RED RETROSPOT TISSUES ,2,440,22,2300,1860,1,44
4534,SCOTTIE DOG HOT WATER BOTTLE,5,376,5,600,224,1,10
4535,CHOCOLATE HOT WATER BOTTLE,8,378,5,600,222,1,10
4536,LUNCH BAG CARS BLUE,5,1546,25,2600,1054,1,50
4537,LUNCH BAG SPACEBOY DESIGN ,8,2068,23,2400,332,1,46
4538,ROUND SNACK BOXES SET OF4 WOODLAND ,3,1476,15,1600,124,1,30
4539,LUNCH BAG DOLLY GIRL DESIGN,2,114,3,400,286,1,6
4540,LUNCH BAG SUKI  DESIGN ,9,764,9,1000,236,1,18
4541,LUNCH BAG  BLACK SKULL.,3,1911,20,2100,189,1,40
4542,ROUND SNACK BOXES SET OF 4 FRUITS ,10,599,22,2300,1701,1,44
4543,ROUND SNACK BOXES SET OF 4 SKULLS,3,126,4,500,374,1,8
4544,DOLLY GIRL LUNCH BOX,8,1953,20,2100,147,1,40
4545,SPACEBOY LUNCH BOX ,6,363,10,1100,737,1,20
4546,GREEN POLKADOT PLATE ,9,323,7,800,477,1,14
4547,BLUE POLKADOT PLATE ,3,662,22,2300,1638,1,44
4548,RED RETROSPOT PLATE ,4,477,6,700,223,1,12
4549,PINK  POLKADOT PLATE ,9,127,1,200,73,1,2
4550,ROUND SNACK BOXES SET OF 4 SKULLS,1,847,21,2200,1353,1,42
4551,FELTCRAFT DOLL MOLLY,9,442,20,2100,1658,1,40
4552,FELTCRAFT CHRISTMAS FAIRY,10,119,2,300,181,1,4
4553,TRAVEL SEWING KIT,1,2437,25,2600,163,1,50
4554,SET OF 3 NOTEBOOKS IN PARCEL,8,607,13,1400,793,1,26
4555,RED RETROSPOT TAPE,1,256,7,800,544,1,14
4556,COSY SLIPPER SHOES SMALL  RED ,2,426,6,700,274,1,12
4557,9 RIBBONS RUSTIC CHARM,6,478,8,900,422,1,16
4558,SCANDINAVIAN REDS RIBBONS,4,100,0,100,0,1,0
4559,JAM MAKING SET PRINTED,6,414,6,700,286,1,12
4560,15 DAISY PEGS IN WOOD BOX,7,489,15,1600,1111,1,30
4561,HOT WATER BOTTLE BABUSHKA ,3,925,12,1300,375,1,24
4562,FELTCRAFT PRINCESS CHARLOTTE DOLL,8,446,17,1800,1354,1,34
4563,FELTCRAFT CHRISTMAS FAIRY,6,630,7,800,170,1,14
4564,FELTCRAFT PRINCESS CHARLOTTE DOLL,10,185,1,200,15,1,2
4565,9 RIBBONS RUSTIC CHARM,7,296,5,600,304,1,10
4566,COSY SLIPPER SHOES SMALL  RED ,4,209,10,1100,891,1,20
4567,SCANDINAVIAN REDS RIBBONS,6,733,19,2000,1267,1,38
4568,8 HOOK HANGER RED MAGIC TOADSTOOL,6,288,2,300,12,1,4
4569,CHRISTMAS CRAFT TREE TOP ANGEL,9,100,0,100,0,1,0
4570,CHRISTMAS CRAFT LITTLE FRIENDS,8,1688,24,2500,812,1,48
4571,8 HOOK HANGER RED MAGIC TOADSTOOL,4,498,15,1600,1102,1,30
4572,9 RIBBONS RUSTIC CHARM,7,668,11,1200,532,1,22
4573,15 DAISY PEGS IN WOOD BOX,7,1503,17,1800,297,1,34
4574,SET OF 3 NOTEBOOKS IN PARCEL,4,1547,19,2000,453,1,38
4575,8 HOOK HANGER MAGIC TOADSTOOL,8,430,8,900,470,1,16
4576,SCANDINAVIAN REDS RIBBONS,6,782,14,1500,718,1,28
4577,RED TOADSTOOL LED NIGHT LIGHT,1,1328,18,1900,572,1,36
4578,8 HOOK HANGER RED MAGIC TOADSTOOL,7,382,18,1900,1518,1,36
4579,COSY SLIPPER SHOES SMALL GREEN,6,367,14,1500,1133,1,28
4580,COSY SLIPPER SHOES SMALL  RED ,3,684,25,2600,1916,1,50
4581,FELTCRAFT DOLL ROSIE,8,1472,14,1500,28,1,28
4582,FELTCRAFT DOLL MOLLY,10,225,24,2500,2275,1,48
4583,FELTCRAFT DOLL EMILY,7,365,6,700,335,1,12
4584,FELTCRAFT PRINCESS CHARLOTTE DOLL,7,238,19,2000,1762,1,38
4585,FELTCRAFT PRINCESS OLIVIA DOLL,7,205,5,600,395,1,10
4586,REX CASH+CARRY JUMBO SHOPPER,5,1232,24,2500,1268,1,48
4587,FELTCRAFT DOLL MOLLY,10,514,18,1900,1386,1,36
4588,FELTCRAFT CUSHION OWL,5,517,12,1300,783,1,24
4589,CHRISTMAS CRAFT TREE TOP ANGEL,9,199,1,200,1,1,2
4590,CHRISTMAS CRAFT LITTLE FRIENDS,6,858,8,900,42,1,16
4591,FELTCRAFT CUSHION RABBIT,6,115,8,900,785,1,16
4592,FELTCRAFT CUSHION BUTTERFLY,8,1100,21,2200,1100,1,42
4593,15 DAISY PEGS IN WOOD BOX,3,570,6,700,130,1,12
4594,PAPER CHAIN KIT 50'S CHRISTMAS ,2,287,4,500,213,1,8
4595,FELTCRAFT CUSHION BUTTERFLY,7,378,23,2400,2022,1,46
4596,15 DAISY PEGS IN WOOD BOX,6,768,11,1200,432,1,22
4597,ROSE COTTAGE KEEPSAKE BOX ,5,1122,15,1600,478,1,30
4598,TOTE BAG I LOVE LONDON,1,297,9,1000,703,1,18
4599,15 DAISY PEGS IN WOOD BOX,4,1182,21,2200,1018,1,42
4600,TOTE BAG I LOVE LONDON,10,349,20,2100,1751,1,40
4601,FOLDING UMBRELLA PINKWHITE POLKADOT,1,145,3,400,255,1,6
4602,FOLDING UMBRELLA CREAM POLKADOT,5,578,7,800,222,1,14
4603,FOLDING UMBRELLA WHITE/RED POLKADOT,3,1007,13,1400,393,1,26
4604,SET 10 LIGHTS NIGHT OWL,6,813,22,2300,1487,1,44
4605,SMALL POPCORN HOLDER,7,203,7,800,597,1,14
4606, SET 2 TEA TOWELS I LOVE LONDON ,7,201,6,700,499,1,12
4607,FOLDING UMBRELLA RED/WHITE POLKADOT,5,231,4,500,269,1,8
4608,BABUSHKA LIGHTS STRING OF 13,7,1373,15,1600,227,1,30
4609,LUNCH BAG RED RETROSPOT,1,835,8,900,65,1,16
4610,S/4 VALENTINE DECOUPAGE HEART BOX,5,589,22,2300,1711,1,44
4611,FOLDING UMBRELLA CREAM POLKADOT,9,286,6,700,414,1,12
4612, SET 2 TEA TOWELS I LOVE LONDON ,4,1113,19,2000,887,1,38
4613,FOLDING UMBRELLA RED/WHITE POLKADOT,3,1274,21,2200,926,1,42
4614,SOLDIERS EGG CUP ,4,235,9,1000,765,1,18
4615,S/4 VALENTINE DECOUPAGE HEART BOX,7,115,1,200,85,1,2
4616,RED RETROSPOT MINI CASES,5,1945,19,2000,55,1,38
4617,,5,969,9,1000,31,1,18
4618,63 CAKE CASES VINTAGE CHRISTMAS,1,1454,17,1800,346,1,34
4619,PAPER CHAIN KIT VINTAGE CHRISTMAS,6,652,8,900,248,1,16
4620,RIBBON REEL CHRISTMAS SOCK BAUBLE,5,100,0,100,0,1,0
4621,RIBBON REEL SNOWY VILLAGE,1,248,3,400,152,1,6
4622,RIBBON REEL MAKING SNOWMEN ,4,585,7,800,215,1,14
4623,SET OF 20 VINTAGE CHRISTMAS NAPKINS,4,440,11,1200,760,1,22
4624,TURQUOISE CHRISTMAS TREE ,4,503,10,1100,597,1,20
4625,RED STAR CARD HOLDER,4,1118,14,1500,382,1,28
4626,WICKER WREATH SMALL,2,1027,25,2600,1573,1,50
4627,HEART OF WICKER LARGE,6,2116,23,2400,284,1,46
4628,ADVENT CALENDAR GINGHAM SACK,4,579,12,1300,721,1,24
4629,HEART OF WICKER SMALL,7,486,5,600,114,1,10
4630,FELTCRAFT BUTTERFLY HEARTS,7,172,6,700,528,1,12
4631,PARTY CONE CHRISTMAS DECORATION ,8,389,24,2500,2111,1,48
4632,VINTAGE HEADS AND TAILS CARD GAME ,7,262,2,300,38,1,4
4633,WICKER STAR ,1,625,13,1400,775,1,26
4634,VINTAGE SNAP CARDS,10,717,7,800,83,1,14
4635,FELTCRAFT 6 FLOWER FRIENDS,1,2045,20,2100,55,1,40
4636, SET 2 TEA TOWELS I LOVE LONDON ,3,304,14,1500,1196,1,28
4637,JAM MAKING SET PRINTED,10,1794,25,2600,806,1,50
4638,BIRD DECORATION RED RETROSPOT,7,419,25,2600,2181,1,50
4639,CHRISTMAS GINGHAM TREE,4,1063,10,1100,37,1,20
4640,CHRISTMAS GINGHAM STAR,6,839,18,1900,1061,1,36
4641,CHRISTMAS GINGHAM HEART,1,1481,17,1800,319,1,34
4642,PACK OF 12 PINK POLKADOT TISSUES,1,691,11,1200,509,1,22
4643,FELTCRAFT PRINCESS LOLA DOLL,4,653,13,1400,747,1,26
4644,PACK OF 12 LONDON TISSUES ,2,1399,25,2600,1201,1,50
4645,PURPLE DRAWERKNOB ACRYLIC EDWARDIAN,4,1160,15,1600,440,1,30
4646,CHILDREN'S APRON DOLLY GIRL ,2,931,21,2200,1269,1,42
4647,CHILDRENS APRON SPACEBOY DESIGN,10,869,21,2200,1331,1,42
4648,CHRISTMAS LIGHTS 10 SANTAS ,3,372,3,400,28,1,6
4649,CHRISTMAS LIGHTS 10 REINDEER,5,960,22,2300,1340,1,44
4650,PAPER CHAIN KIT 50'S CHRISTMAS ,10,214,7,800,586,1,14
4651,FELTCRAFT CHRISTMAS FAIRY,3,158,1,200,42,1,2
4652,PACK OF 72 RETROSPOT CAKE CASES,2,550,12,1300,750,1,24
4653,PACK OF 60 MUSHROOM CAKE CASES,4,487,17,1800,1313,1,34
4654,63 CAKE CASES DOLLY GIRL DESIGN,10,1583,20,2100,517,1,40
4655,PACK OF 60 PINK PAISLEY CAKE CASES,10,1747,19,2000,253,1,38
4656,HAND WARMER BABUSHKA DESIGN,5,1045,17,1800,755,1,34
4657,HAND WARMER BIRD DESIGN,3,594,11,1200,606,1,22
4658,HAND WARMER OWL DESIGN,5,376,25,2600,2224,1,50
4659,HAND WARMER RED RETROSPOT,7,1002,18,1900,898,1,36
4660,SET 12 RETRO WHITE CHALK STICKS,3,146,1,200,54,1,2
4661,FELTCRAFT HAIRBAND RED AND BLUE,2,124,1,200,76,1,2
4662,FELTCRAFT HAIRBAND PINK AND PURPLE,5,322,7,800,478,1,14
4663,FELTCRAFT HAIRBANDS PINK AND WHITE ,4,939,15,1600,661,1,30
4664,TV DINNER TRAY DOLLY GIRL,3,833,9,1000,167,1,18
4665,PLASTERS IN TIN VINTAGE PAISLEY ,3,187,25,2600,2413,1,50
4666,PLASTERS IN TIN SPACEBOY,9,265,24,2500,2235,1,48
4667,PLASTERS IN TIN WOODLAND ANIMALS,4,595,19,2000,1405,1,38
4668,MAGIC DRAWING SLATE SPACEBOY ,10,825,25,2600,1775,1,50
4669,MAGIC DRAWING SLATE CIRCUS PARADE  ,6,363,19,2000,1637,1,38
4670,MAGIC DRAWING SLATE GO TO THE FAIR ,2,101,1,200,99,1,2
4671,MAGIC DRAWING SLATE DOLLY GIRL ,3,1212,22,2300,1088,1,44
4672,CHARLIE + LOLA RED HOT WATER BOTTLE,2,1405,15,1600,195,1,30
4673,HOT WATER BOTTLE BABUSHKA ,8,433,9,1000,567,1,18
4674,URBAN BLACK RIBBONS ,1,184,24,2500,2316,1,48
4675,FELTCRAFT PRINCESS CHARLOTTE DOLL,4,414,18,1900,1486,1,36
4676,SET OF 6 T-LIGHTS TOADSTOOLS,6,1053,12,1300,247,1,24
4677,ROTATING LEAVES T-LIGHT HOLDER,4,1129,12,1300,171,1,24
4678,RED  HARMONICA IN BOX ,5,1336,25,2600,1264,1,50
4679,CUPCAKE LACE PAPER SET 9,9,986,11,1200,214,1,22
4680,FAMILY PHOTO FRAME CORNICE,7,827,10,1100,273,1,20
4681,TRIPLE PHOTO FRAME CORNICE ,6,417,7,800,383,1,14
4682,WOODEN FRAME ANTIQUE WHITE ,6,575,11,1200,625,1,22
4683,WOODEN BOX OF DOMINOES,5,680,20,2100,1420,1,40
4684,TRADITIONAL WOODEN CATCH CUP GAME ,2,550,9,1000,450,1,18
4685,TRADITIONAL WOODEN SKIPPING ROPE,3,878,12,1300,422,1,24
4686,S/6 WOODEN SKITTLES IN COTTON BAG,5,172,2,300,128,1,4
4687,RED METAL BEACH SPADE ,6,1241,17,1800,559,1,34
4688,BOYS VINTAGE TIN SEASIDE BUCKET,7,792,19,2000,1208,1,38
4689,GIRLS VINTAGE TIN SEASIDE BUCKET,9,706,8,900,194,1,16
4690,GREY HEART HOT WATER BOTTLE,10,580,13,1400,820,1,26
4691,SCOTTIE DOG HOT WATER BOTTLE,10,156,1,200,44,1,2
4692,BIRD HOUSE HOT WATER BOTTLE,8,1544,23,2400,856,1,46
4693,KINGS CHOICE TEA CADDY ,1,609,13,1400,791,1,26
4694,KINGS CHOICE BISCUIT TIN,2,968,13,1400,432,1,26
4695,METAL SIGN EMPIRE TEA,5,963,15,1600,637,1,30
4696,HOMEMADE JAM SCENTED CANDLES,2,1072,17,1800,728,1,34
4697,SET OF 6 SOLDIER SKITTLES,2,770,7,800,30,1,14
4698,FAWN BLUE HOT WATER BOTTLE,3,649,11,1200,551,1,22
4699,HAND WARMER RED RETROSPOT,7,2249,23,2400,151,1,46
4700,HOT WATER BOTTLE BABUSHKA ,6,917,17,1800,883,1,34
4701,WHITE SKULL HOT WATER BOTTLE ,6,1833,25,2600,767,1,50
4702,RETROSPOT HEART HOT WATER BOTTLE,10,782,23,2400,1618,1,46
4703,RED WOOLLY HOTTIE WHITE HEART.,5,601,10,1100,499,1,20
4704,SCOTTIE DOG HOT WATER BOTTLE,6,109,3,400,291,1,6
4705,GREY HEART HOT WATER BOTTLE,5,1570,19,2000,430,1,38
4706,HOT WATER BOTTLE BABUSHKA ,10,800,13,1400,600,1,26
4707,PACK OF 6 BIRDY GIFT TAGS,1,607,7,800,193,1,14
4708,CHILLI LIGHTS,9,254,3,400,146,1,6
4709,PIGGY BANK RETROSPOT ,8,486,21,2200,1714,1,42
4710,CERAMIC STRAWBERRY MONEY BOX,8,245,3,400,155,1,6
4711,CERAMIC STRAWBERRY CAKE MONEY BANK,1,1002,22,2300,1298,1,44
4712,CERAMIC CHERRY CAKE MONEY BANK,2,1255,12,1300,45,1,24
4713,CERAMIC HEART FAIRY CAKE MONEY BANK,8,2102,24,2500,398,1,48
4714,CERAMIC PIRATE CHEST MONEY BANK,10,680,16,1700,1020,1,32
4715,DOORSTOP RETROSPOT HEART,7,1386,17,1800,414,1,34
4716,GINGHAM HEART  DOORSTOP RED,9,649,8,900,251,1,16
4717,RETROSPOT BABUSHKA DOORSTOP,6,304,8,900,596,1,16
4718,SILK PURSE BABUSHKA RED,5,552,6,700,148,1,12
4719,SILK PURSE BABUSHKA PINK,5,988,13,1400,412,1,26
4720,FAMILY PHOTO FRAME CORNICE,9,398,6,700,302,1,12
4721,SWEETHEART WIRE WALL TIDY,10,1727,24,2500,773,1,48
4722,JAM MAKING SET PRINTED,7,933,11,1200,267,1,22
4723,RED RETROSPOT OVEN GLOVE ,7,826,12,1300,474,1,24
4724,CREAM HEART CARD HOLDER,4,417,11,1200,783,1,22
4725,NAMASTE SWAGAT INCENSE,7,836,16,1700,864,1,32
4726,CERAMIC STRAWBERRY DESIGN MUG,9,536,24,2500,1964,1,48
4727,BLACK HEART CARD HOLDER,9,157,2,300,143,1,4
4728,CLASSICAL ROSE SMALL VASE,7,807,10,1100,293,1,20
4729,HYACINTH BULB T-LIGHT CANDLES,3,853,23,2400,1547,1,46
4730,CHRISTMAS CRAFT WHITE FAIRY ,2,2108,23,2400,292,1,46
4731,CHRISTMAS CRAFT LITTLE FRIENDS,9,791,14,1500,709,1,28
4732,COSY HOUR CIGAR BOX MATCHES ,4,151,6,700,549,1,12
4733,RED TEA TOWEL CLASSIC DESIGN,1,668,22,2300,1632,1,44
4734,HEART FILIGREE DOVE  SMALL,7,632,8,900,268,1,16
4735,RETROSPOT CHILDRENS APRON,6,306,10,1100,794,1,20
4736,COLOURING PENCILS BROWN TUBE,8,930,11,1200,270,1,22
4737,7 IVORY DINNER CANDLES SILVER FLOCK,8,525,12,1300,775,1,24
4738,HEART FILIGREE DOVE  SMALL,2,106,7,800,694,1,14
4739,ZINC METAL HEART DECORATION,10,396,3,400,4,1,6
4740,GREEN FERN NOTEBOOK,2,400,7,800,400,1,14
4741,BLUE PAISLEY NOTEBOOK,10,365,25,2600,2235,1,50
4742,CHRYSANTHEMUM NOTEBOOK,4,541,11,1200,659,1,22
4743,LARGE CHINESE STYLE SCISSOR,5,1179,18,1900,721,1,36
4744,SMALL CHINESE STYLE SCISSOR,4,874,17,1800,926,1,34
4745,S/6 WOODEN SKITTLES IN COTTON BAG,1,958,9,1000,42,1,18
4746,TRADITIONAL WOODEN SKIPPING ROPE,3,449,8,900,451,1,16
4747,SET OF 6 SOLDIER SKITTLES,8,947,13,1400,453,1,26
4748,7 TRADITIONAL SPINNING TOPS,10,634,17,1800,1166,1,34
4749,ROTATING SILVER ANGELS T-LIGHT HLDR,6,292,14,1500,1208,1,28
4750,BLACK LOVE BIRD CANDLE,3,1465,14,1500,35,1,28
4751,RETROSPOT CHILDRENS APRON,8,517,13,1400,883,1,26
4752,HANGING GLASS ETCHED TEALIGHT,10,357,7,800,443,1,14
4753,HANGING GLASS ETCHED TEALIGHT,4,1180,16,1700,520,1,32
4754,BLUE NEW BAROQUE CANDLESTICK CANDLE,8,189,4,500,311,1,8
4755,COOKING SET RETROSPOT,1,943,13,1400,457,1,26
4756,KINGS CHOICE GIANT TUBE MATCHES,6,815,8,900,85,1,16
4757,COSY HOUR GIANT TUBE MATCHES,7,1598,19,2000,402,1,38
4758,PLACE SETTING WHITE STAR,2,1134,24,2500,1366,1,48
4759,HYACINTH BULB T-LIGHT CANDLES,3,113,18,1900,1787,1,36
4760,S/15 SILVER GLASS BAUBLES IN BAG,2,769,8,900,131,1,16
4761,FRENCH WC SIGN BLUE METAL,6,1566,22,2300,734,1,44
4762,KINGS CHOICE GIANT TUBE MATCHES,1,100,0,100,0,1,0
4763,75 SWEETHEART FAIRY CAKE CASES,10,950,17,1800,850,1,34
4764,ASSORTED COLOUR BIRD ORNAMENT,9,1432,15,1600,168,1,30
4765,FAIRY SOAP SOAP HOLDER,3,318,12,1300,982,1,24
4766,GREEN GIANT GARDEN THERMOMETER,6,321,22,2300,1979,1,44
4767,IVORY GIANT GARDEN THERMOMETER,2,317,12,1300,983,1,24
4768,BLUE GIANT GARDEN THERMOMETER,8,248,8,900,652,1,16
4769,PACK OF 60 PINK PAISLEY CAKE CASES,5,285,5,600,315,1,10
4770,RETROSPOT HEART HOT WATER BOTTLE,3,256,9,1000,744,1,18
4771,CHICK GREY HOT WATER BOTTLE,8,1632,24,2500,868,1,48
4772,VICTORIAN SEWING BOX SMALL ,4,579,11,1200,621,1,22
4773,VICTORIAN SEWING BOX MEDIUM,4,763,13,1400,637,1,26
4774,SET/10 RED POLKADOT PARTY CANDLES,1,460,25,2600,2140,1,50
4775,WASHROOM METAL SIGN,3,583,13,1400,817,1,26
4776,BLACK SWEETHEART BRACELET,8,201,8,900,699,1,16
4777,DIAMANTE HAIR GRIP PACK/2 BLACK DIA,8,318,3,400,82,1,6
4778,BLACK DIAMANTE EXPANDABLE RING,8,1785,21,2200,415,1,42
4779,DIAMANTE HAIR GRIP PACK/2 RUBY,6,412,18,1900,1488,1,36
4780,DIAMANTE HAIR GRIP PACK/2 MONTANA,2,594,17,1800,1206,1,34
4781,BLUE SWEETHEART BRACELET,5,554,10,1100,546,1,20
4782,PINK SWEETHEART BRACELET,7,860,22,2300,1440,1,44
4783,PURPLE SWEETHEART BRACELET,4,528,6,700,172,1,12
4784,JUMBO BAG PINK POLKADOT,2,656,22,2300,1644,1,44
4785,JUMBO BAG RED RETROSPOT,6,180,3,400,220,1,6
4786,ASSORTED COLOUR BIRD ORNAMENT,10,1778,23,2400,622,1,46
4787,PAPER CHAIN KIT 50'S CHRISTMAS ,3,175,17,1800,1625,1,34
4788,RIBBON REEL CHRISTMAS PRESENT ,7,295,10,1100,805,1,20
4789,FIRST AID TIN,9,1071,22,2300,1229,1,44
4790,MAKE YOUR OWN MONSOON CARD KIT,7,350,21,2200,1850,1,42
4791,PACK OF 12 HEARTS DESIGN TISSUES ,10,1580,19,2000,420,1,38
4792,PACK OF 12 RED RETROSPOT TISSUES ,4,365,9,1000,635,1,18
4793,SOLDIERS EGG CUP ,8,100,0,100,0,1,0
4794,HEART IVORY TRELLIS SMALL,2,389,23,2400,2011,1,46
4795,HEART FILIGREE DOVE  SMALL,6,865,19,2000,1135,1,38
4796,HEART FILIGREE DOVE LARGE,9,2197,24,2500,303,1,48
4797,PACK 3 BOXES BIRD PANNETONE ,4,1375,16,1700,325,1,32
4798,PACK 3 BOXES CHRISTMAS PANNETONE,4,100,0,100,0,1,0
4799,SMALL POPCORN HOLDER,4,2157,21,2200,43,1,42
4800,PACK OF 60 PINK PAISLEY CAKE CASES,3,545,5,600,55,1,10
4801,SET OF 6 SOLDIER SKITTLES,7,1462,20,2100,638,1,40
4802,SWIRLY CIRCULAR RUBBERS IN BAG,6,648,7,800,152,1,14
4803,VINTAGE PAISLEY STATIONERY SET,4,573,5,600,27,1,10
4804,PAPER CHAIN KIT VINTAGE CHRISTMAS,10,872,11,1200,328,1,22
4805,SET/10 BLUE POLKADOT PARTY CANDLES,9,1618,19,2000,382,1,38
4806,RIBBON REEL SOCKS AND MITTENS,8,948,25,2600,1652,1,50
4807,63 CAKE CASES VINTAGE CHRISTMAS,7,1239,22,2300,1061,1,44
4808,CHRISTMAS METAL TAGS ASSORTED ,4,301,4,500,199,1,8
4809,CHRISTMAS TREE T-LIGHT HOLDER,6,278,2,300,22,1,4
4810,STAR  T-LIGHT HOLDER ,9,1565,21,2200,635,1,42
4811,HEART T-LIGHT HOLDER ,3,153,24,2500,2347,1,48
4812,MINI FUNKY DESIGN TAPES,8,1583,18,1900,317,1,36
4813,SET OF 6 T-LIGHTS SNOWMEN,7,1367,18,1900,533,1,36
4814,STAR WOODEN CHRISTMAS DECORATION,7,453,19,2000,1547,1,38
4815,WOODEN HEART CHRISTMAS SCANDINAVIAN,5,1313,25,2600,1287,1,50
4816,CHRISTMAS RETROSPOT TREE WOOD,7,181,15,1600,1419,1,30
4817,SET OF 6 T-LIGHTS SANTA,8,363,8,900,537,1,16
4818,SET/9 CHRISTMAS T-LIGHTS SCENTED ,6,2397,23,2400,3,1,46
4819,BLUE ROSE FABRIC MIRROR,7,133,6,700,567,1,12
4820,THREE CANVAS LUGGAGE TAGS,2,282,3,400,118,1,6
4821,RETROSPOT PARTY BAG + STICKER SET,6,1385,20,2100,715,1,40
4822,PLASTERS IN TIN VINTAGE PAISLEY ,5,1320,15,1600,280,1,30
4823,RETROSPOT SMALL TUBE MATCHES,1,1199,22,2300,1101,1,44
4824,HAND WARMER SCOTTY DOG DESIGN,10,175,23,2400,2225,1,46
4825,3D CHRISTMAS STAMPS STICKERS ,7,2274,24,2500,226,1,48
4826,HAND WARMER SCOTTY DOG DESIGN,6,953,21,2200,1247,1,42
4827,HAND WARMER SCOTTY DOG DESIGN,4,135,16,1700,1565,1,32
4828,CLOTHES PEGS RETROSPOT PACK 27,2,292,4,500,208,1,8
4829,39 FOIL HEART CAKE CASES,10,740,8,900,160,1,16
4830,CHRISTMAS METAL TAGS ASSORTED ,8,1319,19,2000,681,1,38
4831,PACK OF 6 SWEETIE GIFT BOXES,1,887,12,1300,413,1,24
4832,PACK OF 72 RETROSPOT CAKE CASES,4,477,24,2500,2023,1,48
4833,PACK OF 72 RETROSPOT CAKE CASES,4,161,16,1700,1539,1,32
4834,PACK OF 6 BIRDY GIFT TAGS,9,721,12,1300,579,1,24
4835,SET/10 RED POLKADOT PARTY CANDLES,10,1488,16,1700,212,1,32
4836,SET/10 PINK POLKADOT PARTY CANDLES,2,515,18,1900,1385,1,36
4837,SET OF 3 NOTEBOOKS IN PARCEL,6,194,2,300,106,1,4
4838,STAR  T-LIGHT HOLDER ,4,151,1,200,49,1,2
4839,CINAMMON SET OF 9 T-LIGHTS,9,1555,21,2200,645,1,42
4840,ORANGE SCENTED SET/9 T-LIGHTS,2,348,13,1400,1052,1,26
4841,RIBBON REEL STRIPES DESIGN ,2,639,21,2200,1561,1,42
4842,SET OF 2 TINS JARDIN DE PROVENCE,6,138,1,200,62,1,2
4843,MAKE YOUR OWN PLAYTIME CARD KIT,3,571,16,1700,1129,1,32
4844,DINOSAURS  WRITING SET ,6,892,8,900,8,1,16
4845,BALLOONS  WRITING SET ,3,2295,23,2400,105,1,46
4846,SKULLS WRITING SET ,2,2364,24,2500,136,1,48
4847,VINTAGE PAISLEY STATIONERY SET,2,250,9,1000,750,1,18
4848,COSY SLIPPER SHOES SMALL  RED ,8,383,4,500,117,1,8
4849,DOORMAT BLACK FLOCK ,10,139,3,400,261,1,6
4850,JUMBO  BAG BAROQUE BLACK WHITE,1,1061,10,1100,39,1,20
4851,JAM MAKING SET WITH JARS,10,1787,21,2200,413,1,42
4852,ORANGE SCENTED SET/9 T-LIGHTS,10,1870,19,2000,130,1,38
4853,CINAMMON SET OF 9 T-LIGHTS,1,1719,20,2100,381,1,40
4854,HAND WARMER SCOTTY DOG DESIGN,8,495,5,600,105,1,10
4855,CHRISTMAS DECOUPAGE CANDLE,9,829,13,1400,571,1,26
4856,HEART T-LIGHT HOLDER ,7,580,9,1000,420,1,18
4857,GROW YOUR OWN BASIL IN ENAMEL MUG,9,225,6,700,475,1,12
4858,OFFICE MUG WARMER POLKADOT,3,103,1,200,97,1,2
4859,SMALL POPCORN HOLDER,4,268,12,1300,1032,1,24
4860,JUMBO BAG DOLLY GIRL DESIGN,5,236,4,500,264,1,8
4861,JAM MAKING SET WITH JARS,4,1366,14,1500,134,1,28
4862,JAM MAKING SET PRINTED,5,483,11,1200,717,1,22
4863,SMALL GLASS HEART TRINKET POT,4,646,6,700,54,1,12
4864,RED WOOLLY HOTTIE WHITE HEART.,1,1020,10,1100,80,1,20
4865,BLACK RECORD COVER FRAME,9,1328,16,1700,372,1,32
4866,"RECORD FRAME 7"" SINGLE SIZE ",4,262,9,1000,738,1,18
4867,39 PENCILS TUBE RED RETROSPOT,5,244,12,1300,1056,1,24
4868,39 PENCILS TUBE WOODLAND,2,287,3,400,113,1,6
4869,SET OF 6 SOLDIER SKITTLES,3,100,0,100,0,1,0
4870,ROCKING HORSE RED CHRISTMAS ,6,413,18,1900,1487,1,36
4871,CHRISTMAS GINGHAM HEART,7,100,0,100,0,1,0
4872,CHRISTMAS GINGHAM STAR,5,270,7,800,530,1,14
4873,HAND WARMER UNION JACK,8,414,17,1800,1386,1,34
4874,HAND WARMER RED RETROSPOT,5,551,8,900,349,1,16
4875,REGENCY CAKESTAND 3 TIER,7,801,19,2000,1199,1,38
4876,JUMBO SHOPPER VINTAGE RED PAISLEY,5,808,16,1700,892,1,32
4877,RIBBON REEL SNOWY VILLAGE,8,265,6,700,435,1,12
4878,VINTAGE UNION JACK BUNTING,3,1788,21,2200,412,1,42
4879,JAM MAKING SET WITH JARS,4,1323,24,2500,1177,1,48
4880,RIBBON REEL STRIPES DESIGN ,9,2422,25,2600,178,1,50
4881,RETRO LONGBOARD IRONING BOARD COVER,3,100,0,100,0,1,0
4882,3D DOG PICTURE PLAYING CARDS,8,1661,19,2000,339,1,38
4883,RETROSPOT CIGAR BOX MATCHES ,10,912,16,1700,788,1,32
4884,SET/9 CHRISTMAS T-LIGHTS SCENTED ,3,234,2,300,66,1,4
4885,ROTATING SILVER ANGELS T-LIGHT HLDR,5,654,11,1200,546,1,22
4886,ROTATING SILVER ANGELS T-LIGHT HLDR,1,155,2,300,145,1,4
4887,SAVE THE PLANET COTTON TOTE BAG,8,1016,13,1400,384,1,26
4888,SET OF 20 VINTAGE CHRISTMAS NAPKINS,1,131,22,2300,2169,1,44
4889,PAPER BUNTING WHITE LACE,7,896,11,1200,304,1,22
4890,GENTLEMAN SHIRT REPAIR KIT ,5,494,8,900,406,1,16
4891,CARD I LOVE LONDON ,8,687,17,1800,1113,1,34
4892,PAPER CHAIN KIT VINTAGE CHRISTMAS,6,740,13,1400,660,1,26
4893,MIRRORED WALL ART FOXY,5,195,1,200,5,1,2
4894,MIRRORED WALL ART GENTS,7,994,17,1800,806,1,34
4895,AIRLINE BAG VINTAGE JET SET WHITE,1,471,4,500,29,1,8
4896,JAM MAKING SET PRINTED,4,603,10,1100,497,1,20
4897,POTTING SHED SOW 'N' GROW SET,10,261,8,900,639,1,16
4898,BABUSHKA LIGHTS STRING OF 13,2,976,19,2000,1024,1,38
4899,REX CASH+CARRY JUMBO SHOPPER,1,145,11,1200,1055,1,22
4900,AIRLINE BAG VINTAGE WORLD CHAMPION ,10,1284,23,2400,1116,1,46
4901,HAND WARMER BIRD DESIGN,10,124,4,500,376,1,8
4902,CHRISTMAS CRAFT LITTLE FRIENDS,9,255,12,1300,1045,1,24
4903,PINK HEARTS PAPER GARLAND,7,100,0,100,0,1,0
4904,POTTING SHED SEED ENVELOPES,2,1560,22,2300,740,1,44
4905,HI TEC ALPINE HAND WARMER,3,387,14,1500,1113,1,28
4906,FELTCRAFT CHRISTMAS FAIRY,10,492,4,500,8,1,8
4907,HI TEC ALPINE HAND WARMER,5,236,6,700,464,1,12
4908,ROTATING SILVER ANGELS T-LIGHT HLDR,1,487,9,1000,513,1,18
4909,6 STRIPEY MICE FELTCRAFT,8,536,14,1500,964,1,28
4910,FELTCRAFT 6 FLOWER FRIENDS,5,550,23,2400,1850,1,46
4911,CHRISTMAS CRAFT LITTLE FRIENDS,6,625,14,1500,875,1,28
4912,VINTAGE UNION JACK CUSHION COVER,7,661,17,1800,1139,1,34
4913,POLYESTER FILLER PAD 45x45cm,6,1360,18,1900,540,1,36
4914,DOLLY GIRL LUNCH BOX,6,112,12,1300,1188,1,24
4915,PACK OF 12 LONDON TISSUES ,3,348,8,900,552,1,16
4916,CARD DOLLY GIRL ,1,114,2,300,186,1,4
4917,CARD BILLBOARD FONT,2,618,6,700,82,1,12
4918,RAINY LADIES BIRTHDAY CARD,8,605,16,1700,1095,1,32
4919,GREY HEART HOT WATER BOTTLE,6,793,20,2100,1307,1,40
4920,RED WOOLLY HOTTIE WHITE HEART.,7,262,20,2100,1838,1,40
4921,RED WHITE SCARF  HOT WATER BOTTLE,8,369,4,500,131,1,8
4922, SET 2 TEA TOWELS I LOVE LONDON ,3,1774,18,1900,126,1,36
4923,SET OF 2 TEA TOWELS APPLE AND PEARS,7,1402,17,1800,398,1,34
4924,SET/2 RED RETROSPOT TEA TOWELS ,7,100,0,100,0,1,0
4925,LOVE BUILDING BLOCK WORD,5,493,19,2000,1507,1,38
4926,HOME BUILDING BLOCK WORD,10,539,5,600,61,1,10
4927,ASSORTED COLOUR BIRD ORNAMENT,3,118,1,200,82,1,2
4928,LANTERN CREAM GAZEBO ,1,2423,25,2600,177,1,50
4929,BLUE BIRDHOUSE DECORATION,8,137,10,1100,963,1,20
4930,WHITE HANGING HEART T-LIGHT HOLDER,6,103,1,200,97,1,2
4931,REGENCY CAKESTAND 3 TIER,9,698,8,900,202,1,16
4932,ANTIQUE SILVER TEA GLASS ENGRAVED,10,1950,21,2200,250,1,42
4933,AGED GLASS SILVER T-LIGHT HOLDER,2,375,7,800,425,1,14
4934,JAM MAKING SET WITH JARS,1,1886,25,2600,714,1,50
4935,HAND WARMER OWL DESIGN,8,1301,14,1500,199,1,28
4936,SET OF 2 WOODEN MARKET CRATES,5,185,1,200,15,1,2
4937,SET OF 6 T-LIGHTS TOADSTOOLS,8,481,14,1500,1019,1,28
4938,HAND WARMER UNION JACK,9,120,1,200,80,1,2
4939,HAND WARMER SCOTTY DOG DESIGN,10,1341,20,2100,759,1,40
4940,CLASSIC FRENCH STYLE BASKET NATURAL,4,982,19,2000,1018,1,38
4941,CRAZY DAISY HEART DECORATION,4,291,5,600,309,1,10
4942,GIN + TONIC DIET METAL SIGN,7,1617,23,2400,783,1,46
4943,IVORY GIANT GARDEN THERMOMETER,10,621,13,1400,779,1,26
4944,CARD HOLDER GINGHAM HEART,4,884,16,1700,816,1,32
4945,SMALL STRIPES CHOCOLATE GIFT BAG ,2,252,4,500,248,1,8
4946,S/6 WOODEN SKITTLES IN COTTON BAG,2,503,25,2600,2097,1,50
4947,HAND WARMER RED RETROSPOT,6,194,1,200,6,1,2
4948,HAND WARMER UNION JACK,8,644,24,2500,1856,1,48
4949,FRENCH WC SIGN BLUE METAL,10,111,17,1800,1689,1,34
4950,PINK UNION JACK  LUGGAGE TAG,5,772,8,900,128,1,16
4951,"TRAY, BREAKFAST IN BED",4,216,17,1800,1584,1,34
4952,PIZZA PLATE IN BOX,7,1395,22,2300,905,1,44
4953,HEART OF WICKER LARGE,7,197,10,1100,903,1,20
4954,PINK HEART DOTS HOT WATER BOTTLE,2,870,25,2600,1730,1,50
4955,PLACE SETTING WHITE HEART,2,328,18,1900,1572,1,36
4956,SET OF 4 NAPKIN CHARMS LEAVES   ,5,100,0,100,0,1,0
4957,SET OF 4 NAPKIN CHARMS STARS   ,8,272,12,1300,1028,1,24
4958,SET OF 4 NAPKIN CHARMS CUTLERY,5,539,7,800,261,1,14
4959,CARAVAN SQUARE TISSUE BOX,9,283,24,2500,2217,1,48
4960,PLASTERS IN TIN SKULLS,8,411,8,900,489,1,16
4961,PLASTERS IN TIN SPACEBOY,7,691,8,900,209,1,16
4962,BUTTON BOX ,9,1316,15,1600,284,1,30
4963,PLASTERS IN TIN VINTAGE PAISLEY ,7,143,5,600,457,1,10
4964,15 MESSAGE CARDS WITH ENVELOPES,2,2186,24,2500,314,1,48
4965,SMALL RED BABUSHKA NOTEBOOK ,4,192,2,300,108,1,4
4966,CUPCAKE LACE PAPER SET 9,1,1270,14,1500,230,1,28
4967,PACK 3 BOXES CHRISTMAS PANNETONE,5,309,3,400,91,1,6
4968,HERB MARKER MINT,10,1422,22,2300,878,1,44
4969,HERB MARKER ROSEMARY,5,330,24,2500,2170,1,48
4970,HERB MARKER BASIL,4,830,19,2000,1170,1,38
4971,HERB MARKER CHIVES ,8,400,7,800,400,1,14
4972,HERB MARKER PARSLEY,6,1877,18,1900,23,1,36
4973,HERB MARKER THYME,8,279,11,1200,921,1,22
4974,WHITE HANGING HEART T-LIGHT HOLDER,7,566,6,700,134,1,12
4975,METAL MERRY CHRISTMAS WREATH,4,490,11,1200,710,1,22
4976,WHITE CHRISTMAS GARLAND STARS TREES,9,407,22,2300,1893,1,44
4977,RETROSPOT SMALL TUBE MATCHES,9,100,0,100,0,1,0
4978,RETROSPOT GIANT TUBE MATCHES,3,1288,17,1800,512,1,34
4979,PLACE SETTING WHITE STAR,4,746,10,1100,354,1,20
4980,GROW YOUR OWN BASIL IN ENAMEL MUG,2,567,10,1100,533,1,20
4981,39 FOIL STAR CAKE CASES ,1,345,17,1800,1455,1,34
4982,39 FOIL HEART CAKE CASES,4,1890,18,1900,10,1,36
4983,PACK OF 6 SWEETIE GIFT BOXES,8,334,23,2400,2066,1,46
4984,PACK OF 6 HANDBAG GIFT BOXES,4,808,10,1100,292,1,20
4985,GARLAND WOODEN HAPPY EASTER,7,215,3,400,185,1,6
4986,CALENDAR PAPER CUT DESIGN,6,237,10,1100,863,1,20
4987,CALENDAR IN SEASON DESIGN,1,1080,10,1100,20,1,20
4988,SMALL POPCORN HOLDER,5,302,5,600,298,1,10
4989,BLUE PAISLEY TISSUE BOX,5,277,25,2600,2323,1,50
4990,HEART OF WICKER SMALL,7,114,8,900,786,1,16
4991,SKULLS SQUARE TISSUE BOX,3,1573,20,2100,527,1,40
4992,SKULLS SQUARE TISSUE BOX,4,242,2,300,58,1,4
4993,WHITE HANGING HEART T-LIGHT HOLDER,6,551,5,600,49,1,10
4994,WHITE METAL LANTERN,9,192,5,600,408,1,10
4995,CREAM CUPID HEARTS COAT HANGER,1,154,13,1400,1246,1,26
4996,KNITTED UNION FLAG HOT WATER BOTTLE,1,338,22,2300,1962,1,44
4997,RED WOOLLY HOTTIE WHITE HEART.,1,145,19,2000,1855,1,38
4998,SET 7 BABUSHKA NESTING BOXES,5,763,7,800,37,1,14
4999,GLASS STAR FROSTED T-LIGHT HOLDER,7,1666,25,2600,934,1,50
5000,HAND WARMER UNION JACK,4,120,21,2200,2080,1,42
5001,HAND WARMER RED POLKA DOT,9,706,10,1100,394,1,20
5002,ASSORTED COLOUR BIRD ORNAMENT,5,1043,24,2500,1457,1,48
5003,POPPY'S PLAYHOUSE BEDROOM ,6,448,8,900,452,1,16
5004,POPPY'S PLAYHOUSE KITCHEN,8,434,13,1400,966,1,26
5005,FELTCRAFT PRINCESS CHARLOTTE DOLL,10,737,14,1500,763,1,28
5006,IVORY KNITTED MUG COSY ,6,504,7,800,296,1,14
5007,BOX OF 6 ASSORTED COLOUR TEASPOONS,7,1063,14,1500,437,1,28
5008,BOX OF VINTAGE JIGSAW BLOCKS ,2,1064,12,1300,236,1,24
5009,BOX OF VINTAGE ALPHABET BLOCKS,7,195,14,1500,1305,1,28
5010,HOME BUILDING BLOCK WORD,6,467,8,900,433,1,16
5011,LOVE BUILDING BLOCK WORD,7,796,17,1800,1004,1,34
5012,RECIPE BOX WITH METAL HEART,10,612,24,2500,1888,1,48
5013,DOORMAT NEW ENGLAND,2,1458,18,1900,442,1,36
5014,JAM MAKING SET WITH JARS,9,155,2,300,145,1,4
5015,RED COAT RACK PARIS FASHION,9,1184,21,2200,1016,1,42
5016,YELLOW COAT RACK PARIS FASHION,5,646,6,700,54,1,12
5017,BLUE COAT RACK PARIS FASHION,10,670,13,1400,730,1,26
5018,BATH BUILDING BLOCK WORD,6,529,18,1900,1371,1,36
5019,ALARM CLOCK BAKELIKE PINK,10,433,9,1000,567,1,18
5020,ALARM CLOCK BAKELIKE RED ,10,1054,11,1200,146,1,22
5021,ALARM CLOCK BAKELIKE GREEN,1,1619,24,2500,881,1,48
5022,PANDA AND BUNNIES STICKER SHEET,2,466,14,1500,1034,1,28
5023,STARS GIFT TAPE ,9,347,16,1700,1353,1,32
5024,INFLATABLE POLITICAL GLOBE ,3,1716,22,2300,584,1,44
5025,VINTAGE HEADS AND TAILS CARD GAME ,10,721,8,900,179,1,16
5026,SET/2 RED RETROSPOT TEA TOWELS ,1,399,8,900,501,1,16
5027,ROUND SNACK BOXES SET OF4 WOODLAND ,5,456,22,2300,1844,1,44
5028,SPACEBOY LUNCH BOX ,1,194,7,800,606,1,14
5029,LUNCH BOX I LOVE LONDON,1,572,14,1500,928,1,28
5030,CIRCUS PARADE LUNCH BOX ,5,297,10,1100,803,1,20
5031,CHARLOTTE BAG DOLLY GIRL DESIGN,10,100,0,100,0,1,0
5032,RED TOADSTOOL LED NIGHT LIGHT,4,384,5,600,216,1,10
5033, SET 2 TEA TOWELS I LOVE LONDON ,10,100,0,100,0,1,0
5034,VINTAGE SEASIDE JIGSAW PUZZLES,2,138,2,300,162,1,4
5035,MINI JIGSAW CIRCUS PARADE ,5,1441,20,2100,659,1,40
5036,MINI JIGSAW SPACEBOY,6,149,1,200,51,1,2
5037,MINI PAINT SET VINTAGE ,10,296,2,300,4,1,4
5038,POSTAGE,6,215,12,1300,1085,1,24
5039,PAPER CHAIN KIT 50'S CHRISTMAS ,4,815,8,900,85,1,16
5040,HAND WARMER RED POLKA DOT,5,667,12,1300,633,1,24
5041,HAND WARMER UNION JACK,4,100,0,100,0,1,0
5042,WHITE HANGING HEART T-LIGHT HOLDER,10,1527,16,1700,173,1,32
5043,WHITE METAL LANTERN,5,436,21,2200,1764,1,42
5044,CREAM CUPID HEARTS COAT HANGER,7,2113,24,2500,387,1,48
5045,EDWARDIAN PARASOL RED,2,1214,22,2300,1086,1,44
5046,RETRO COFFEE MUGS ASSORTED,8,227,19,2000,1773,1,38
5047,SAVE THE PLANET MUG,1,337,5,600,263,1,10
5048,VINTAGE BILLBOARD DRINK ME MUG,6,1498,24,2500,1002,1,48
5049,VINTAGE BILLBOARD LOVE/HATE MUG,2,615,6,700,85,1,12
5050,WOOD 2 DRAWER CABINET WHITE FINISH,6,1273,19,2000,727,1,38
5051,WOOD S/3 CABINET ANT WHITE FINISH,6,1172,24,2500,1328,1,48
5052,WOODEN PICTURE FRAME WHITE FINISH,6,545,14,1500,955,1,28
5053,WOODEN FRAME ANTIQUE WHITE ,5,296,15,1600,1304,1,30
5054,KNITTED UNION FLAG HOT WATER BOTTLE,1,1136,16,1700,564,1,32
5055,RED WOOLLY HOTTIE WHITE HEART.,7,1144,20,2100,956,1,40
5056,SET 7 BABUSHKA NESTING BOXES,1,113,5,600,487,1,10
5057,GLASS STAR FROSTED T-LIGHT HOLDER,6,901,9,1000,99,1,18
5058,VICTORIAN SEWING BOX LARGE,2,129,3,400,271,1,6
5059,WHITE HANGING HEART T-LIGHT HOLDER,8,1087,23,2400,1313,1,46
5060,WHITE METAL LANTERN,10,184,5,600,416,1,10
5061,CREAM CUPID HEARTS COAT HANGER,3,991,17,1800,809,1,34
5062,EDWARDIAN PARASOL RED,10,730,7,800,70,1,14
5063,RETRO COFFEE MUGS ASSORTED,7,130,10,1100,970,1,20
5064,SAVE THE PLANET MUG,6,946,9,1000,54,1,18
5065,VINTAGE BILLBOARD DRINK ME MUG,2,466,12,1300,834,1,24
5066,VINTAGE BILLBOARD LOVE/HATE MUG,4,865,23,2400,1535,1,46
5067,WOOD 2 DRAWER CABINET WHITE FINISH,7,1241,21,2200,959,1,42
5068,WOOD S/3 CABINET ANT WHITE FINISH,1,480,15,1600,1120,1,30
5069,WOODEN PICTURE FRAME WHITE FINISH,6,290,8,900,610,1,16
5070,WOODEN FRAME ANTIQUE WHITE ,6,359,4,500,141,1,8
5071,KNITTED UNION FLAG HOT WATER BOTTLE,4,910,16,1700,790,1,32
5072,RED WOOLLY HOTTIE WHITE HEART.,2,131,16,1700,1569,1,32
5073,SET 7 BABUSHKA NESTING BOXES,7,951,11,1200,249,1,22
5074,GLASS STAR FROSTED T-LIGHT HOLDER,2,248,4,500,252,1,8
5075,HOT WATER BOTTLE TEA AND SYMPATHY,6,1186,11,1200,14,1,22
5076,RED HANGING HEART T-LIGHT HOLDER,5,1552,21,2200,648,1,42
5077,HAND WARMER RED POLKA DOT,5,703,21,2200,1497,1,42
5078,HAND WARMER UNION JACK,9,207,13,1400,1193,1,26
5079,JUMBO BAG PINK POLKADOT,3,283,15,1600,1317,1,30
5080,JUMBO  BAG BAROQUE BLACK WHITE,1,238,2,300,62,1,4
5081,JUMBO BAG CHARLIE AND LOLA TOYS,10,844,21,2200,1356,1,42
5082,STRAWBERRY CHARLOTTE BAG,1,1675,25,2600,925,1,50
5083,RED 3 PIECE RETROSPOT CUTLERY SET,5,198,8,900,702,1,16
5084,BLUE 3 PIECE POLKADOT CUTLERY SET,1,360,19,2000,1640,1,38
5085,SET/6 RED SPOTTY PAPER PLATES,6,337,10,1100,763,1,20
5086,LUNCH BAG RED RETROSPOT,5,500,20,2100,1600,1,40
5087,STRAWBERRY LUNCH BOX WITH CUTLERY,2,934,22,2300,1366,1,44
5088,LUNCH BOX WITH CUTLERY RETROSPOT ,1,103,1,200,97,1,2
5089,PACK OF 72 RETROSPOT CAKE CASES,4,1636,23,2400,764,1,46
5090,PACK OF 60 DINOSAUR CAKE CASES,6,199,9,1000,801,1,18
5091,PACK OF 60 PINK PAISLEY CAKE CASES,10,586,6,700,114,1,12
5092,64 TEATIME FAIRY CAKE CASES,1,100,0,100,0,1,0
5093,TOMATO CHARLIE+LOLA COASTER SET,9,1649,21,2200,551,1,42
5094,CHARLIE & LOLA WASTEPAPER BIN FLORA,6,145,1,200,55,1,2
5095,RED CHARLIE+LOLA PERSONAL DOORSIGN,2,167,2,300,133,1,4
5096,JUMBO STORAGE BAG SUKI,9,870,9,1000,130,1,18
5097,JUMBO BAG PINK VINTAGE PAISLEY,8,156,1,200,44,1,2
5098,JAM MAKING SET PRINTED,6,619,6,700,81,1,12
5099,RETROSPOT TEA SET CERAMIC 11 PC ,8,243,2,300,57,1,4
5100,GIRLY PINK TOOL SET,6,764,8,900,136,1,16
5101,JUMBO SHOPPER VINTAGE RED PAISLEY,9,629,22,2300,1671,1,44
5102,"AIRLINE LOUNGE,METAL SIGN",3,309,8,900,591,1,16
5103,WHITE SPOT RED CERAMIC DRAWER KNOB,1,1474,23,2400,926,1,46
5104,RED DRAWER KNOB ACRYLIC EDWARDIAN,10,505,5,600,95,1,10
5105,CLEAR DRAWER KNOB ACRYLIC EDWARDIAN,1,169,1,200,31,1,2
5106,PHOTO CLIP LINE,8,1033,16,1700,667,1,32
5107,FELT EGG COSY CHICKEN,2,387,18,1900,1513,1,36
5108,PIGGY BANK RETROSPOT ,4,272,2,300,28,1,4
5109,SKULL SHOULDER BAG,5,503,7,800,297,1,14
5110,YOU'RE CONFUSING ME METAL SIGN ,3,499,10,1100,601,1,20
5111,COOK WITH WINE METAL SIGN ,2,199,6,700,501,1,12
5112,GIN + TONIC DIET METAL SIGN,9,918,16,1700,782,1,32
5113,YELLOW BREAKFAST CUP AND SAUCER,2,761,13,1400,639,1,26
5114,PINK BREAKFAST CUP AND SAUCER ,5,1355,16,1700,345,1,32
5115,PAPER CHAIN KIT 50'S CHRISTMAS ,7,883,25,2600,1717,1,50
5116,PAPER CHAIN KIT RETROSPOT,4,555,10,1100,545,1,20
5117,SMALL HEART FLOWERS HOOK ,2,722,12,1300,578,1,24
5118,PHOTO CLIP LINE,6,318,4,500,182,1,8
5119,TEA TIME DES TEA COSY,4,100,0,100,0,1,0
5120,FELT EGG COSY WHITE RABBIT ,9,1033,19,2000,967,1,38
5121,ZINC WILLIE WINKIE  CANDLE STICK,8,767,18,1900,1133,1,36
5122,CERAMIC CHERRY CAKE MONEY BANK,10,1308,23,2400,1092,1,46
5123,RETROSPOT LARGE MILK JUG,2,275,2,300,25,1,4
5124,SET OF 6 FUNKY BEAKERS,8,802,16,1700,898,1,32
5125,EDWARDIAN PARASOL BLACK,3,342,25,2600,2258,1,50
5126,EDWARDIAN PARASOL NATURAL,5,483,10,1100,617,1,20
5127,CERAMIC STRAWBERRY CAKE MONEY BANK,3,1991,19,2000,9,1,38
5128,BLUE OWL SOFT TOY,8,545,6,700,155,1,12
5129,BALLOON ART MAKE YOUR OWN FLOWERS,8,103,1,200,97,1,2
5130,RED TOADSTOOL LED NIGHT LIGHT,9,414,17,1800,1386,1,34
5131,GLASS CLOCHE SMALL,10,225,4,500,275,1,8
5132,GUMBALL MONOCHROME COAT RACK,7,1129,16,1700,571,1,32
5133,DOORMAT FANCY FONT HOME SWEET HOME,6,464,14,1500,1036,1,28
5134,Discount,9,1083,14,1500,417,1,28
5135,INFLATABLE POLITICAL GLOBE ,8,1522,20,2100,578,1,40
5136,VINTAGE SNAKES & LADDERS,8,632,7,800,168,1,14
5137,CHOCOLATE CALCULATOR,10,1209,12,1300,91,1,24
5138,JUMBO SHOPPER VINTAGE RED PAISLEY,2,1629,23,2400,771,1,46
5139,RECYCLING BAG RETROSPOT ,4,648,21,2200,1552,1,42
5140,TOY TIDY PINK POLKADOT,10,317,17,1800,1483,1,34
5141,ANTIQUE GLASS DRESSING TABLE POT,7,491,6,700,209,1,12
5142,ALARM CLOCK BAKELIKE GREEN,3,109,8,900,791,1,16
5143,IVORY GIANT GARDEN THERMOMETER,6,739,7,800,61,1,14
5144,7 TIER CAKE TIN GREEN AND CREAM,7,100,0,100,0,1,0
5145,7 TIER CAKE TIN RED AND CREAM,5,329,5,600,271,1,10
5146,SET 3 WICKER OVAL BASKETS W LIDS,1,1291,14,1500,209,1,28
5147,SET OF 3 COLOURED  FLYING DUCKS,9,671,21,2200,1529,1,42
5148,WOOD BLACK BOARD ANT WHITE FINISH,3,456,12,1300,844,1,24
5149,COLOUR GLASS T-LIGHT HOLDER HANGING,2,784,9,1000,216,1,18
5150,HANGING METAL HEART LANTERN,6,1648,25,2600,952,1,50
5151,HANGING MEDINA LANTERN SMALL,2,239,2,300,61,1,4
5152,NATURAL SLATE HEART CHALKBOARD ,6,193,6,700,507,1,12
5153,HEART OF WICKER SMALL,5,135,2,300,165,1,4
5154,HEART OF WICKER LARGE,2,608,20,2100,1492,1,40
5155,WHITE LOVEBIRD LANTERN,10,1054,19,2000,946,1,38
5156,CLASSIC METAL BIRDCAGE PLANT HOLDER,3,100,0,100,0,1,0
5157,CREAM HEART CARD HOLDER,10,1261,25,2600,1339,1,50
5158,ENAMEL FLOWER JUG CREAM,6,113,1,200,87,1,2
5159,ENAMEL FIRE BUCKET CREAM,6,301,5,600,299,1,10
5160,ENAMEL BREAD BIN CREAM,3,1172,12,1300,128,1,24
5161,SET 3 WICKER OVAL BASKETS W LIDS,2,596,21,2200,1604,1,42
5162,JAM MAKING SET PRINTED,3,194,15,1600,1406,1,30
5163,JAM MAKING SET WITH JARS,2,748,19,2000,1252,1,38
5164,JUMBO BAG DOLLY GIRL DESIGN,9,512,24,2500,1988,1,48
5165,TRADITIONAL CHRISTMAS RIBBONS,5,205,23,2400,2195,1,46
5166,ORGANISER WOOD ANTIQUE WHITE ,10,623,11,1200,577,1,22
5167,LUNCH BAG DOLLY GIRL DESIGN,4,580,21,2200,1620,1,42
5168,WHITE WIRE EGG HOLDER,6,440,7,800,360,1,14
5169,JUMBO  BAG BAROQUE BLACK WHITE,4,1574,20,2100,526,1,40
5170,JUMBO BAG RED RETROSPOT,4,681,15,1600,919,1,30
5171,CHILLI LIGHTS,10,675,14,1500,825,1,28
5172,LIGHT GARLAND BUTTERFILES PINK,4,803,21,2200,1397,1,42
5173,WOODEN OWLS LIGHT GARLAND ,1,758,16,1700,942,1,32
5174,FAIRY TALE COTTAGE NIGHTLIGHT,1,369,9,1000,631,1,18
5175,RED TOADSTOOL LED NIGHT LIGHT,2,2277,25,2600,323,1,50
5176,HOME BUILDING BLOCK WORD,10,164,19,2000,1836,1,38
5177,LOVE BUILDING BLOCK WORD,10,194,6,700,506,1,12
5178,DOORMAT FANCY FONT HOME SWEET HOME,6,1283,14,1500,217,1,28
5179,HOME SMALL WOOD LETTERS,2,741,19,2000,1259,1,38
5180,GINGHAM HEART  DOORSTOP RED,6,299,14,1500,1201,1,28
5181,FIVE HEART HANGING DECORATION,1,229,5,600,371,1,10
5182,HANGING METAL HEART LANTERN,7,1562,21,2200,638,1,42
5183,ASSORTED BOTTLE TOP  MAGNETS ,1,1185,17,1800,615,1,34
5184,FRIDGE MAGNETS US DINER ASSORTED,4,918,9,1000,82,1,18
5185,HOMEMADE JAM SCENTED CANDLES,2,439,6,700,261,1,12
5186,FRIDGE MAGNETS LES ENFANTS ASSORTED,2,975,12,1300,325,1,24
5187,ROSE CARAVAN DOORSTOP,2,1455,23,2400,945,1,46
5188,HEART OF WICKER SMALL,7,779,13,1400,621,1,26
5189,9 HOOK HANGER MAGIC TOADSTOOL,4,127,17,1800,1673,1,34
5190,CHRISTMAS LIGHTS 10 REINDEER,4,732,8,900,168,1,16
5191,VINTAGE UNION JACK CUSHION COVER,10,750,12,1300,550,1,24
5192,VINTAGE HEADS AND TAILS CARD GAME ,7,720,18,1900,1180,1,36
5193,SET OF 3 COLOURED  FLYING DUCKS,8,797,14,1500,703,1,28
5194,SET OF 3 GOLD FLYING DUCKS,6,504,5,600,96,1,10
5195,RED RETROSPOT UMBRELLA,4,134,2,300,166,1,4
5196,BLACK/BLUE POLKADOT UMBRELLA,9,196,5,600,404,1,10
5197,RED DINER WALL CLOCK,4,802,20,2100,1298,1,40
5198,ALARM CLOCK BAKELIKE GREEN,9,224,2,300,76,1,4
5199,ALARM CLOCK BAKELIKE RED ,10,426,10,1100,674,1,20
5200,BLUE DINER WALL CLOCK,3,314,13,1400,1086,1,26
5201,IVORY DINER WALL CLOCK,9,363,5,600,237,1,10
5202,LARGE HEART MEASURING SPOONS,7,187,1,200,13,1,2
5203,SMALL HEART MEASURING SPOONS,3,328,5,600,272,1,10
5204,CHRISTMAS LIGHTS 10 REINDEER,7,1457,20,2100,643,1,40
5205,JAM MAKING SET WITH JARS,1,100,0,100,0,1,0
5206,JAM MAKING SET PRINTED,10,156,16,1700,1544,1,32
5207,JAM JAR WITH PINK LID,8,695,15,1600,905,1,30
5208,JAM JAR WITH GREEN LID,3,878,8,900,22,1,16
5209,ROSE COTTAGE KEEPSAKE BOX ,10,543,5,600,57,1,10
5210,HANGING HEART ZINC T-LIGHT HOLDER,10,1274,13,1400,126,1,26
5211,PAPER CHAIN KIT VINTAGE CHRISTMAS,4,1329,15,1600,271,1,30
5212,DISCO BALL CHRISTMAS DECORATION,5,592,8,900,308,1,16
5213,WHITE HANGING HEART T-LIGHT HOLDER,4,243,6,700,457,1,12
5214,SMALL POPCORN HOLDER,3,952,18,1900,948,1,36
5215,LARGE POPCORN HOLDER ,7,766,13,1400,634,1,26
5216,RETROSPOT LARGE MILK JUG,8,138,18,1900,1762,1,36
5217,SET/20 RED RETROSPOT PAPER NAPKINS ,8,745,22,2300,1555,1,44
5218,SET/6 RED SPOTTY PAPER PLATES,6,657,11,1200,543,1,22
5219,SET/6 RED SPOTTY PAPER CUPS,10,241,3,400,159,1,6
5220,POLKADOT RAIN HAT ,9,1551,18,1900,349,1,36
5221,DELUXE SEWING KIT ,1,2274,24,2500,226,1,48
5222,RETROSPOT HEART HOT WATER BOTTLE,2,376,14,1500,1124,1,28
5223,KNITTED UNION FLAG HOT WATER BOTTLE,3,587,22,2300,1713,1,44
5224,ENGLISH ROSE HOT WATER BOTTLE,3,367,13,1400,1033,1,26
5225,PHOTO CUBE,10,604,15,1600,996,1,30
5226,HOMEMADE JAM SCENTED CANDLES,6,100,0,100,0,1,0
5227,JUMBO BAG RED RETROSPOT,9,205,2,300,95,1,4
5228,PLASTERS IN TIN CIRCUS PARADE ,2,159,1,200,41,1,2
5229,PACK OF 12 PINK PAISLEY TISSUES ,9,1181,25,2600,1419,1,50
5230,PACK OF 12 BLUE PAISLEY TISSUES ,4,667,25,2600,1933,1,50
5231,PACK OF 12 RED RETROSPOT TISSUES ,7,880,17,1800,920,1,34
5232,CHICK GREY HOT WATER BOTTLE,5,254,2,300,46,1,4
5233,PLASTERS IN TIN VINTAGE PAISLEY ,5,620,21,2200,1580,1,42
5234,PLASTERS IN TIN SKULLS,10,280,22,2300,2020,1,44
5235,7 STRIPEY MICE FELTCRAFT,10,385,9,1000,615,1,18
5236,SET OF 6 SOLDIER SKITTLES,9,2096,24,2500,404,1,48
5237,TRADITIONAL WOODEN SKIPPING ROPE,9,350,3,400,50,1,6
5238,WOODEN BOX OF DOMINOES,6,1537,22,2300,763,1,44
5239,RUSTIC  SEVENTEEN DRAWER SIDEBOARD,10,459,4,500,41,1,8
5240,PARTY CONES CARNIVAL ASSORTED,1,110,23,2400,2290,1,46
5241,PARTY CONES CANDY ASSORTED,4,1144,18,1900,756,1,36
5242,PICNIC BASKET WICKER SMALL,6,434,13,1400,966,1,26
5243,ASSORTED COLOUR BIRD ORNAMENT,3,137,2,300,163,1,4
5244,STAR DECORATION PAINTED ZINC ,5,123,3,400,277,1,6
5245,RETROSPOT LAMP,5,1173,16,1700,527,1,32
5246,"FANCY FONT BIRTHDAY CARD, ",1,160,1,200,40,1,2
5247,HAND WARMER UNION JACK,5,1243,13,1400,157,1,26
5248,HAND WARMER SCOTTY DOG DESIGN,6,1194,18,1900,706,1,36
5249,HAND WARMER OWL DESIGN,9,102,13,1400,1298,1,26
5250,HAND WARMER RED RETROSPOT,1,344,6,700,356,1,12
5251,RETROSPOT HEART HOT WATER BOTTLE,9,1174,23,2400,1226,1,46
5252,DOG BOWL CHASING BALL DESIGN,7,197,2,300,103,1,4
5253,CLOTHES PEGS RETROSPOT PACK 28,7,588,19,2000,1412,1,38
5254,HAND OVER THE CHOCOLATE   SIGN ,6,179,2,300,121,1,4
5255,WHITE HANGING HEART T-LIGHT HOLDER,1,196,1,200,4,1,2
5256,TRAVEL SEWING KIT,1,153,1,200,47,1,2
5257,BLACK HEART CARD HOLDER,7,1019,13,1400,381,1,26
5258,ASSORTED COLOUR BIRD ORNAMENT,5,100,0,100,0,1,0
5259,PACK OF 60 PINK PAISLEY CAKE CASES,8,793,13,1400,607,1,26
5260,64 TEATIME FAIRY CAKE CASES,5,529,12,1300,771,1,24
5261,PACK OF 72 RETROSPOT CAKE CASES,10,174,1,200,26,1,2
5262,CHICK GREY HOT WATER BOTTLE,9,267,2,300,33,1,4
5263,SMALL GLASS HEART TRINKET POT,10,190,2,300,110,1,4
5264,ALARM CLOCK BAKELIKE IVORY,5,203,2,300,97,1,4
5265,ALARM CLOCK BAKELIKE RED ,3,124,1,200,76,1,2
5266,ALARM CLOCK BAKELIKE ORANGE,7,956,13,1400,444,1,26
5267,ALARM CLOCK BAKELIKE GREEN,1,1376,24,2500,1124,1,48
5268,HOT WATER BOTTLE TEA AND SYMPATHY,10,173,4,500,327,1,8
5269,HAND WARMER BIRD DESIGN,9,2491,25,2600,109,1,50
5270,HAND WARMER SCOTTY DOG DESIGN,1,648,15,1600,952,1,30
5271,WHITE HANGING HEART T-LIGHT HOLDER,4,1376,18,1900,524,1,36
5272,WHITE METAL LANTERN,5,1103,17,1800,697,1,34
5273,CREAM CUPID HEARTS COAT HANGER,5,300,5,600,300,1,10
5274,EDWARDIAN PARASOL BLACK,2,393,24,2500,2107,1,48
5275,EDWARDIAN PARASOL RED,9,769,21,2200,1431,1,42
5276,RETRO COFFEE MUGS ASSORTED,5,146,1,200,54,1,2
5277,SAVE THE PLANET MUG,9,1544,22,2300,756,1,44
5278,VINTAGE BILLBOARD DRINK ME MUG,3,234,16,1700,1466,1,32
5279,VINTAGE BILLBOARD LOVE/HATE MUG,8,362,13,1400,1038,1,26
5280,WOOD 2 DRAWER CABINET WHITE FINISH,6,1195,25,2600,1405,1,50
5281,WOOD S/3 CABINET ANT WHITE FINISH,3,196,2,300,104,1,4
5282,WOODEN PICTURE FRAME WHITE FINISH,9,170,6,700,530,1,12
5283,WOODEN FRAME ANTIQUE WHITE ,3,245,5,600,355,1,10
5284,KNITTED UNION FLAG HOT WATER BOTTLE,8,194,18,1900,1706,1,36
5285,RED WOOLLY HOTTIE WHITE HEART.,8,535,9,1000,465,1,18
5286,SET 7 BABUSHKA NESTING BOXES,5,127,5,600,473,1,10
5287,IVORY EMBROIDERED QUILT ,5,1649,19,2000,351,1,38
5288,GLASS STAR FROSTED T-LIGHT HOLDER,1,169,21,2200,2031,1,42
5289,SET OF 3 BLACK FLYING DUCKS,4,2012,24,2500,488,1,48
5290,SET OF 3 COLOURED  FLYING DUCKS,1,678,14,1500,822,1,28
5291,PACK OF 12 RED RETROSPOT TISSUES ,10,369,4,500,131,1,8
5292,RED RETROSPOT MUG,9,336,10,1100,764,1,20
5293,BABUSHKA LIGHTS STRING OF 14,2,568,18,1900,1332,1,36
5294,PIGGY BANK RETROSPOT ,1,2208,23,2400,192,1,46
5295,SET 7 BABUSHKA NESTING BOXES,5,182,2,300,118,1,4
5296,DOORMAT FAIRY CAKE,9,268,2,300,32,1,4
5297,HAND WARMER RED RETROSPOT,5,263,6,700,437,1,12
5298,HAND WARMER SCOTTY DOG DESIGN,9,1669,24,2500,831,1,48
5299,HAND WARMER OWL DESIGN,6,1266,12,1300,34,1,24
5300,STRAWBERRY CERAMIC TRINKET BOX,7,1195,11,1200,5,1,22
5301,PINK DOUGHNUT TRINKET POT ,10,667,6,700,33,1,12
5302,SILK PURSE BABUSHKA PINK,9,801,21,2200,1399,1,42
5303,HOT WATER BOTTLE TEA AND SYMPATHY,5,844,17,1800,956,1,34
5304,HOT WATER BOTTLE I AM SO POORLY,2,1402,17,1800,398,1,34
5305,CHOCOLATE HOT WATER BOTTLE,2,786,17,1800,1014,1,34
5306,WHITE SKULL HOT WATER BOTTLE ,9,258,3,400,142,1,6
5307,SCOTTIE DOG HOT WATER BOTTLE,4,1553,24,2500,947,1,48
5308,HAND WARMER RED POLKA DOT,1,1449,18,1900,451,1,36
5309,HAND WARMER UNION JACK,2,181,10,1100,919,1,20
5310,HOMEMADE JAM SCENTED CANDLES,5,1102,15,1600,498,1,30
5311,BIRD HOUSE HOT WATER BOTTLE,3,265,3,400,135,1,6
5312,BOUDOIR SQUARE TISSUE BOX,9,464,7,800,336,1,14
5313,SKULLS SQUARE TISSUE BOX,7,2092,21,2200,108,1,42
5314,PHOTO FRAME CORNICE,5,184,2,300,116,1,4
5315,SILK PURSE BABUSHKA RED,8,597,7,800,203,1,14
5316,PICTURE DOMINOES,6,1000,13,1400,400,1,26
5317,S/6 SEW ON CROCHET FLOWERS,4,476,8,900,424,1,16
5318,SCANDINAVIAN REDS RIBBONS,9,152,1,200,48,1,2
5319,BALLOONS  WRITING SET ,6,236,8,900,664,1,16
5320,JAM MAKING SET PRINTED,9,1897,18,1900,3,1,36
5321,LAVENDER INCENSE IN TIN,9,156,5,600,444,1,10
5322,TV DINNER TRAY VINTAGE PAISLEY,1,551,22,2300,1749,1,44
5323,SET OF 4 ENGLISH ROSE PLACEMATS,4,1161,15,1600,439,1,30
5324,SET OF 4 ENGLISH ROSE COASTERS,4,1038,20,2100,1062,1,40
5325,TRIPLE PHOTO FRAME CORNICE ,1,1083,11,1200,117,1,22
5326,FAMILY PHOTO FRAME CORNICE,2,940,9,1000,60,1,18
5327,MIRRORED DISCO BALL ,1,512,14,1500,988,1,28
5328,DISCO BALL ROTATOR BATTERY OPERATED,1,1274,13,1400,126,1,26
5329,SILVER LOOKING MIRROR,10,230,13,1400,1170,1,26
5330,LADIES & GENTLEMEN METAL SIGN,2,438,24,2500,2062,1,48
5331,METAL SIGN HER DINNER IS SERVED ,2,111,1,200,89,1,2
5332,YOU'RE CONFUSING ME METAL SIGN ,10,300,7,800,500,1,14
5333,DOORMAT TOPIARY,6,365,11,1200,835,1,22
5334,BATHROOM METAL SIGN,1,207,2,300,93,1,4
5335,KITCHEN METAL SIGN,9,403,12,1300,897,1,24
5336,TOILET METAL SIGN,3,493,20,2100,1607,1,40
5337,METAL SIGN TAKE IT OR LEAVE IT ,4,175,12,1300,1125,1,24
5338,I'M ON HOLIDAY METAL SIGN,2,360,5,600,240,1,10
5339,GROW YOUR OWN BASIL IN ENAMEL MUG,1,1376,16,1700,324,1,32
5340,SET/10 PINK POLKADOT PARTY CANDLES,10,938,18,1900,962,1,36
5341,SET 20 NAPKINS FAIRY CAKES DESIGN ,1,116,12,1300,1184,1,24
5342,64 TEATIME FAIRY CAKE CASES,7,1314,15,1600,286,1,30
5343,SET OF 6 T-LIGHTS SNOWMEN,5,475,18,1900,1425,1,36
5344,SET OF 6 T-LIGHTS SANTA,5,2127,22,2300,173,1,44
5345,SET OF 9 HEART SHAPED BALLOONS,9,1669,21,2200,531,1,42
5346,SANDWICH BATH SPONGE,6,528,17,1800,1272,1,34
5347,APPLE BATH SPONGE,9,363,15,1600,1237,1,30
5348,STRAWBERRY BATH SPONGE ,9,304,8,900,596,1,16
5349,BLACK PIRATE TREASURE CHEST,1,1069,15,1600,531,1,30
5350,STAR PORTABLE TABLE LIGHT ,3,1232,12,1300,68,1,24
5351,SNOWFLAKE PORTABLE TABLE LIGHT ,4,1280,25,2600,1320,1,50
5352,PINK OVAL JEWELLED MIRROR,5,871,9,1000,129,1,18
5353,RETROSPOT CIGAR BOX MATCHES ,6,308,3,400,92,1,6
5354,COSY HOUR GIANT TUBE MATCHES,3,506,7,800,294,1,14
5355,JAZZ HEARTS PURSE NOTEBOOK,7,100,0,100,0,1,0
5356,LUNCH BAG DOLLY GIRL DESIGN,2,852,13,1400,548,1,26
5357,WHITE HANGING HEART T-LIGHT HOLDER,8,2004,20,2100,96,1,40
5358,CANDLEHOLDER PINK HANGING HEART,8,100,0,100,0,1,0
5359,WOOD 2 DRAWER CABINET WHITE FINISH,8,612,25,2600,1988,1,50
5360,ASSORTED COLOUR MINI CASES,5,1288,12,1300,12,1,24
5361,LUNCH BAG RED RETROSPOT,10,672,8,900,228,1,16
5362,LUNCH BAG SPACEBOY DESIGN ,9,637,23,2400,1763,1,46
5363,LUNCH BAG WOODLAND,9,192,23,2400,2208,1,46
5364,LUNCH BAG PINK POLKADOT,1,575,11,1200,625,1,22
5365,GUMBALL COAT RACK,3,1836,24,2500,664,1,48
5366,BLUE NEW BAROQUE CANDLESTICK CANDLE,7,1477,14,1500,23,1,28
5367,PINK NEW BAROQUECANDLESTICK CANDLE,7,100,0,100,0,1,0
5368,FAIRY CAKE FLANNEL ASSORTED COLOUR,7,1302,17,1800,498,1,34
5369,BREAD BIN DINER STYLE PINK,2,1342,15,1600,258,1,30
5370,JUMBO BAG CHARLIE AND LOLA TOYS,9,288,16,1700,1412,1,32
5371,TEA TIME TABLE CLOTH,5,255,10,1100,845,1,20
5372,ENGLISH ROSE HOT WATER BOTTLE,4,1342,17,1800,458,1,34
5373,ENAMEL FIRE BUCKET CREAM,4,1367,24,2500,1133,1,48
5374,PICNIC BASKET WICKER SMALL,5,1199,11,1200,1,1,22
5375,PAPER CHAIN KIT 50'S CHRISTMAS ,10,100,6,700,600,1,12
5376,PAPER CHAIN KIT VINTAGE CHRISTMAS,9,179,5,600,421,1,10
5377,HOT WATER BOTTLE BABUSHKA ,7,185,1,200,15,1,2
5378,HAND WARMER BIRD DESIGN,1,566,10,1100,534,1,20
5379,POSTAGE,7,1626,22,2300,674,1,44
5380,HEART IVORY TRELLIS SMALL,4,559,18,1900,1341,1,36
5381,CLEAR DRAWER KNOB ACRYLIC EDWARDIAN,1,556,5,600,44,1,10
5382,PINK DRAWER KNOB ACRYLIC EDWARDIAN,5,588,12,1300,712,1,24
5383,GREEN DRAWER KNOB ACRYLIC EDWARDIAN,9,1424,20,2100,676,1,40
5384,BLUE DRAWER KNOB ACRYLIC EDWARDIAN,4,539,11,1200,661,1,22
5385,HEART OF WICKER SMALL,2,1039,14,1500,461,1,28
5386,SMALL POPCORN HOLDER,7,320,3,400,80,1,6
5387,SET 6 FOOTBALL CELEBRATION CANDLES,9,890,10,1100,210,1,20
5388,SET OF 6 GIRLS CELEBRATION CANDLES,1,2025,24,2500,475,1,48
5389,ROMANTIC PINKS RIBBONS ,7,1925,22,2300,375,1,44
5390,BRIGHT BLUES RIBBONS ,2,237,3,400,163,1,6
5391,SCANDINAVIAN REDS RIBBONS,10,369,25,2600,2231,1,50
5392,CHOCOLATE BOX RIBBONS ,7,182,16,1700,1518,1,32
5393,PARTY INVITES FOOTBALL,8,201,13,1400,1199,1,26
5394,PARTY INVITES JAZZ HEARTS,7,253,11,1200,947,1,22
5395,PARTY INVITES SPACEMAN,4,278,4,500,222,1,8
5396,SET OF 3 BUTTERFLY COOKIE CUTTERS,4,125,5,600,475,1,10
5397,SET OF 3 HEART COOKIE CUTTERS,10,1171,23,2400,1229,1,46
5398,7 PIECE SPACEBOY COOKIE CUTTER SET,10,897,25,2600,1703,1,50
5399,PACK OF 72 SKULL CAKE CASES,8,669,25,2600,1931,1,50
5400,PACK OF 60 SPACEBOY CAKE CASES,5,479,15,1600,1121,1,30
5401,PACK OF 72 RETROSPOT CAKE CASES,8,1616,22,2300,684,1,44
5402,76 SWEETHEART FAIRY CAKE CASES,9,1978,21,2200,222,1,42
5403,PACK OF 60 DINOSAUR CAKE CASES,6,171,3,400,229,1,6
5404,LUNCH BAG SUKI  DESIGN ,3,1112,17,1800,688,1,34
5405,LUNCH BAG CARS BLUE,5,213,6,700,487,1,12
5406,LUNCH BAG  BLACK SKULL.,10,621,8,900,279,1,16
5407,HEART IVORY TRELLIS LARGE,6,252,3,400,148,1,6
5408,SET/5 RED RETROSPOT LID GLASS BOWLS,8,791,23,2400,1609,1,46
5409,WHITE HANGING HEART T-LIGHT HOLDER,10,2128,22,2300,172,1,44
5410,WHITE METAL LANTERN,5,590,21,2200,1610,1,42
5411,CREAM CUPID HEARTS COAT HANGER,9,917,13,1400,483,1,26
5412,EDWARDIAN PARASOL RED,9,395,16,1700,1305,1,32
5413,RETRO COFFEE MUGS ASSORTED,6,904,12,1300,396,1,24
5414,SAVE THE PLANET MUG,9,209,4,500,291,1,8
5415,VINTAGE BILLBOARD DRINK ME MUG,10,872,22,2300,1428,1,44
5416,VINTAGE BILLBOARD LOVE/HATE MUG,5,1628,19,2000,372,1,38
5417,WOOD 2 DRAWER CABINET WHITE FINISH,10,615,11,1200,585,1,22
5418,WOOD S/3 CABINET ANT WHITE FINISH,10,1330,22,2300,970,1,44
5419,WOODEN PICTURE FRAME WHITE FINISH,3,1191,14,1500,309,1,28
5420,WOODEN FRAME ANTIQUE WHITE ,2,369,3,400,31,1,6
5421,KNITTED UNION FLAG HOT WATER BOTTLE,7,293,13,1400,1107,1,26
5422,RED WOOLLY HOTTIE WHITE HEART.,6,1691,21,2200,509,1,42
5423,SET 7 BABUSHKA NESTING BOXES,7,2080,21,2200,120,1,42
5424,IVORY EMBROIDERED QUILT ,6,158,7,800,642,1,14
5425,GLASS STAR FROSTED T-LIGHT HOLDER,7,377,9,1000,623,1,18
5426,HAND WARMER RED POLKA DOT,5,1925,21,2200,275,1,42
5427,HAND WARMER UNION JACK,4,701,12,1300,599,1,24
5428,MAGIC DRAWING SLATE DINOSAUR,3,510,10,1100,590,1,20
5429,MAGIC DRAWING SLATE BAKE A CAKE ,6,100,0,100,0,1,0
5430,16 PENCILS TALL TUBE SKULLS,8,100,0,100,0,1,0
5431,CHOCOLATE CALCULATOR,7,1618,24,2500,882,1,48
5432,RED  HARMONICA IN BOX ,9,246,8,900,654,1,16
5433,BLUE HARMONICA IN BOX ,10,100,0,100,0,1,0
5434,SKULLS  WATER TRANSFER TATTOOS ,3,1559,20,2100,541,1,40
5435,PACK 3 BOXES BIRD PANNETONE ,7,1359,17,1800,441,1,34
5436,HOT WATER BOTTLE TEA AND SYMPATHY,1,303,3,400,97,1,6
5437,RED WOOLLY HOTTIE WHITE HEART.,8,437,12,1300,863,1,24
5438,WHITE SKULL HOT WATER BOTTLE ,8,503,7,800,297,1,14
5439,7 PIECE SPACEBOY COOKIE CUTTER SET,3,608,12,1300,692,1,24
5440,SET OF 20 KIDS COOKIE CUTTERS,5,1535,18,1900,365,1,36
5441,14 COLOUR SPACEBOY PEN,7,131,4,500,369,1,8
5442,VICTORIAN GLASS HANGING T-LIGHT,2,904,23,2400,1496,1,46
5443,SINGLE HEART ZINC T-LIGHT HOLDER,7,355,11,1200,845,1,22
5444,RED HANGING HEART T-LIGHT HOLDER,2,145,6,700,555,1,12
5445,HANGING METAL STAR LANTERN,9,100,0,100,0,1,0
5446,SILVER HANGING T-LIGHT HOLDER,6,1065,21,2200,1135,1,42
5447,DOORMAT RED RETROSPOT,2,270,14,1500,1230,1,28
5448,DOORMAT HEARTS,8,1980,24,2500,520,1,48
5449,NATURAL SLATE RECTANGLE CHALKBOARD,9,1833,24,2500,667,1,48
5450,LOVEBIRD HANGING DECORATION WHITE ,10,1299,13,1400,101,1,26
5451,ASSORTED COLOUR BIRD ORNAMENT,10,127,16,1700,1573,1,32
5452,HOME BUILDING BLOCK WORD,10,252,2,300,48,1,4
5453,LOVE BUILDING BLOCK WORD,6,453,6,700,247,1,12
5454,PHOTO FRAME CORNICE,6,168,5,600,432,1,10
5455,PENS ASSORTED FUNNY FACE,8,106,3,400,294,1,6
5456,CARD CIRCUS PARADE,10,220,2,300,80,1,4
5457,WRAP COWBOYS  ,7,1323,24,2500,1177,1,48
5458,AIRLINE BAG VINTAGE TOKYO 82,5,1754,23,2400,646,1,46
5459,RED RETROSPOT UMBRELLA,10,818,8,900,82,1,16
5460,BLACK/BLUE POLKADOT UMBRELLA,7,1041,11,1200,159,1,22
5461,RED 3 PIECE RETROSPOT CUTLERY SET,8,329,18,1900,1571,1,36
5462,PACK OF 72 RETROSPOT CAKE CASES,9,1626,18,1900,274,1,36
5463,SET OF 72 RETROSPOT PAPER  DOILIES,3,431,24,2500,2069,1,48
5464,BLUE COAT RACK PARIS FASHION,4,1590,16,1700,110,1,32
5465,PLASTERS IN TIN SKULLS,10,1324,13,1400,76,1,26
5466,SLEEPING CAT ERASERS,4,100,0,100,0,1,0
5467,CARD BIRTHDAY COWBOY,4,183,12,1300,1117,1,24
5468,PACK 3 BOXES CHRISTMAS PANNETONE,2,268,2,300,32,1,4
5469,ROTATING SILVER ANGELS T-LIGHT HLDR,1,1690,19,2000,310,1,38
5470,COSY HOUR GIANT TUBE MATCHES,1,375,19,2000,1625,1,38
5471,RIBBON REEL MAKING SNOWMEN ,4,578,19,2000,1422,1,38
5472,MINI PAINT SET VINTAGE ,4,614,24,2500,1886,1,48
5473,8 TRADITIONAL SPINNING TOPS,7,110,21,2200,2090,1,42
5474,SET OF 6 SOLDIER SKITTLES,4,1106,22,2300,1194,1,44
5475,BAG 500g SWIRLY MARBLES,7,616,18,1900,1284,1,36
5476,9 STRAND GLASS NECKLACE CRYSTAL,6,1777,17,1800,23,1,34
5477,WHITE SKULL HOT WATER BOTTLE ,7,225,3,400,175,1,6
5478,SCOTTIE DOG HOT WATER BOTTLE,2,100,0,100,0,1,0
5479,SQUARECUSHION COVER PINK UNION FLAG,3,1406,14,1500,94,1,28
5480,SPACEBOY CHILDRENS EGG CUP,2,100,0,100,0,1,0
5481,CHILDREN'S SPACEBOY MUG,1,485,5,600,115,1,10
5482,HAND WARMER SCOTTY DOG DESIGN,7,557,5,600,43,1,10
5483,FELTCRAFT CUSHION OWL,4,273,7,800,527,1,14
5484,BLACK CANDELABRA T-LIGHT HOLDER,8,331,5,600,269,1,10
5485,TOY TIDY DOLLY GIRL DESIGN,9,406,5,600,194,1,10
5486,SET 12 LAVENDER  BOTANICAL T-LIGHTS,1,122,3,400,278,1,6
5487,UNION JACK FLAG LUGGAGE TAG,6,626,6,700,74,1,12
5488,RED HEART LUGGAGE TAG,1,799,9,1000,201,1,18
5489,RED GLASS TASSLE BAG CHARM,9,1078,20,2100,1022,1,40
5490,CLEAR ACRYLIC FACETED BANGLE,2,160,10,1100,940,1,20
5491,9 STRAND GLASS NECKLACE CRYSTAL,7,163,6,700,537,1,12
5492,DOORMAT UNION JACK GUNS AND ROSES,9,1972,19,2000,28,1,38
5493,VANILLA SCENT CANDLE JEWELLED BOX,3,246,18,1900,1654,1,36
5494,FULL ENGLISH BREAKFAST PLATE,7,648,6,700,52,1,12
5495,BLACK CANDELABRA T-LIGHT HOLDER,3,100,0,100,0,1,0
5496,MAGIC DRAWING SLATE CIRCUS PARADE  ,9,619,21,2200,1581,1,42
5497,CHRISTMAS HANGING HEART WITH BELL,5,357,21,2200,1843,1,42
5498,CAKE STAND VICTORIAN FILIGREE MED,9,412,8,900,488,1,16
5499,PAISLEY PATTERN  STICKERS,10,157,1,200,43,1,2
5500,FLOWERS  STICKERS,9,320,15,1600,1280,1,30
5501,PINK NEW BAROQUECANDLESTICK CANDLE,9,1212,16,1700,488,1,32
5502,BLUE NEW BAROQUE CANDLESTICK CANDLE,1,746,8,900,154,1,16
5503,JUMBO STORAGE BAG SUKI,7,2294,24,2500,206,1,48
5504,BLACK LOVE BIRD CANDLE,5,784,11,1200,416,1,22
5505,PARTY TIME PENCIL ERASERS,3,128,15,1600,1472,1,30
5506,DISCO BALL CHRISTMAS DECORATION,8,1314,20,2100,786,1,40
5507,PINK B'FLY C/COVER W BOBBLES,9,2122,24,2500,378,1,48
5508,PINK UNION JACK  LUGGAGE TAG,8,1500,18,1900,400,1,36
5509,10 RIBBONS ELEGANT CHRISTMAS ,2,1197,18,1900,703,1,36
5510,UNION JACK FLAG LUGGAGE TAG,8,1048,17,1800,752,1,34
5511,AGED GLASS SILVER T-LIGHT HOLDER,6,1144,14,1500,356,1,28
5512,BOOM BOX SPEAKER GIRLS,10,920,9,1000,80,1,18
5513,10 RIBBONS SHIMMERING PINKS ,7,135,3,400,265,1,6
5514, SET 2 TEA TOWELS I LOVE LONDON ,8,256,3,400,144,1,6
5515,JUMBO BAG OWLS,9,1159,20,2100,941,1,40
5516,SANDWICH BATH SPONGE,6,810,11,1200,390,1,22
5517,OWL DOORSTOP,5,1171,23,2400,1229,1,46
5518,9 STRAND GLASS NECKLACE CRYSTAL,6,624,11,1200,576,1,22
5519,HAND WARMER UNION JACK,7,1511,23,2400,889,1,46
5520,HAND WARMER SCOTTY DOG DESIGN,2,856,12,1300,444,1,24
5521,LARGE POPCORN HOLDER ,8,1575,21,2200,625,1,42
5522,PAINTED METAL STAR WITH HOLLY BELLS,8,2406,24,2500,94,1,48
5523,PAINTED METAL HEART WITH HOLLY BELL,10,963,14,1500,537,1,28
5524,ANGEL DECORATION STARS ON DRESS,9,111,16,1700,1589,1,32
5525,SMALL POPCORN HOLDER,6,859,19,2000,1141,1,38
5526,JUMBO BAG RED RETROSPOT,2,1351,16,1700,349,1,32
5527,JUMBO BAG STRAWBERRY,7,131,11,1200,1069,1,22
5528,STRAWBERRY SHOPPER BAG,3,549,6,700,151,1,12
5529,STRAWBERRY CHARLOTTE BAG,4,306,7,800,494,1,14
5530, SET 2 TEA TOWELS I LOVE LONDON ,3,196,2,300,104,1,4
5531,PACK OF 12 RED RETROSPOT TISSUES ,7,1064,21,2200,1136,1,42
5532,SCOTTIE DOG HOT WATER BOTTLE,3,100,0,100,0,1,0
5533,CHOCOLATE HOT WATER BOTTLE,2,247,3,400,153,1,6
5534,LUNCH BAG CARS BLUE,7,992,9,1000,8,1,18
5535,LUNCH BAG SPACEBOY DESIGN ,8,1723,21,2200,477,1,42
5536,ROUND SNACK BOXES SET OF4 WOODLAND ,1,489,11,1200,711,1,22
5537,LUNCH BAG DOLLY GIRL DESIGN,10,169,9,1000,831,1,18
5538,LUNCH BAG SUKI  DESIGN ,2,758,12,1300,542,1,24
5539,LUNCH BAG  BLACK SKULL.,10,2200,24,2500,300,1,48
5540,ROUND SNACK BOXES SET OF 4 FRUITS ,10,132,9,1000,868,1,18
5541,ROUND SNACK BOXES SET OF 4 SKULLS,4,122,2,300,178,1,4
5542,DOLLY GIRL LUNCH BOX,1,1140,20,2100,960,1,40
5543,SPACEBOY LUNCH BOX ,1,109,3,400,291,1,6
5544,GREEN POLKADOT PLATE ,6,1028,13,1400,372,1,26
5545,BLUE POLKADOT PLATE ,3,693,15,1600,907,1,30
5546,RED RETROSPOT PLATE ,8,1952,22,2300,348,1,44
5547,PINK  POLKADOT PLATE ,10,750,14,1500,750,1,28
5548,ROUND SNACK BOXES SET OF 4 SKULLS,10,901,18,1900,999,1,36
5549,FELTCRAFT DOLL MOLLY,2,555,13,1400,845,1,26
5550,FELTCRAFT CHRISTMAS FAIRY,4,955,21,2200,1245,1,42
5551,TRAVEL SEWING KIT,9,646,7,800,154,1,14
5552,SET OF 3 NOTEBOOKS IN PARCEL,9,177,1,200,23,1,2
5553,RED RETROSPOT TAPE,7,316,3,400,84,1,6
5554,COSY SLIPPER SHOES SMALL  RED ,3,1453,19,2000,547,1,38
5555,10 RIBBONS RUSTIC CHARM,3,948,10,1100,152,1,20
5556,SCANDINAVIAN REDS RIBBONS,8,397,16,1700,1303,1,32
5557,JAM MAKING SET PRINTED,3,379,13,1400,1021,1,26
5558,16 DAISY PEGS IN WOOD BOX,4,481,4,500,19,1,8
5559,HOT WATER BOTTLE BABUSHKA ,8,1491,22,2300,809,1,44
5560,FELTCRAFT PRINCESS CHARLOTTE DOLL,9,814,15,1600,786,1,30
5561,FELTCRAFT CHRISTMAS FAIRY,4,1431,16,1700,269,1,32
5562,FELTCRAFT PRINCESS CHARLOTTE DOLL,5,265,5,600,335,1,10
5563,10 RIBBONS RUSTIC CHARM,7,139,3,400,261,1,6
5564,COSY SLIPPER SHOES SMALL  RED ,10,328,5,600,272,1,10
5565,SCANDINAVIAN REDS RIBBONS,8,830,13,1400,570,1,26
5566,9 HOOK HANGER RED MAGIC TOADSTOOL,2,337,6,700,363,1,12
5567,CHRISTMAS CRAFT TREE TOP ANGEL,8,1152,20,2100,948,1,40
5568,CHRISTMAS CRAFT LITTLE FRIENDS,9,100,0,100,0,1,0
5569,9 HOOK HANGER RED MAGIC TOADSTOOL,8,394,4,500,106,1,8
5570,10 RIBBONS RUSTIC CHARM,9,1285,19,2000,715,1,38
5571,16 DAISY PEGS IN WOOD BOX,1,199,6,700,501,1,12
5572,SET OF 3 NOTEBOOKS IN PARCEL,2,226,3,400,174,1,6
5573,9 HOOK HANGER MAGIC TOADSTOOL,8,879,13,1400,521,1,26
5574,SCANDINAVIAN REDS RIBBONS,2,111,1,200,89,1,2
5575,RED TOADSTOOL LED NIGHT LIGHT,10,375,21,2200,1825,1,42
5576,9 HOOK HANGER RED MAGIC TOADSTOOL,10,534,14,1500,966,1,28
5577,COSY SLIPPER SHOES SMALL GREEN,4,1610,18,1900,290,1,36
5578,COSY SLIPPER SHOES SMALL  RED ,2,214,19,2000,1786,1,38
5579,FELTCRAFT DOLL ROSIE,9,1064,21,2200,1136,1,42
5580,FELTCRAFT DOLL MOLLY,6,1581,18,1900,319,1,36
5581,FELTCRAFT DOLL EMILY,5,589,15,1600,1011,1,30
5582,FELTCRAFT PRINCESS CHARLOTTE DOLL,7,447,20,2100,1653,1,40
5583,FELTCRAFT PRINCESS OLIVIA DOLL,4,855,9,1000,145,1,18
5584,REX CASH+CARRY JUMBO SHOPPER,7,140,9,1000,860,1,18
5585,FELTCRAFT DOLL MOLLY,9,637,6,700,63,1,12
5586,FELTCRAFT CUSHION OWL,5,252,15,1600,1348,1,30
5587,CHRISTMAS CRAFT TREE TOP ANGEL,4,1091,22,2300,1209,1,44
5588,CHRISTMAS CRAFT LITTLE FRIENDS,7,1027,18,1900,873,1,36
5589,FELTCRAFT CUSHION RABBIT,8,802,16,1700,898,1,32
5590,FELTCRAFT CUSHION BUTTERFLY,6,170,2,300,130,1,4
5591,16 DAISY PEGS IN WOOD BOX,9,1259,13,1400,141,1,26
5592,PAPER CHAIN KIT 50'S CHRISTMAS ,1,100,0,100,0,1,0
5593,FELTCRAFT CUSHION BUTTERFLY,3,661,6,700,39,1,12
5594,16 DAISY PEGS IN WOOD BOX,10,1545,15,1600,55,1,30
5595,ROSE COTTAGE KEEPSAKE BOX ,1,688,11,1200,512,1,22
5596,TOTE BAG I LOVE LONDON,7,742,11,1200,458,1,22
5597,16 DAISY PEGS IN WOOD BOX,8,1335,18,1900,565,1,36
5598,TOTE BAG I LOVE LONDON,2,2030,24,2500,470,1,48
5599,FOLDING UMBRELLA PINKWHITE POLKADOT,1,710,16,1700,990,1,32
5600,FOLDING UMBRELLA CREAM POLKADOT,3,134,6,700,566,1,12
5601,FOLDING UMBRELLA WHITE/RED POLKADOT,3,206,16,1700,1494,1,32
5602,SET 10 LIGHTS NIGHT OWL,1,1054,16,1700,646,1,32
5603,SMALL POPCORN HOLDER,1,126,2,300,174,1,4
5604, SET 2 TEA TOWELS I LOVE LONDON ,9,286,2,300,14,1,4
5605,FOLDING UMBRELLA RED/WHITE POLKADOT,7,1769,19,2000,231,1,38
5606,BABUSHKA LIGHTS STRING OF 14,4,1406,16,1700,294,1,32
5607,LUNCH BAG RED RETROSPOT,10,154,4,500,346,1,8
5608,S/4 VALENTINE DECOUPAGE HEART BOX,6,195,1,200,5,1,2
5609,FOLDING UMBRELLA CREAM POLKADOT,8,155,20,2100,1945,1,40
5610, SET 2 TEA TOWELS I LOVE LONDON ,8,545,8,900,355,1,16
5611,FOLDING UMBRELLA RED/WHITE POLKADOT,1,555,8,900,345,1,16
5612,SOLDIERS EGG CUP ,3,702,8,900,198,1,16
5613,S/4 VALENTINE DECOUPAGE HEART BOX,6,308,5,600,292,1,10
5614,RED RETROSPOT MINI CASES,3,1023,11,1200,177,1,22
5615,,5,233,4,500,267,1,8
5616,64 CAKE CASES VINTAGE CHRISTMAS,5,763,14,1500,737,1,28
5617,PAPER CHAIN KIT VINTAGE CHRISTMAS,4,149,19,2000,1851,1,38
5618,RIBBON REEL CHRISTMAS SOCK BAUBLE,9,523,14,1500,977,1,28
5619,RIBBON REEL SNOWY VILLAGE,2,653,13,1400,747,1,26
5620,RIBBON REEL MAKING SNOWMEN ,9,1618,19,2000,382,1,38
5621,SET OF 20 VINTAGE CHRISTMAS NAPKINS,1,1335,17,1800,465,1,34
5622,TURQUOISE CHRISTMAS TREE ,2,2015,22,2300,285,1,44
5623,RED STAR CARD HOLDER,9,165,18,1900,1735,1,36
5624,WICKER WREATH SMALL,6,116,1,200,84,1,2
5625,HEART OF WICKER LARGE,6,222,2,300,78,1,4
5626,ADVENT CALENDAR GINGHAM SACK,5,1102,20,2100,998,1,40
5627,HEART OF WICKER SMALL,2,1245,25,2600,1355,1,50
5628,FELTCRAFT BUTTERFLY HEARTS,8,360,17,1800,1440,1,34
5629,PARTY CONE CHRISTMAS DECORATION ,5,1751,22,2300,549,1,44
5630,VINTAGE HEADS AND TAILS CARD GAME ,6,376,3,400,24,1,6
5631,WICKER STAR ,8,1962,20,2100,138,1,40
5632,VINTAGE SNAP CARDS,10,264,21,2200,1936,1,42
5633,FELTCRAFT 6 FLOWER FRIENDS,3,1532,22,2300,768,1,44
5634, SET 2 TEA TOWELS I LOVE LONDON ,9,222,2,300,78,1,4
5635,JAM MAKING SET PRINTED,8,1448,19,2000,552,1,38
5636,BIRD DECORATION RED RETROSPOT,5,589,11,1200,611,1,22
5637,CHRISTMAS GINGHAM TREE,4,2442,25,2600,158,1,50
5638,CHRISTMAS GINGHAM STAR,8,662,17,1800,1138,1,34
5639,CHRISTMAS GINGHAM HEART,5,192,1,200,8,1,2
5640,PACK OF 12 PINK POLKADOT TISSUES,3,878,19,2000,1122,1,38
5641,FELTCRAFT PRINCESS LOLA DOLL,4,120,1,200,80,1,2
5642,PACK OF 12 LONDON TISSUES ,1,554,5,600,46,1,10
5643,PURPLE DRAWERKNOB ACRYLIC EDWARDIAN,1,533,6,700,167,1,12
5644,CHILDREN'S APRON DOLLY GIRL ,4,685,15,1600,915,1,30
5645,CHILDRENS APRON SPACEBOY DESIGN,9,994,17,1800,806,1,34
5646,CHRISTMAS LIGHTS 10 SANTAS ,5,203,10,1100,897,1,20
5647,CHRISTMAS LIGHTS 10 REINDEER,9,1050,14,1500,450,1,28
5648,PAPER CHAIN KIT 50'S CHRISTMAS ,2,515,7,800,285,1,14
5649,FELTCRAFT CHRISTMAS FAIRY,1,1204,23,2400,1196,1,46
5650,PACK OF 72 RETROSPOT CAKE CASES,2,756,14,1500,744,1,28
5651,PACK OF 60 MUSHROOM CAKE CASES,4,937,12,1300,363,1,24
5652,64 CAKE CASES DOLLY GIRL DESIGN,10,1120,15,1600,480,1,30
5653,PACK OF 60 PINK PAISLEY CAKE CASES,8,1462,15,1600,138,1,30
5654,HAND WARMER BABUSHKA DESIGN,8,531,12,1300,769,1,24
5655,HAND WARMER BIRD DESIGN,1,182,12,1300,1118,1,24
5656,HAND WARMER OWL DESIGN,4,317,12,1300,983,1,24
5657,HAND WARMER RED RETROSPOT,3,949,10,1100,151,1,20
5658,SET 12 RETRO WHITE CHALK STICKS,9,145,4,500,355,1,8
5659,FELTCRAFT HAIRBAND RED AND BLUE,2,282,2,300,18,1,4
5660,FELTCRAFT HAIRBAND PINK AND PURPLE,10,412,9,1000,588,1,18
5661,FELTCRAFT HAIRBANDS PINK AND WHITE ,3,422,9,1000,578,1,18
5662,TV DINNER TRAY DOLLY GIRL,6,177,1,200,23,1,2
5663,PLASTERS IN TIN VINTAGE PAISLEY ,4,100,0,100,0,1,0
5664,PLASTERS IN TIN SPACEBOY,2,926,11,1200,274,1,22
5665,PLASTERS IN TIN WOODLAND ANIMALS,8,570,25,2600,2030,1,50
5666,MAGIC DRAWING SLATE SPACEBOY ,10,100,0,100,0,1,0
5667,MAGIC DRAWING SLATE CIRCUS PARADE  ,4,849,13,1400,551,1,26
5668,MAGIC DRAWING SLATE GO TO THE FAIR ,6,768,14,1500,732,1,28
5669,MAGIC DRAWING SLATE DOLLY GIRL ,7,913,10,1100,187,1,20
5670,CHARLIE + LOLA RED HOT WATER BOTTLE,9,602,25,2600,1998,1,50
5671,HOT WATER BOTTLE BABUSHKA ,2,1837,19,2000,163,1,38
5672,URBAN BLACK RIBBONS ,4,185,11,1200,1015,1,22
5673,FELTCRAFT PRINCESS CHARLOTTE DOLL,9,1324,23,2400,1076,1,46
5674,SET OF 6 T-LIGHTS TOADSTOOLS,2,615,9,1000,385,1,18
5675,ROTATING LEAVES T-LIGHT HOLDER,9,218,22,2300,2082,1,44
5676,RED  HARMONICA IN BOX ,5,522,23,2400,1878,1,46
5677,CUPCAKE LACE PAPER SET 10,3,223,3,400,177,1,6
5678,FAMILY PHOTO FRAME CORNICE,7,127,1,200,73,1,2
5679,TRIPLE PHOTO FRAME CORNICE ,3,583,5,600,17,1,10
5680,WOODEN FRAME ANTIQUE WHITE ,6,100,0,100,0,1,0
5681,WOODEN BOX OF DOMINOES,4,1485,18,1900,415,1,36
5682,TRADITIONAL WOODEN CATCH CUP GAME ,6,1671,18,1900,229,1,36
5683,TRADITIONAL WOODEN SKIPPING ROPE,7,1935,19,2000,65,1,38
5684,S/6 WOODEN SKITTLES IN COTTON BAG,1,1297,15,1600,303,1,30
5685,RED METAL BEACH SPADE ,7,519,11,1200,681,1,22
5686,BOYS VINTAGE TIN SEASIDE BUCKET,9,1649,20,2100,451,1,40
5687,GIRLS VINTAGE TIN SEASIDE BUCKET,8,1623,18,1900,277,1,36
5688,GREY HEART HOT WATER BOTTLE,10,309,10,1100,791,1,20
5689,SCOTTIE DOG HOT WATER BOTTLE,1,262,6,700,438,1,12
5690,BIRD HOUSE HOT WATER BOTTLE,2,655,9,1000,345,1,18
5691,KINGS CHOICE TEA CADDY ,4,382,3,400,18,1,6
5692,KINGS CHOICE BISCUIT TIN,8,119,2,300,181,1,4
5693,METAL SIGN EMPIRE TEA,5,1177,19,2000,823,1,38
5694,HOMEMADE JAM SCENTED CANDLES,5,1000,11,1200,200,1,22
5695,SET OF 6 SOLDIER SKITTLES,2,456,10,1100,644,1,20
5696,FAWN BLUE HOT WATER BOTTLE,1,2276,25,2600,324,1,50
5697,HAND WARMER RED RETROSPOT,2,310,6,700,390,1,12
5698,HOT WATER BOTTLE BABUSHKA ,6,1506,21,2200,694,1,42
5699,WHITE SKULL HOT WATER BOTTLE ,4,222,22,2300,2078,1,44
5700,RETROSPOT HEART HOT WATER BOTTLE,9,1222,22,2300,1078,1,44
5701,RED WOOLLY HOTTIE WHITE HEART.,6,1067,13,1400,333,1,26
5702,SCOTTIE DOG HOT WATER BOTTLE,9,1307,18,1900,593,1,36
5703,GREY HEART HOT WATER BOTTLE,8,231,5,600,369,1,10
5704,HOT WATER BOTTLE BABUSHKA ,8,1456,24,2500,1044,1,48
5705,PACK OF 6 BIRDY GIFT TAGS,2,538,16,1700,1162,1,32
5706,CHILLI LIGHTS,9,398,9,1000,602,1,18
5707,PIGGY BANK RETROSPOT ,2,109,2,300,191,1,4
5708,CERAMIC STRAWBERRY MONEY BOX,10,215,6,700,485,1,12
5709,CERAMIC STRAWBERRY CAKE MONEY BANK,3,1003,20,2100,1097,1,40
5710,CERAMIC CHERRY CAKE MONEY BANK,10,196,1,200,4,1,2
5711,CERAMIC HEART FAIRY CAKE MONEY BANK,7,1413,21,2200,787,1,42
5712,CERAMIC PIRATE CHEST MONEY BANK,10,2312,25,2600,288,1,50
5713,DOORSTOP RETROSPOT HEART,5,170,1,200,30,1,2
5714,GINGHAM HEART  DOORSTOP RED,3,275,7,800,525,1,14
5715,RETROSPOT BABUSHKA DOORSTOP,9,445,7,800,355,1,14
5716,SILK PURSE BABUSHKA RED,7,171,19,2000,1829,1,38
5717,SILK PURSE BABUSHKA PINK,9,305,6,700,395,1,12
5718,FAMILY PHOTO FRAME CORNICE,10,334,3,400,66,1,6
5719,SWEETHEART WIRE WALL TIDY,4,872,22,2300,1428,1,44
5720,JAM MAKING SET PRINTED,2,180,22,2300,2120,1,44
5721,RED RETROSPOT OVEN GLOVE ,3,100,0,100,0,1,0
5722,CREAM HEART CARD HOLDER,9,1285,16,1700,415,1,32
5723,NAMASTE SWAGAT INCENSE,6,1426,18,1900,474,1,36
5724,CERAMIC STRAWBERRY DESIGN MUG,1,698,14,1500,802,1,28
5725,BLACK HEART CARD HOLDER,9,781,7,800,19,1,14
5726,CLASSICAL ROSE SMALL VASE,2,859,8,900,41,1,16
5727,HYACINTH BULB T-LIGHT CANDLES,10,871,22,2300,1429,1,44
5728,CHRISTMAS CRAFT WHITE FAIRY ,10,1447,24,2500,1053,1,48
5729,CHRISTMAS CRAFT LITTLE FRIENDS,9,1613,23,2400,787,1,46
5730,COSY HOUR CIGAR BOX MATCHES ,1,1298,20,2100,802,1,40
5731,RED TEA TOWEL CLASSIC DESIGN,5,1246,14,1500,254,1,28
5732,HEART FILIGREE DOVE  SMALL,7,1591,15,1600,9,1,30
5733,RETROSPOT CHILDRENS APRON,1,353,4,500,147,1,8
5734,COLOURING PENCILS BROWN TUBE,8,204,3,400,196,1,6
5735,8 IVORY DINNER CANDLES SILVER FLOCK,5,627,10,1100,473,1,20
5736,HEART FILIGREE DOVE  SMALL,6,2081,25,2600,519,1,50
5737,ZINC METAL HEART DECORATION,5,350,5,600,250,1,10
5738,GREEN FERN NOTEBOOK,1,1736,23,2400,664,1,46
5739,BLUE PAISLEY NOTEBOOK,5,218,17,1800,1582,1,34
5740,CHRYSANTHEMUM NOTEBOOK,4,975,13,1400,425,1,26
5741,LARGE CHINESE STYLE SCISSOR,5,286,14,1500,1214,1,28
5742,SMALL CHINESE STYLE SCISSOR,10,426,13,1400,974,1,26
5743,S/6 WOODEN SKITTLES IN COTTON BAG,3,537,5,600,63,1,10
5744,TRADITIONAL WOODEN SKIPPING ROPE,6,184,2,300,116,1,4
5745,SET OF 6 SOLDIER SKITTLES,6,2123,22,2300,177,1,44
5746,8 TRADITIONAL SPINNING TOPS,2,535,18,1900,1365,1,36
5747,ROTATING SILVER ANGELS T-LIGHT HLDR,5,385,7,800,415,1,14
5748,BLACK LOVE BIRD CANDLE,4,851,10,1100,249,1,20
5749,RETROSPOT CHILDRENS APRON,8,153,1,200,47,1,2
5750,HANGING GLASS ETCHED TEALIGHT,8,169,22,2300,2131,1,44
5751,HANGING GLASS ETCHED TEALIGHT,4,1704,24,2500,796,1,48
5752,BLUE NEW BAROQUE CANDLESTICK CANDLE,1,156,12,1300,1144,1,24
5753,COOKING SET RETROSPOT,5,1890,18,1900,10,1,36
5754,KINGS CHOICE GIANT TUBE MATCHES,7,295,3,400,105,1,6
5755,COSY HOUR GIANT TUBE MATCHES,2,572,12,1300,728,1,24
5756,PLACE SETTING WHITE STAR,9,1236,14,1500,264,1,28
5757,HYACINTH BULB T-LIGHT CANDLES,1,608,7,800,192,1,14
5758,S/15 SILVER GLASS BAUBLES IN BAG,1,641,14,1500,859,1,28
5759,FRENCH WC SIGN BLUE METAL,5,867,21,2200,1333,1,42
5760,KINGS CHOICE GIANT TUBE MATCHES,5,1144,17,1800,656,1,34
5761,76 SWEETHEART FAIRY CAKE CASES,3,804,23,2400,1596,1,46
5762,ASSORTED COLOUR BIRD ORNAMENT,3,137,6,700,563,1,12
5763,FAIRY SOAP SOAP HOLDER,9,1093,25,2600,1507,1,50
5764,GREEN GIANT GARDEN THERMOMETER,5,1253,22,2300,1047,1,44
5765,IVORY GIANT GARDEN THERMOMETER,8,873,15,1600,727,1,30
5766,BLUE GIANT GARDEN THERMOMETER,5,641,12,1300,659,1,24
5767,PACK OF 60 PINK PAISLEY CAKE CASES,10,1850,21,2200,350,1,42
5768,RETROSPOT HEART HOT WATER BOTTLE,9,488,7,800,312,1,14
5769,CHICK GREY HOT WATER BOTTLE,3,1710,17,1800,90,1,34
5770,VICTORIAN SEWING BOX SMALL ,9,166,7,800,634,1,14
5771,VICTORIAN SEWING BOX MEDIUM,3,495,12,1300,805,1,24
5772,SET/10 RED POLKADOT PARTY CANDLES,10,1174,17,1800,626,1,34
5773,WASHROOM METAL SIGN,1,723,20,2100,1377,1,40
5774,BLACK SWEETHEART BRACELET,1,1575,18,1900,325,1,36
5775,DIAMANTE HAIR GRIP PACK/2 BLACK DIA,10,526,6,700,174,1,12
5776,BLACK DIAMANTE EXPANDABLE RING,6,947,18,1900,953,1,36
5777,DIAMANTE HAIR GRIP PACK/2 RUBY,1,455,16,1700,1245,1,32
5778,DIAMANTE HAIR GRIP PACK/2 MONTANA,6,1546,17,1800,254,1,34
5779,BLUE SWEETHEART BRACELET,2,113,5,600,487,1,10
5780,PINK SWEETHEART BRACELET,8,110,6,700,590,1,12
5781,PURPLE SWEETHEART BRACELET,6,1352,21,2200,848,1,42
5782,JUMBO BAG PINK POLKADOT,6,190,11,1200,1010,1,22
5783,JUMBO BAG RED RETROSPOT,7,1125,13,1400,275,1,26
5784,ASSORTED COLOUR BIRD ORNAMENT,3,530,6,700,170,1,12
5785,PAPER CHAIN KIT 50'S CHRISTMAS ,5,1055,14,1500,445,1,28
5786,RIBBON REEL CHRISTMAS PRESENT ,4,170,2,300,130,1,4
5787,FIRST AID TIN,2,113,2,300,187,1,4
5788,MAKE YOUR OWN MONSOON CARD KIT,7,782,10,1100,318,1,20
5789,PACK OF 12 HEARTS DESIGN TISSUES ,8,764,24,2500,1736,1,48
5790,PACK OF 12 RED RETROSPOT TISSUES ,3,984,18,1900,916,1,36
5791,SOLDIERS EGG CUP ,4,1817,18,1900,83,1,36
5792,HEART IVORY TRELLIS SMALL,9,153,3,400,247,1,6
5793,HEART FILIGREE DOVE  SMALL,3,1091,16,1700,609,1,32
5794,HEART FILIGREE DOVE LARGE,6,303,9,1000,697,1,18
5795,PACK 3 BOXES BIRD PANNETONE ,10,637,19,2000,1363,1,38
5796,PACK 3 BOXES CHRISTMAS PANNETONE,2,1281,17,1800,519,1,34
5797,SMALL POPCORN HOLDER,3,151,13,1400,1249,1,26
5798,PACK OF 60 PINK PAISLEY CAKE CASES,10,980,11,1200,220,1,22
5799,SET OF 6 SOLDIER SKITTLES,8,960,11,1200,240,1,22
5800,SWIRLY CIRCULAR RUBBERS IN BAG,2,1100,22,2300,1200,1,44
5801,VINTAGE PAISLEY STATIONERY SET,10,531,7,800,269,1,14
5802,PAPER CHAIN KIT VINTAGE CHRISTMAS,7,1094,20,2100,1006,1,40
5803,SET/10 BLUE POLKADOT PARTY CANDLES,4,1306,14,1500,194,1,28
5804,RIBBON REEL SOCKS AND MITTENS,10,177,1,200,23,1,2
5805,64 CAKE CASES VINTAGE CHRISTMAS,2,735,13,1400,665,1,26
5806,CHRISTMAS METAL TAGS ASSORTED ,5,663,9,1000,337,1,18
5807,CHRISTMAS TREE T-LIGHT HOLDER,2,430,17,1800,1370,1,34
5808,STAR  T-LIGHT HOLDER ,6,158,1,200,42,1,2
5809,HEART T-LIGHT HOLDER ,5,334,25,2600,2266,1,50
5810,MINI FUNKY DESIGN TAPES,8,132,9,1000,868,1,18
5811,SET OF 6 T-LIGHTS SNOWMEN,10,558,6,700,142,1,12
5812,STAR WOODEN CHRISTMAS DECORATION,3,515,21,2200,1685,1,42
5813,WOODEN HEART CHRISTMAS SCANDINAVIAN,8,1323,25,2600,1277,1,50
5814,CHRISTMAS RETROSPOT TREE WOOD,10,922,15,1600,678,1,30
5815,SET OF 6 T-LIGHTS SANTA,4,135,1,200,65,1,2
5816,SET/9 CHRISTMAS T-LIGHTS SCENTED ,6,118,1,200,82,1,2
5817,BLUE ROSE FABRIC MIRROR,5,364,5,600,236,1,10
5818,THREE CANVAS LUGGAGE TAGS,9,750,19,2000,1250,1,38
5819,RETROSPOT PARTY BAG + STICKER SET,7,199,5,600,401,1,10
5820,PLASTERS IN TIN VINTAGE PAISLEY ,10,1839,20,2100,261,1,40
5821,RETROSPOT SMALL TUBE MATCHES,7,533,8,900,367,1,16
5822,HAND WARMER SCOTTY DOG DESIGN,2,464,9,1000,536,1,18
5823,3D CHRISTMAS STAMPS STICKERS ,4,1565,24,2500,935,1,48
5824,HAND WARMER SCOTTY DOG DESIGN,2,447,8,900,453,1,16
5825,HAND WARMER SCOTTY DOG DESIGN,2,828,8,900,72,1,16
5826,CLOTHES PEGS RETROSPOT PACK 28,5,590,18,1900,1310,1,36
5827,40 FOIL HEART CAKE CASES,1,510,17,1800,1290,1,34
5828,CHRISTMAS METAL TAGS ASSORTED ,8,1754,21,2200,446,1,42
5829,PACK OF 6 SWEETIE GIFT BOXES,3,1550,19,2000,450,1,38
5830,PACK OF 72 RETROSPOT CAKE CASES,1,998,9,1000,2,1,18
5831,PACK OF 72 RETROSPOT CAKE CASES,5,939,14,1500,561,1,28
5832,PACK OF 6 BIRDY GIFT TAGS,7,497,4,500,3,1,8
5833,SET/10 RED POLKADOT PARTY CANDLES,10,692,8,900,208,1,16
5834,SET/10 PINK POLKADOT PARTY CANDLES,7,109,4,500,391,1,8
5835,SET OF 3 NOTEBOOKS IN PARCEL,7,833,9,1000,167,1,18
5836,STAR  T-LIGHT HOLDER ,6,786,24,2500,1714,1,48
5837,CINAMMON SET OF 9 T-LIGHTS,2,803,24,2500,1697,1,48
5838,ORANGE SCENTED SET/9 T-LIGHTS,3,100,0,100,0,1,0
5839,RIBBON REEL STRIPES DESIGN ,7,1999,25,2600,601,1,50
5840,SET OF 2 TINS JARDIN DE PROVENCE,1,112,11,1200,1088,1,22
5841,MAKE YOUR OWN PLAYTIME CARD KIT,6,1406,14,1500,94,1,28
5842,DINOSAURS  WRITING SET ,4,1220,15,1600,380,1,30
5843,BALLOONS  WRITING SET ,6,120,1,200,80,1,2
5844,SKULLS WRITING SET ,6,221,6,700,479,1,12
5845,VINTAGE PAISLEY STATIONERY SET,10,756,10,1100,344,1,20
5846,COSY SLIPPER SHOES SMALL  RED ,5,2592,25,2600,8,1,50
5847,DOORMAT BLACK FLOCK ,6,2466,24,2500,34,1,48
5848,JUMBO  BAG BAROQUE BLACK WHITE,8,937,12,1300,363,1,24
5849,JAM MAKING SET WITH JARS,7,289,22,2300,2011,1,44
5850,ORANGE SCENTED SET/9 T-LIGHTS,2,1174,11,1200,26,1,22
5851,CINAMMON SET OF 9 T-LIGHTS,5,100,0,100,0,1,0
5852,HAND WARMER SCOTTY DOG DESIGN,9,423,14,1500,1077,1,28
5853,CHRISTMAS DECOUPAGE CANDLE,7,1642,17,1800,158,1,34
5854,HEART T-LIGHT HOLDER ,7,132,19,2000,1868,1,38
5855,GROW YOUR OWN BASIL IN ENAMEL MUG,1,1464,22,2300,836,1,44
5856,OFFICE MUG WARMER POLKADOT,8,1030,14,1500,470,1,28
5857,SMALL POPCORN HOLDER,8,689,14,1500,811,1,28
5858,JUMBO BAG DOLLY GIRL DESIGN,8,536,23,2400,1864,1,46
5859,JAM MAKING SET WITH JARS,9,951,16,1700,749,1,32
5860,JAM MAKING SET PRINTED,4,534,15,1600,1066,1,30
5861,SMALL GLASS HEART TRINKET POT,3,551,25,2600,2049,1,50
5862,RED WOOLLY HOTTIE WHITE HEART.,6,344,23,2400,2056,1,46
5863,BLACK RECORD COVER FRAME,4,1872,25,2600,728,1,50
5864,"RECORD FRAME 7"" SINGLE SIZE ",10,1938,23,2400,462,1,46
5865,40 PENCILS TUBE RED RETROSPOT,10,259,7,800,541,1,14
5866,40 PENCILS TUBE WOODLAND,8,166,1,200,34,1,2
5867,SET OF 6 SOLDIER SKITTLES,1,257,21,2200,1943,1,42
5868,ROCKING HORSE RED CHRISTMAS ,10,1056,21,2200,1144,1,42
5869,CHRISTMAS GINGHAM HEART,4,768,15,1600,832,1,30
5870,CHRISTMAS GINGHAM STAR,7,743,16,1700,957,1,32
5871,HAND WARMER UNION JACK,9,1879,20,2100,221,1,40
5872,HAND WARMER RED RETROSPOT,10,1464,14,1500,36,1,28
5873,REGENCY CAKESTAND 3 TIER,7,190,9,1000,810,1,18
5874,JUMBO SHOPPER VINTAGE RED PAISLEY,6,100,0,100,0,1,0
5875,RIBBON REEL SNOWY VILLAGE,6,836,13,1400,564,1,26
5876,VINTAGE UNION JACK BUNTING,7,169,14,1500,1331,1,28
5877,JAM MAKING SET WITH JARS,1,357,5,600,243,1,10
5878,RIBBON REEL STRIPES DESIGN ,2,138,4,500,362,1,8
5879,RETRO LONGBOARD IRONING BOARD COVER,4,197,1,200,3,1,2
5880,3D DOG PICTURE PLAYING CARDS,8,190,12,1300,1110,1,24
5881,RETROSPOT CIGAR BOX MATCHES ,10,419,5,600,181,1,10
5882,SET/9 CHRISTMAS T-LIGHTS SCENTED ,4,120,2,300,180,1,4
5883,ROTATING SILVER ANGELS T-LIGHT HLDR,2,219,7,800,581,1,14
5884,ROTATING SILVER ANGELS T-LIGHT HLDR,6,1143,22,2300,1157,1,44
5885,SAVE THE PLANET COTTON TOTE BAG,8,234,10,1100,866,1,20
5886,SET OF 20 VINTAGE CHRISTMAS NAPKINS,4,283,6,700,417,1,12
5887,PAPER BUNTING WHITE LACE,7,681,16,1700,1019,1,32
5888,GENTLEMAN SHIRT REPAIR KIT ,8,675,10,1100,425,1,20
5889,CARD I LOVE LONDON ,4,653,15,1600,947,1,30
5890,PAPER CHAIN KIT VINTAGE CHRISTMAS,5,488,22,2300,1812,1,44
5891,MIRRORED WALL ART FOXY,3,1001,25,2600,1599,1,50
5892,MIRRORED WALL ART GENTS,7,1218,15,1600,382,1,30
5893,AIRLINE BAG VINTAGE JET SET WHITE,7,1061,20,2100,1039,1,40
5894,JAM MAKING SET PRINTED,6,1362,16,1700,338,1,32
5895,POTTING SHED SOW 'N' GROW SET,3,205,3,400,195,1,6
5896,BABUSHKA LIGHTS STRING OF 14,10,155,16,1700,1545,1,32
5897,REX CASH+CARRY JUMBO SHOPPER,5,801,19,2000,1199,1,38
5898,AIRLINE BAG VINTAGE WORLD CHAMPION ,2,679,12,1300,621,1,24
5899,HAND WARMER BIRD DESIGN,8,285,4,500,215,1,8
5900,CHRISTMAS CRAFT LITTLE FRIENDS,10,1245,12,1300,55,1,24
5901,PINK HEARTS PAPER GARLAND,10,761,8,900,139,1,16
5902,POTTING SHED SEED ENVELOPES,6,923,22,2300,1377,1,44
5903,HI TEC ALPINE HAND WARMER,6,1019,24,2500,1481,1,48
5904,FELTCRAFT CHRISTMAS FAIRY,3,192,14,1500,1308,1,28
5905,HI TEC ALPINE HAND WARMER,4,635,21,2200,1565,1,42
5906,ROTATING SILVER ANGELS T-LIGHT HLDR,6,973,20,2100,1127,1,40
5907,7 STRIPEY MICE FELTCRAFT,3,451,19,2000,1549,1,38
5908,FELTCRAFT 6 FLOWER FRIENDS,2,561,9,1000,439,1,18
5909,CHRISTMAS CRAFT LITTLE FRIENDS,2,804,8,900,96,1,16
5910,VINTAGE UNION JACK CUSHION COVER,3,837,15,1600,763,1,30
5911,POLYESTER FILLER PAD 45x45cm,9,460,6,700,240,1,12
5912,DOLLY GIRL LUNCH BOX,10,576,11,1200,624,1,22
5913,PACK OF 12 LONDON TISSUES ,1,320,4,500,180,1,8
5914,CARD DOLLY GIRL ,9,1675,20,2100,425,1,40
5915,CARD BILLBOARD FONT,10,500,13,1400,900,1,26
5916,RAINY LADIES BIRTHDAY CARD,8,451,4,500,49,1,8
5917,GREY HEART HOT WATER BOTTLE,8,898,15,1600,702,1,30
5918,RED WOOLLY HOTTIE WHITE HEART.,2,189,1,200,11,1,2
5919,RED WHITE SCARF  HOT WATER BOTTLE,1,1261,23,2400,1139,1,46
5920, SET 2 TEA TOWELS I LOVE LONDON ,1,722,7,800,78,1,14
5921,SET OF 2 TEA TOWELS APPLE AND PEARS,4,1022,15,1600,578,1,30
5922,SET/2 RED RETROSPOT TEA TOWELS ,8,327,4,500,173,1,8
5923,LOVE BUILDING BLOCK WORD,8,270,16,1700,1430,1,32
5924,HOME BUILDING BLOCK WORD,2,861,8,900,39,1,16
5925,ASSORTED COLOUR BIRD ORNAMENT,1,1718,21,2200,482,1,42
5926,LANTERN CREAM GAZEBO ,9,2069,23,2400,331,1,46
5927,BLUE BIRDHOUSE DECORATION,3,800,17,1800,1000,1,34
5928,WHITE HANGING HEART T-LIGHT HOLDER,7,831,8,900,69,1,16
5929,REGENCY CAKESTAND 3 TIER,2,1447,22,2300,853,1,44
5930,ANTIQUE SILVER TEA GLASS ENGRAVED,2,512,12,1300,788,1,24
5931,AGED GLASS SILVER T-LIGHT HOLDER,2,571,6,700,129,1,12
5932,JAM MAKING SET WITH JARS,2,210,22,2300,2090,1,44
5933,HAND WARMER OWL DESIGN,9,434,13,1400,966,1,26
5934,SET OF 2 WOODEN MARKET CRATES,1,2567,25,2600,33,1,50
5935,SET OF 6 T-LIGHTS TOADSTOOLS,3,231,17,1800,1569,1,34
5936,HAND WARMER UNION JACK,5,1486,24,2500,1014,1,48
5937,HAND WARMER SCOTTY DOG DESIGN,8,123,2,300,177,1,4
5938,CLASSIC FRENCH STYLE BASKET NATURAL,6,213,11,1200,987,1,22
5939,CRAZY DAISY HEART DECORATION,4,988,25,2600,1612,1,50
5940,GIN + TONIC DIET METAL SIGN,10,1431,14,1500,69,1,28
5941,IVORY GIANT GARDEN THERMOMETER,2,339,5,600,261,1,10
5942,CARD HOLDER GINGHAM HEART,5,100,0,100,0,1,0
5943,SMALL STRIPES CHOCOLATE GIFT BAG ,2,239,5,600,361,1,10
5944,S/6 WOODEN SKITTLES IN COTTON BAG,6,163,20,2100,1937,1,40
5945,HAND WARMER RED RETROSPOT,1,1442,17,1800,358,1,34
5946,HAND WARMER UNION JACK,1,840,10,1100,260,1,20
5947,FRENCH WC SIGN BLUE METAL,5,1309,13,1400,91,1,26
5948,PINK UNION JACK  LUGGAGE TAG,1,372,13,1400,1028,1,26
5949,"TRAY, BREAKFAST IN BED",8,784,20,2100,1316,1,40
5950,PIZZA PLATE IN BOX,5,1482,22,2300,818,1,44
5951,HEART OF WICKER LARGE,2,1226,14,1500,274,1,28
5952,PINK HEART DOTS HOT WATER BOTTLE,3,289,2,300,11,1,4
5953,PLACE SETTING WHITE HEART,8,344,18,1900,1556,1,36
5954,SET OF 4 NAPKIN CHARMS LEAVES   ,10,801,13,1400,599,1,26
5955,SET OF 4 NAPKIN CHARMS STARS   ,10,373,11,1200,827,1,22
5956,SET OF 4 NAPKIN CHARMS CUTLERY,4,201,15,1600,1399,1,30
5957,CARAVAN SQUARE TISSUE BOX,3,883,8,900,17,1,16
5958,PLASTERS IN TIN SKULLS,9,700,16,1700,1000,1,32
5959,PLASTERS IN TIN SPACEBOY,1,1957,24,2500,543,1,48
5960,BUTTON BOX ,1,956,13,1400,444,1,26
5961,PLASTERS IN TIN VINTAGE PAISLEY ,4,140,15,1600,1460,1,30
5962,16 MESSAGE CARDS WITH ENVELOPES,4,1866,22,2300,434,1,44
5963,SMALL RED BABUSHKA NOTEBOOK ,6,2116,21,2200,84,1,42
5964,CUPCAKE LACE PAPER SET 10,2,749,16,1700,951,1,32
5965,PACK 3 BOXES CHRISTMAS PANNETONE,8,1718,19,2000,282,1,38
5966,HERB MARKER MINT,5,735,24,2500,1765,1,48
5967,HERB MARKER ROSEMARY,4,2255,25,2600,345,1,50
5968,HERB MARKER BASIL,9,743,8,900,157,1,16
5969,HERB MARKER CHIVES ,4,1548,15,1600,52,1,30
5970,HERB MARKER PARSLEY,5,2043,21,2200,157,1,42
5971,HERB MARKER THYME,5,168,5,600,432,1,10
5972,WHITE HANGING HEART T-LIGHT HOLDER,2,499,17,1800,1301,1,34
5973,METAL MERRY CHRISTMAS WREATH,4,864,12,1300,436,1,24
5974,WHITE CHRISTMAS GARLAND STARS TREES,2,858,9,1000,142,1,18
5975,RETROSPOT SMALL TUBE MATCHES,10,301,7,800,499,1,14
5976,RETROSPOT GIANT TUBE MATCHES,7,516,11,1200,684,1,22
5977,PLACE SETTING WHITE STAR,1,1262,25,2600,1338,1,50
5978,GROW YOUR OWN BASIL IN ENAMEL MUG,5,783,7,800,17,1,14
5979,40 FOIL STAR CAKE CASES ,6,2165,25,2600,435,1,50
5980,40 FOIL HEART CAKE CASES,8,1382,24,2500,1118,1,48
5981,PACK OF 6 SWEETIE GIFT BOXES,7,263,14,1500,1237,1,28
5982,PACK OF 6 HANDBAG GIFT BOXES,1,187,4,500,313,1,8
5983,GARLAND WOODEN HAPPY EASTER,9,1952,21,2200,248,1,42
5984,CALENDAR PAPER CUT DESIGN,2,1311,16,1700,389,1,32
5985,CALENDAR IN SEASON DESIGN,2,1061,14,1500,439,1,28
5986,SMALL POPCORN HOLDER,3,183,2,300,117,1,4
5987,BLUE PAISLEY TISSUE BOX,9,421,10,1100,679,1,20
5988,HEART OF WICKER SMALL,6,650,15,1600,950,1,30
5989,SKULLS SQUARE TISSUE BOX,2,523,5,600,77,1,10
5990,SKULLS SQUARE TISSUE BOX,5,1228,19,2000,772,1,38
5991,WHITE HANGING HEART T-LIGHT HOLDER,1,622,24,2500,1878,1,48
5992,WHITE METAL LANTERN,4,767,8,900,133,1,16
5993,CREAM CUPID HEARTS COAT HANGER,9,1551,21,2200,649,1,42
5994,KNITTED UNION FLAG HOT WATER BOTTLE,9,1345,24,2500,1155,1,48
5995,RED WOOLLY HOTTIE WHITE HEART.,3,311,3,400,89,1,6
5996,SET 7 BABUSHKA NESTING BOXES,3,702,18,1900,1198,1,36
5997,GLASS STAR FROSTED T-LIGHT HOLDER,10,1480,20,2100,620,1,40
5998,HAND WARMER UNION JACK,1,1556,24,2500,944,1,48
5999,HAND WARMER RED POLKA DOT,10,231,2,300,69,1,4
6000,ASSORTED COLOUR BIRD ORNAMENT,8,794,15,1600,806,1,30
6001,POPPY'S PLAYHOUSE BEDROOM ,2,726,15,1600,874,1,30
6002,POPPY'S PLAYHOUSE KITCHEN,7,173,3,400,227,1,6
6003,FELTCRAFT PRINCESS CHARLOTTE DOLL,10,1721,24,2500,779,1,48
6004,IVORY KNITTED MUG COSY ,10,1687,17,1800,113,1,34
6005,BOX OF 6 ASSORTED COLOUR TEASPOONS,4,245,13,1400,1155,1,26
6006,BOX OF VINTAGE JIGSAW BLOCKS ,10,354,10,1100,746,1,20
6007,BOX OF VINTAGE ALPHABET BLOCKS,3,1198,15,1600,402,1,30
6008,HOME BUILDING BLOCK WORD,10,315,5,600,285,1,10
6009,LOVE BUILDING BLOCK WORD,5,199,11,1200,1001,1,22
6010,RECIPE BOX WITH METAL HEART,4,2194,24,2500,306,1,48
6011,DOORMAT NEW ENGLAND,10,823,14,1500,677,1,28
6012,JAM MAKING SET WITH JARS,3,669,22,2300,1631,1,44
6013,RED COAT RACK PARIS FASHION,1,928,14,1500,572,1,28
6014,YELLOW COAT RACK PARIS FASHION,6,180,6,700,520,1,12
6015,BLUE COAT RACK PARIS FASHION,3,1539,22,2300,761,1,44
6016,BATH BUILDING BLOCK WORD,4,174,8,900,726,1,16
6017,ALARM CLOCK BAKELIKE PINK,2,533,19,2000,1467,1,38
6018,ALARM CLOCK BAKELIKE RED ,1,167,4,500,333,1,8
6019,ALARM CLOCK BAKELIKE GREEN,6,400,9,1000,600,1,18
6020,PANDA AND BUNNIES STICKER SHEET,8,1945,19,2000,55,1,38
6021,STARS GIFT TAPE ,10,1113,25,2600,1487,1,50
6022,INFLATABLE POLITICAL GLOBE ,1,1281,16,1700,419,1,32
6023,VINTAGE HEADS AND TAILS CARD GAME ,1,100,0,100,0,1,0
6024,SET/2 RED RETROSPOT TEA TOWELS ,5,1054,25,2600,1546,1,50
6025,ROUND SNACK BOXES SET OF4 WOODLAND ,7,1159,12,1300,141,1,24
6026,SPACEBOY LUNCH BOX ,1,1276,14,1500,224,1,28
6027,LUNCH BOX I LOVE LONDON,4,168,2,300,132,1,4
6028,CIRCUS PARADE LUNCH BOX ,5,1731,24,2500,769,1,48
6029,CHARLOTTE BAG DOLLY GIRL DESIGN,5,363,23,2400,2037,1,46
6030,RED TOADSTOOL LED NIGHT LIGHT,7,507,11,1200,693,1,22
6031, SET 2 TEA TOWELS I LOVE LONDON ,5,220,16,1700,1480,1,32
6032,VINTAGE SEASIDE JIGSAW PUZZLES,1,914,10,1100,186,1,20
6033,MINI JIGSAW CIRCUS PARADE ,4,1852,25,2600,748,1,50
6034,MINI JIGSAW SPACEBOY,5,952,11,1200,248,1,22
6035,MINI PAINT SET VINTAGE ,4,227,23,2400,2173,1,46
6036,POSTAGE,8,1208,14,1500,292,1,28
6037,PAPER CHAIN KIT 50'S CHRISTMAS ,5,1724,20,2100,376,1,40
6038,HAND WARMER RED POLKA DOT,2,472,8,900,428,1,16
6039,HAND WARMER UNION JACK,4,1523,16,1700,177,1,32
6040,WHITE HANGING HEART T-LIGHT HOLDER,1,1528,15,1600,72,1,30
6041,WHITE METAL LANTERN,8,1616,24,2500,884,1,48
6042,CREAM CUPID HEARTS COAT HANGER,6,151,3,400,249,1,6
6043,EDWARDIAN PARASOL RED,4,727,12,1300,573,1,24
6044,RETRO COFFEE MUGS ASSORTED,4,928,12,1300,372,1,24
6045,SAVE THE PLANET MUG,5,977,22,2300,1323,1,44
6046,VINTAGE BILLBOARD DRINK ME MUG,9,1232,14,1500,268,1,28
6047,VINTAGE BILLBOARD LOVE/HATE MUG,1,1274,17,1800,526,1,34
6048,WOOD 2 DRAWER CABINET WHITE FINISH,9,992,23,2400,1408,1,46
6049,WOOD S/3 CABINET ANT WHITE FINISH,6,103,3,400,297,1,6
6050,WOODEN PICTURE FRAME WHITE FINISH,6,447,23,2400,1953,1,46
6051,WOODEN FRAME ANTIQUE WHITE ,6,1078,14,1500,422,1,28
6052,KNITTED UNION FLAG HOT WATER BOTTLE,7,100,0,100,0,1,0
6053,RED WOOLLY HOTTIE WHITE HEART.,2,576,6,700,124,1,12
6054,SET 7 BABUSHKA NESTING BOXES,3,254,6,700,446,1,12
6055,GLASS STAR FROSTED T-LIGHT HOLDER,7,1964,24,2500,536,1,48
6056,VICTORIAN SEWING BOX LARGE,9,100,0,100,0,1,0
6057,WHITE HANGING HEART T-LIGHT HOLDER,9,103,2,300,197,1,4
6058,WHITE METAL LANTERN,9,645,10,1100,455,1,20
6059,CREAM CUPID HEARTS COAT HANGER,6,475,17,1800,1325,1,34
6060,EDWARDIAN PARASOL RED,3,386,10,1100,714,1,20
6061,RETRO COFFEE MUGS ASSORTED,3,1182,19,2000,818,1,38
6062,SAVE THE PLANET MUG,10,1967,22,2300,333,1,44
6063,VINTAGE BILLBOARD DRINK ME MUG,4,285,10,1100,815,1,20
6064,VINTAGE BILLBOARD LOVE/HATE MUG,2,1739,20,2100,361,1,40
6065,WOOD 2 DRAWER CABINET WHITE FINISH,9,1150,12,1300,150,1,24
6066,WOOD S/3 CABINET ANT WHITE FINISH,2,227,4,500,273,1,8
6067,WOODEN PICTURE FRAME WHITE FINISH,3,258,10,1100,842,1,20
6068,WOODEN FRAME ANTIQUE WHITE ,7,218,2,300,82,1,4
6069,KNITTED UNION FLAG HOT WATER BOTTLE,1,361,4,500,139,1,8
6070,RED WOOLLY HOTTIE WHITE HEART.,4,473,23,2400,1927,1,46
6071,SET 7 BABUSHKA NESTING BOXES,7,111,7,800,689,1,14
6072,GLASS STAR FROSTED T-LIGHT HOLDER,7,811,9,1000,189,1,18
6073,HOT WATER BOTTLE TEA AND SYMPATHY,7,279,2,300,21,1,4
6074,RED HANGING HEART T-LIGHT HOLDER,8,265,5,600,335,1,10
6075,HAND WARMER RED POLKA DOT,3,412,7,800,388,1,14
6076,HAND WARMER UNION JACK,2,520,11,1200,680,1,22
6077,JUMBO BAG PINK POLKADOT,6,200,1,200,0,1,2
6078,JUMBO  BAG BAROQUE BLACK WHITE,8,1086,15,1600,514,1,30
6079,JUMBO BAG CHARLIE AND LOLA TOYS,2,333,4,500,167,1,8
6080,STRAWBERRY CHARLOTTE BAG,7,712,19,2000,1288,1,38
6081,RED 3 PIECE RETROSPOT CUTLERY SET,8,1275,15,1600,325,1,30
6082,BLUE 3 PIECE POLKADOT CUTLERY SET,3,409,7,800,391,1,14
6083,SET/6 RED SPOTTY PAPER PLATES,7,1800,18,1900,100,1,36
6084,LUNCH BAG RED RETROSPOT,9,156,1,200,44,1,2
6085,STRAWBERRY LUNCH BOX WITH CUTLERY,3,1311,22,2300,989,1,44
6086,LUNCH BOX WITH CUTLERY RETROSPOT ,5,928,20,2100,1172,1,40
6087,PACK OF 72 RETROSPOT CAKE CASES,8,1028,17,1800,772,1,34
6088,PACK OF 60 DINOSAUR CAKE CASES,3,942,10,1100,158,1,20
6089,PACK OF 60 PINK PAISLEY CAKE CASES,8,942,9,1000,58,1,18
6090,65 TEATIME FAIRY CAKE CASES,5,138,1,200,62,1,2
6091,TOMATO CHARLIE+LOLA COASTER SET,10,970,18,1900,930,1,36
6092,CHARLIE & LOLA WASTEPAPER BIN FLORA,1,352,19,2000,1648,1,38
6093,RED CHARLIE+LOLA PERSONAL DOORSIGN,6,119,3,400,281,1,6
6094,JUMBO STORAGE BAG SUKI,4,100,0,100,0,1,0
6095,JUMBO BAG PINK VINTAGE PAISLEY,10,1317,15,1600,283,1,30
6096,JAM MAKING SET PRINTED,4,125,13,1400,1275,1,26
6097,RETROSPOT TEA SET CERAMIC 11 PC ,8,926,23,2400,1474,1,46
6098,GIRLY PINK TOOL SET,5,344,4,500,156,1,8
6099,JUMBO SHOPPER VINTAGE RED PAISLEY,7,1522,18,1900,378,1,36
6100,"AIRLINE LOUNGE,METAL SIGN",9,755,18,1900,1145,1,36
6101,WHITE SPOT RED CERAMIC DRAWER KNOB,4,100,0,100,0,1,0
6102,RED DRAWER KNOB ACRYLIC EDWARDIAN,7,331,8,900,569,1,16
6103,CLEAR DRAWER KNOB ACRYLIC EDWARDIAN,6,218,8,900,682,1,16
6104,PHOTO CLIP LINE,3,376,17,1800,1424,1,34
6105,FELT EGG COSY CHICKEN,8,714,21,2200,1486,1,42
6106,PIGGY BANK RETROSPOT ,3,352,5,600,248,1,10
6107,SKULL SHOULDER BAG,8,169,3,400,231,1,6
6108,YOU'RE CONFUSING ME METAL SIGN ,5,169,7,800,631,1,14
6109,COOK WITH WINE METAL SIGN ,9,203,11,1200,997,1,22
6110,GIN + TONIC DIET METAL SIGN,7,167,1,200,33,1,2
6111,YELLOW BREAKFAST CUP AND SAUCER,8,271,14,1500,1229,1,28
6112,PINK BREAKFAST CUP AND SAUCER ,4,1129,24,2500,1371,1,48
6113,PAPER CHAIN KIT 50'S CHRISTMAS ,8,578,6,700,122,1,12
6114,PAPER CHAIN KIT RETROSPOT,10,216,14,1500,1284,1,28
6115,SMALL HEART FLOWERS HOOK ,7,299,3,400,101,1,6
6116,PHOTO CLIP LINE,5,2244,23,2400,156,1,46
6117,TEA TIME DES TEA COSY,2,368,7,800,432,1,14
6118,FELT EGG COSY WHITE RABBIT ,1,381,17,1800,1419,1,34
6119,ZINC WILLIE WINKIE  CANDLE STICK,10,468,19,2000,1532,1,38
6120,CERAMIC CHERRY CAKE MONEY BANK,6,1123,15,1600,477,1,30
6121,RETROSPOT LARGE MILK JUG,1,968,10,1100,132,1,20
6122,SET OF 6 FUNKY BEAKERS,7,144,1,200,56,1,2
6123,EDWARDIAN PARASOL BLACK,5,317,9,1000,683,1,18
6124,EDWARDIAN PARASOL NATURAL,1,122,7,800,678,1,14
6125,CERAMIC STRAWBERRY CAKE MONEY BANK,2,238,2,300,62,1,4
6126,BLUE OWL SOFT TOY,3,1709,25,2600,891,1,50
6127,BALLOON ART MAKE YOUR OWN FLOWERS,3,153,14,1500,1347,1,28
6128,RED TOADSTOOL LED NIGHT LIGHT,3,1321,20,2100,779,1,40
6129,GLASS CLOCHE SMALL,4,110,1,200,90,1,2
6130,GUMBALL MONOCHROME COAT RACK,2,399,17,1800,1401,1,34
6131,DOORMAT FANCY FONT HOME SWEET HOME,4,814,15,1600,786,1,30
6132,Discount,3,609,13,1400,791,1,26
6133,INFLATABLE POLITICAL GLOBE ,2,278,17,1800,1522,1,34
6134,VINTAGE SNAKES & LADDERS,5,1676,23,2400,724,1,46
6135,CHOCOLATE CALCULATOR,1,482,8,900,418,1,16
6136,JUMBO SHOPPER VINTAGE RED PAISLEY,2,491,8,900,409,1,16
6137,RECYCLING BAG RETROSPOT ,6,438,17,1800,1362,1,34
6138,TOY TIDY PINK POLKADOT,2,1059,25,2600,1541,1,50
6139,ANTIQUE GLASS DRESSING TABLE POT,8,884,14,1500,616,1,28
6140,ALARM CLOCK BAKELIKE GREEN,6,1094,13,1400,306,1,26
6141,IVORY GIANT GARDEN THERMOMETER,8,348,7,800,452,1,14
6142,8 TIER CAKE TIN GREEN AND CREAM,7,1078,24,2500,1422,1,48
6143,8 TIER CAKE TIN RED AND CREAM,9,680,16,1700,1020,1,32
6144,SET 3 WICKER OVAL BASKETS W LIDS,9,478,18,1900,1422,1,36
6145,SET OF 3 COLOURED  FLYING DUCKS,10,245,13,1400,1155,1,26
6146,WOOD BLACK BOARD ANT WHITE FINISH,1,394,6,700,306,1,12
6147,COLOUR GLASS T-LIGHT HOLDER HANGING,5,273,2,300,27,1,4
6148,HANGING METAL HEART LANTERN,1,515,10,1100,585,1,20
6149,HANGING MEDINA LANTERN SMALL,2,123,25,2600,2477,1,50
6150,NATURAL SLATE HEART CHALKBOARD ,6,348,6,700,352,1,12
6151,HEART OF WICKER SMALL,6,898,18,1900,1002,1,36
6152,HEART OF WICKER LARGE,1,676,14,1500,824,1,28
6153,WHITE LOVEBIRD LANTERN,5,238,5,600,362,1,10
6154,CLASSIC METAL BIRDCAGE PLANT HOLDER,10,1110,20,2100,990,1,40
6155,CREAM HEART CARD HOLDER,9,2039,23,2400,361,1,46
6156,ENAMEL FLOWER JUG CREAM,10,737,14,1500,763,1,28
6157,ENAMEL FIRE BUCKET CREAM,3,353,6,700,347,1,12
6158,ENAMEL BREAD BIN CREAM,9,172,7,800,628,1,14
6159,SET 3 WICKER OVAL BASKETS W LIDS,3,348,5,600,252,1,10
6160,JAM MAKING SET PRINTED,10,900,10,1100,200,1,20
6161,JAM MAKING SET WITH JARS,5,143,11,1200,1057,1,22
6162,JUMBO BAG DOLLY GIRL DESIGN,2,178,3,400,222,1,6
6163,TRADITIONAL CHRISTMAS RIBBONS,9,1748,24,2500,752,1,48
6164,ORGANISER WOOD ANTIQUE WHITE ,6,1972,25,2600,628,1,50
6165,LUNCH BAG DOLLY GIRL DESIGN,7,373,6,700,327,1,12
6166,WHITE WIRE EGG HOLDER,7,125,1,200,75,1,2
6167,JUMBO  BAG BAROQUE BLACK WHITE,3,855,13,1400,545,1,26
6168,JUMBO BAG RED RETROSPOT,9,100,0,100,0,1,0
6169,CHILLI LIGHTS,5,245,21,2200,1955,1,42
6170,LIGHT GARLAND BUTTERFILES PINK,6,1953,25,2600,647,1,50
6171,WOODEN OWLS LIGHT GARLAND ,4,100,0,100,0,1,0
6172,FAIRY TALE COTTAGE NIGHTLIGHT,1,260,2,300,40,1,4
6173,RED TOADSTOOL LED NIGHT LIGHT,2,1866,21,2200,334,1,42
6174,HOME BUILDING BLOCK WORD,1,116,11,1200,1084,1,22
6175,LOVE BUILDING BLOCK WORD,5,1421,24,2500,1079,1,48
6176,DOORMAT FANCY FONT HOME SWEET HOME,1,1230,23,2400,1170,1,46
6177,HOME SMALL WOOD LETTERS,8,2033,22,2300,267,1,44
6178,GINGHAM HEART  DOORSTOP RED,2,641,10,1100,459,1,20
6179,FIVE HEART HANGING DECORATION,2,356,11,1200,844,1,22
6180,HANGING METAL HEART LANTERN,6,231,10,1100,869,1,20
6181,ASSORTED BOTTLE TOP  MAGNETS ,4,100,0,100,0,1,0
6182,FRIDGE MAGNETS US DINER ASSORTED,8,837,15,1600,763,1,30
6183,HOMEMADE JAM SCENTED CANDLES,6,569,10,1100,531,1,20
6184,FRIDGE MAGNETS LES ENFANTS ASSORTED,8,864,23,2400,1536,1,46
6185,ROSE CARAVAN DOORSTOP,8,887,8,900,13,1,16
6186,HEART OF WICKER SMALL,10,100,0,100,0,1,0
6187,10 HOOK HANGER MAGIC TOADSTOOL,7,357,13,1400,1043,1,26
6188,CHRISTMAS LIGHTS 10 REINDEER,9,520,17,1800,1280,1,34
6189,VINTAGE UNION JACK CUSHION COVER,4,1093,18,1900,807,1,36
6190,VINTAGE HEADS AND TAILS CARD GAME ,3,100,0,100,0,1,0
6191,SET OF 3 COLOURED  FLYING DUCKS,3,651,9,1000,349,1,18
6192,SET OF 3 GOLD FLYING DUCKS,1,1542,25,2600,1058,1,50
6193,RED RETROSPOT UMBRELLA,7,449,13,1400,951,1,26
6194,BLACK/BLUE POLKADOT UMBRELLA,10,461,23,2400,1939,1,46
6195,RED DINER WALL CLOCK,4,1449,17,1800,351,1,34
6196,ALARM CLOCK BAKELIKE GREEN,9,164,5,600,436,1,10
6197,ALARM CLOCK BAKELIKE RED ,6,112,19,2000,1888,1,38
6198,BLUE DINER WALL CLOCK,1,651,9,1000,349,1,18
6199,IVORY DINER WALL CLOCK,2,427,14,1500,1073,1,28
6200,LARGE HEART MEASURING SPOONS,1,976,23,2400,1424,1,46
6201,SMALL HEART MEASURING SPOONS,10,1358,20,2100,742,1,40
6202,CHRISTMAS LIGHTS 10 REINDEER,4,1540,15,1600,60,1,30
6203,JAM MAKING SET WITH JARS,3,1071,20,2100,1029,1,40
6204,JAM MAKING SET PRINTED,8,1340,22,2300,960,1,44
6205,JAM JAR WITH PINK LID,10,1072,15,1600,528,1,30
6206,JAM JAR WITH GREEN LID,6,650,10,1100,450,1,20
6207,ROSE COTTAGE KEEPSAKE BOX ,3,576,5,600,24,1,10
6208,HANGING HEART ZINC T-LIGHT HOLDER,5,1022,18,1900,878,1,36
6209,PAPER CHAIN KIT VINTAGE CHRISTMAS,8,292,4,500,208,1,8
6210,DISCO BALL CHRISTMAS DECORATION,7,162,2,300,138,1,4
6211,WHITE HANGING HEART T-LIGHT HOLDER,6,914,14,1500,586,1,28
6212,SMALL POPCORN HOLDER,1,146,3,400,254,1,6
6213,LARGE POPCORN HOLDER ,8,849,10,1100,251,1,20
6214,RETROSPOT LARGE MILK JUG,1,1417,19,2000,583,1,38
6215,SET/20 RED RETROSPOT PAPER NAPKINS ,6,121,14,1500,1379,1,28
6216,SET/6 RED SPOTTY PAPER PLATES,8,424,10,1100,676,1,20
6217,SET/6 RED SPOTTY PAPER CUPS,8,358,6,700,342,1,12
6218,POLKADOT RAIN HAT ,6,935,16,1700,765,1,32
6219,DELUXE SEWING KIT ,10,905,9,1000,95,1,18
6220,RETROSPOT HEART HOT WATER BOTTLE,8,2130,22,2300,170,1,44
6221,KNITTED UNION FLAG HOT WATER BOTTLE,1,1403,20,2100,697,1,40
6222,ENGLISH ROSE HOT WATER BOTTLE,2,100,0,100,0,1,0
6223,PHOTO CUBE,8,977,16,1700,723,1,32
6224,HOMEMADE JAM SCENTED CANDLES,7,377,5,600,223,1,10
6225,JUMBO BAG RED RETROSPOT,6,1110,23,2400,1290,1,46
6226,PLASTERS IN TIN CIRCUS PARADE ,3,1389,25,2600,1211,1,50
6227,PACK OF 12 PINK PAISLEY TISSUES ,6,100,0,100,0,1,0
6228,PACK OF 12 BLUE PAISLEY TISSUES ,6,1093,18,1900,807,1,36
6229,PACK OF 12 RED RETROSPOT TISSUES ,5,199,1,200,1,1,2
6230,CHICK GREY HOT WATER BOTTLE,1,205,23,2400,2195,1,46
6231,PLASTERS IN TIN VINTAGE PAISLEY ,9,149,9,1000,851,1,18
6232,PLASTERS IN TIN SKULLS,1,1989,22,2300,311,1,44
6233,8 STRIPEY MICE FELTCRAFT,4,875,9,1000,125,1,18
6234,SET OF 6 SOLDIER SKITTLES,5,1513,22,2300,787,1,44
6235,TRADITIONAL WOODEN SKIPPING ROPE,5,731,8,900,169,1,16
6236,WOODEN BOX OF DOMINOES,7,774,19,2000,1226,1,38
6237,RUSTIC  SEVENTEEN DRAWER SIDEBOARD,8,1463,15,1600,137,1,30
6238,PARTY CONES CARNIVAL ASSORTED,6,826,22,2300,1474,1,44
6239,PARTY CONES CANDY ASSORTED,5,1409,15,1600,191,1,30
6240,PICNIC BASKET WICKER SMALL,10,200,4,500,300,1,8
6241,ASSORTED COLOUR BIRD ORNAMENT,7,174,2,300,126,1,4
6242,STAR DECORATION PAINTED ZINC ,9,100,0,100,0,1,0
6243,RETROSPOT LAMP,4,206,15,1600,1394,1,30
6244,"FANCY FONT BIRTHDAY CARD, ",7,1390,19,2000,610,1,38
6245,HAND WARMER UNION JACK,2,126,2,300,174,1,4
6246,HAND WARMER SCOTTY DOG DESIGN,2,421,12,1300,879,1,24
6247,HAND WARMER OWL DESIGN,7,100,0,100,0,1,0
6248,HAND WARMER RED RETROSPOT,10,184,7,800,616,1,14
6249,RETROSPOT HEART HOT WATER BOTTLE,8,100,0,100,0,1,0
6250,DOG BOWL CHASING BALL DESIGN,1,270,4,500,230,1,8
6251,CLOTHES PEGS RETROSPOT PACK 29,10,224,2,300,76,1,4
6252,HAND OVER THE CHOCOLATE   SIGN ,6,113,5,600,487,1,10
6253,WHITE HANGING HEART T-LIGHT HOLDER,10,2444,24,2500,56,1,48
6254,TRAVEL SEWING KIT,8,2178,23,2400,222,1,46
6255,BLACK HEART CARD HOLDER,9,1587,20,2100,513,1,40
6256,ASSORTED COLOUR BIRD ORNAMENT,9,1522,23,2400,878,1,46
6257,PACK OF 60 PINK PAISLEY CAKE CASES,5,244,2,300,56,1,4
6258,65 TEATIME FAIRY CAKE CASES,8,482,12,1300,818,1,24
6259,PACK OF 72 RETROSPOT CAKE CASES,1,377,14,1500,1123,1,28
6260,CHICK GREY HOT WATER BOTTLE,8,1671,22,2300,629,1,44
6261,SMALL GLASS HEART TRINKET POT,5,108,6,700,592,1,12
6262,ALARM CLOCK BAKELIKE IVORY,9,600,9,1000,400,1,18
6263,ALARM CLOCK BAKELIKE RED ,5,783,15,1600,817,1,30
6264,ALARM CLOCK BAKELIKE ORANGE,4,1695,21,2200,505,1,42
6265,ALARM CLOCK BAKELIKE GREEN,4,1418,21,2200,782,1,42
6266,HOT WATER BOTTLE TEA AND SYMPATHY,7,1979,21,2200,221,1,42
6267,HAND WARMER BIRD DESIGN,4,295,19,2000,1705,1,38
6268,HAND WARMER SCOTTY DOG DESIGN,2,178,13,1400,1222,1,26
6269,WHITE HANGING HEART T-LIGHT HOLDER,8,1765,25,2600,835,1,50
6270,WHITE METAL LANTERN,6,1661,24,2500,839,1,48
6271,CREAM CUPID HEARTS COAT HANGER,6,425,22,2300,1875,1,44
6272,EDWARDIAN PARASOL BLACK,4,827,13,1400,573,1,26
6273,EDWARDIAN PARASOL RED,3,659,8,900,241,1,16
6274,RETRO COFFEE MUGS ASSORTED,8,116,6,700,584,1,12
6275,SAVE THE PLANET MUG,7,794,25,2600,1806,1,50
6276,VINTAGE BILLBOARD DRINK ME MUG,7,2276,25,2600,324,1,50
6277,VINTAGE BILLBOARD LOVE/HATE MUG,4,1045,22,2300,1255,1,44
6278,WOOD 2 DRAWER CABINET WHITE FINISH,6,1613,22,2300,687,1,44
6279,WOOD S/3 CABINET ANT WHITE FINISH,2,208,2,300,92,1,4
6280,WOODEN PICTURE FRAME WHITE FINISH,6,100,0,100,0,1,0
6281,WOODEN FRAME ANTIQUE WHITE ,9,271,3,400,129,1,6
6282,KNITTED UNION FLAG HOT WATER BOTTLE,6,763,7,800,37,1,14
6283,RED WOOLLY HOTTIE WHITE HEART.,3,655,7,800,145,1,14
6284,SET 7 BABUSHKA NESTING BOXES,9,185,12,1300,1115,1,24
6285,IVORY EMBROIDERED QUILT ,9,100,0,100,0,1,0
6286,GLASS STAR FROSTED T-LIGHT HOLDER,5,315,3,400,85,1,6
6287,SET OF 3 BLACK FLYING DUCKS,3,1641,18,1900,259,1,36
6288,SET OF 3 COLOURED  FLYING DUCKS,2,1547,22,2300,753,1,44
6289,PACK OF 12 RED RETROSPOT TISSUES ,4,100,0,100,0,1,0
6290,RED RETROSPOT MUG,5,1052,17,1800,748,1,34
6291,BABUSHKA LIGHTS STRING OF 15,8,337,6,700,363,1,12
6292,PIGGY BANK RETROSPOT ,10,1830,23,2400,570,1,46
6293,SET 7 BABUSHKA NESTING BOXES,10,410,7,800,390,1,14
6294,DOORMAT FAIRY CAKE,9,350,3,400,50,1,6
6295,HAND WARMER RED RETROSPOT,6,1035,22,2300,1265,1,44
6296,HAND WARMER SCOTTY DOG DESIGN,3,236,7,800,564,1,14
6297,HAND WARMER OWL DESIGN,1,778,16,1700,922,1,32
6298,STRAWBERRY CERAMIC TRINKET BOX,7,716,12,1300,584,1,24
6299,PINK DOUGHNUT TRINKET POT ,2,368,10,1100,732,1,20
6300,SILK PURSE BABUSHKA PINK,6,115,4,500,385,1,8
6301,HOT WATER BOTTLE TEA AND SYMPATHY,6,1181,16,1700,519,1,32
6302,HOT WATER BOTTLE I AM SO POORLY,8,1585,20,2100,515,1,40
6303,CHOCOLATE HOT WATER BOTTLE,10,591,5,600,9,1,10
6304,WHITE SKULL HOT WATER BOTTLE ,10,182,17,1800,1618,1,34
6305,SCOTTIE DOG HOT WATER BOTTLE,2,128,2,300,172,1,4
6306,HAND WARMER RED POLKA DOT,9,100,0,100,0,1,0
6307,HAND WARMER UNION JACK,7,436,5,600,164,1,10
6308,HOMEMADE JAM SCENTED CANDLES,10,207,17,1800,1593,1,34
6309,BIRD HOUSE HOT WATER BOTTLE,10,1594,24,2500,906,1,48
6310,BOUDOIR SQUARE TISSUE BOX,1,1592,16,1700,108,1,32
6311,SKULLS SQUARE TISSUE BOX,3,148,1,200,52,1,2
6312,PHOTO FRAME CORNICE,1,652,6,700,48,1,12
6313,SILK PURSE BABUSHKA RED,2,128,3,400,272,1,6
6314,PICTURE DOMINOES,7,2073,22,2300,227,1,44
6315,S/6 SEW ON CROCHET FLOWERS,4,973,18,1900,927,1,36
6316,SCANDINAVIAN REDS RIBBONS,8,286,12,1300,1014,1,24
6317,BALLOONS  WRITING SET ,2,1004,22,2300,1296,1,44
6318,JAM MAKING SET PRINTED,6,100,0,100,0,1,0
6319,LAVENDER INCENSE IN TIN,9,2196,25,2600,404,1,50
6320,TV DINNER TRAY VINTAGE PAISLEY,5,360,11,1200,840,1,22
6321,SET OF 4 ENGLISH ROSE PLACEMATS,4,424,18,1900,1476,1,36
6322,SET OF 4 ENGLISH ROSE COASTERS,5,172,1,200,28,1,2
6323,TRIPLE PHOTO FRAME CORNICE ,9,807,21,2200,1393,1,42
6324,FAMILY PHOTO FRAME CORNICE,8,655,6,700,45,1,12
6325,MIRRORED DISCO BALL ,1,276,4,500,224,1,8
6326,DISCO BALL ROTATOR BATTERY OPERATED,5,1664,17,1800,136,1,34
6327,SILVER LOOKING MIRROR,4,100,0,100,0,1,0
6328,LADIES & GENTLEMEN METAL SIGN,3,1394,20,2100,706,1,40
6329,METAL SIGN HER DINNER IS SERVED ,7,882,12,1300,418,1,24
6330,YOU'RE CONFUSING ME METAL SIGN ,2,398,3,400,2,1,6
6331,DOORMAT TOPIARY,8,2412,24,2500,88,1,48
6332,BATHROOM METAL SIGN,1,463,4,500,37,1,8
6333,KITCHEN METAL SIGN,7,1186,13,1400,214,1,26
6334,TOILET METAL SIGN,3,731,10,1100,369,1,20
6335,METAL SIGN TAKE IT OR LEAVE IT ,7,256,10,1100,844,1,20
6336,I'M ON HOLIDAY METAL SIGN,7,671,25,2600,1929,1,50
6337,GROW YOUR OWN BASIL IN ENAMEL MUG,2,155,7,800,645,1,14
6338,SET/10 PINK POLKADOT PARTY CANDLES,3,844,22,2300,1456,1,44
6339,SET 20 NAPKINS FAIRY CAKES DESIGN ,9,241,2,300,59,1,4
6340,65 TEATIME FAIRY CAKE CASES,9,1761,24,2500,739,1,48
6341,SET OF 6 T-LIGHTS SNOWMEN,7,300,2,300,0,1,4
6342,SET OF 6 T-LIGHTS SANTA,10,790,16,1700,910,1,32
6343,SET OF 9 HEART SHAPED BALLOONS,10,257,2,300,43,1,4
6344,SANDWICH BATH SPONGE,5,204,20,2100,1896,1,40
6345,APPLE BATH SPONGE,4,1130,20,2100,970,1,40
6346,STRAWBERRY BATH SPONGE ,2,1274,14,1500,226,1,28
6347,BLACK PIRATE TREASURE CHEST,8,1124,12,1300,176,1,24
6348,STAR PORTABLE TABLE LIGHT ,9,1920,21,2200,280,1,42
6349,SNOWFLAKE PORTABLE TABLE LIGHT ,3,553,20,2100,1547,1,40
6350,PINK OVAL JEWELLED MIRROR,10,1036,11,1200,164,1,22
6351,RETROSPOT CIGAR BOX MATCHES ,3,100,0,100,0,1,0
6352,COSY HOUR GIANT TUBE MATCHES,2,371,16,1700,1329,1,32
6353,JAZZ HEARTS PURSE NOTEBOOK,5,311,21,2200,1889,1,42
6354,LUNCH BAG DOLLY GIRL DESIGN,8,848,8,900,52,1,16
6355,WHITE HANGING HEART T-LIGHT HOLDER,1,286,2,300,14,1,4
6356,CANDLEHOLDER PINK HANGING HEART,4,1196,16,1700,504,1,32
6357,WOOD 2 DRAWER CABINET WHITE FINISH,1,135,2,300,165,1,4
6358,ASSORTED COLOUR MINI CASES,9,825,24,2500,1675,1,48
6359,LUNCH BAG RED RETROSPOT,4,121,12,1300,1179,1,24
6360,LUNCH BAG SPACEBOY DESIGN ,1,881,15,1600,719,1,30
6361,LUNCH BAG WOODLAND,6,148,14,1500,1352,1,28
6362,LUNCH BAG PINK POLKADOT,10,1182,12,1300,118,1,24
6363,GUMBALL COAT RACK,1,808,14,1500,692,1,28
6364,BLUE NEW BAROQUE CANDLESTICK CANDLE,8,1560,21,2200,640,1,42
6365,PINK NEW BAROQUECANDLESTICK CANDLE,9,895,15,1600,705,1,30
6366,FAIRY CAKE FLANNEL ASSORTED COLOUR,9,2092,20,2100,8,1,40
6367,BREAD BIN DINER STYLE PINK,4,100,0,100,0,1,0
6368,JUMBO BAG CHARLIE AND LOLA TOYS,7,526,13,1400,874,1,26
6369,TEA TIME TABLE CLOTH,3,228,2,300,72,1,4
6370,ENGLISH ROSE HOT WATER BOTTLE,1,112,2,300,188,1,4
6371,ENAMEL FIRE BUCKET CREAM,4,848,15,1600,752,1,30
6372,PICNIC BASKET WICKER SMALL,3,544,10,1100,556,1,20
6373,PAPER CHAIN KIT 50'S CHRISTMAS ,2,692,6,700,8,1,12
6374,PAPER CHAIN KIT VINTAGE CHRISTMAS,5,369,25,2600,2231,1,50
6375,HOT WATER BOTTLE BABUSHKA ,8,1466,21,2200,734,1,42
6376,HAND WARMER BIRD DESIGN,10,254,23,2400,2146,1,46
6377,POSTAGE,3,1469,17,1800,331,1,34
6378,HEART IVORY TRELLIS SMALL,8,651,7,800,149,1,14
6379,CLEAR DRAWER KNOB ACRYLIC EDWARDIAN,4,1952,19,2000,48,1,38
6380,PINK DRAWER KNOB ACRYLIC EDWARDIAN,7,426,24,2500,2074,1,48
6381,GREEN DRAWER KNOB ACRYLIC EDWARDIAN,4,1035,11,1200,165,1,22
6382,BLUE DRAWER KNOB ACRYLIC EDWARDIAN,7,1021,15,1600,579,1,30
6383,HEART OF WICKER SMALL,10,1520,18,1900,380,1,36
6384,SMALL POPCORN HOLDER,10,783,10,1100,317,1,20
6385,SET 6 FOOTBALL CELEBRATION CANDLES,9,1155,12,1300,145,1,24
6386,SET OF 6 GIRLS CELEBRATION CANDLES,9,1037,19,2000,963,1,38
6387,ROMANTIC PINKS RIBBONS ,9,547,11,1200,653,1,22
6388,BRIGHT BLUES RIBBONS ,1,1544,21,2200,656,1,42
6389,SCANDINAVIAN REDS RIBBONS,5,153,1,200,47,1,2
6390,CHOCOLATE BOX RIBBONS ,4,121,9,1000,879,1,18
6391,PARTY INVITES FOOTBALL,1,161,2,300,139,1,4
6392,PARTY INVITES JAZZ HEARTS,9,848,12,1300,452,1,24
6393,PARTY INVITES SPACEMAN,1,1036,22,2300,1264,1,44
6394,SET OF 3 BUTTERFLY COOKIE CUTTERS,2,255,10,1100,845,1,20
6395,SET OF 3 HEART COOKIE CUTTERS,2,878,24,2500,1622,1,48
6396,8 PIECE SPACEBOY COOKIE CUTTER SET,2,102,3,400,298,1,6
6397,PACK OF 72 SKULL CAKE CASES,6,525,5,600,75,1,10
6398,PACK OF 60 SPACEBOY CAKE CASES,2,136,1,200,64,1,2
6399,PACK OF 72 RETROSPOT CAKE CASES,4,111,11,1200,1089,1,22
6400,77 SWEETHEART FAIRY CAKE CASES,7,314,11,1200,886,1,22
6401,PACK OF 60 DINOSAUR CAKE CASES,2,1329,14,1500,171,1,28
6402,LUNCH BAG SUKI  DESIGN ,6,249,2,300,51,1,4
6403,LUNCH BAG CARS BLUE,10,130,8,900,770,1,16
6404,LUNCH BAG  BLACK SKULL.,2,1343,15,1600,257,1,30
6405,HEART IVORY TRELLIS LARGE,2,140,2,300,160,1,4
6406,SET/5 RED RETROSPOT LID GLASS BOWLS,8,2187,21,2200,13,1,42
6407,WHITE HANGING HEART T-LIGHT HOLDER,8,100,0,100,0,1,0
6408,WHITE METAL LANTERN,6,849,10,1100,251,1,20
6409,CREAM CUPID HEARTS COAT HANGER,9,159,5,600,441,1,10
6410,EDWARDIAN PARASOL RED,5,117,1,200,83,1,2
6411,RETRO COFFEE MUGS ASSORTED,3,1730,21,2200,470,1,42
6412,SAVE THE PLANET MUG,8,536,20,2100,1564,1,40
6413,VINTAGE BILLBOARD DRINK ME MUG,1,175,1,200,25,1,2
6414,VINTAGE BILLBOARD LOVE/HATE MUG,9,192,14,1500,1308,1,28
6415,WOOD 2 DRAWER CABINET WHITE FINISH,4,333,3,400,67,1,6
6416,WOOD S/3 CABINET ANT WHITE FINISH,3,268,6,700,432,1,12
6417,WOODEN PICTURE FRAME WHITE FINISH,6,441,19,2000,1559,1,38
6418,WOODEN FRAME ANTIQUE WHITE ,8,493,14,1500,1007,1,28
6419,KNITTED UNION FLAG HOT WATER BOTTLE,10,117,6,700,583,1,12
6420,RED WOOLLY HOTTIE WHITE HEART.,10,989,15,1600,611,1,30
6421,SET 7 BABUSHKA NESTING BOXES,4,149,8,900,751,1,16
6422,IVORY EMBROIDERED QUILT ,7,366,14,1500,1134,1,28
6423,GLASS STAR FROSTED T-LIGHT HOLDER,10,1681,19,2000,319,1,38
6424,HAND WARMER RED POLKA DOT,6,873,10,1100,227,1,20
6425,HAND WARMER UNION JACK,8,239,6,700,461,1,12
6426,MAGIC DRAWING SLATE DINOSAUR,2,1083,21,2200,1117,1,42
6427,MAGIC DRAWING SLATE BAKE A CAKE ,2,130,6,700,570,1,12
6428,17 PENCILS TALL TUBE SKULLS,7,1208,16,1700,492,1,32
6429,CHOCOLATE CALCULATOR,10,450,23,2400,1950,1,46
6430,RED  HARMONICA IN BOX ,3,208,5,600,392,1,10
6431,BLUE HARMONICA IN BOX ,1,106,5,600,494,1,10
6432,SKULLS  WATER TRANSFER TATTOOS ,7,1348,17,1800,452,1,34
6433,PACK 3 BOXES BIRD PANNETONE ,5,1058,11,1200,142,1,22
6434,HOT WATER BOTTLE TEA AND SYMPATHY,6,584,12,1300,716,1,24
6435,RED WOOLLY HOTTIE WHITE HEART.,3,1262,25,2600,1338,1,50
6436,WHITE SKULL HOT WATER BOTTLE ,2,998,19,2000,1002,1,38
6437,8 PIECE SPACEBOY COOKIE CUTTER SET,7,169,12,1300,1131,1,24
6438,SET OF 20 KIDS COOKIE CUTTERS,5,1497,21,2200,703,1,42
6439,15 COLOUR SPACEBOY PEN,3,255,3,400,145,1,6
6440,VICTORIAN GLASS HANGING T-LIGHT,7,754,23,2400,1646,1,46
6441,SINGLE HEART ZINC T-LIGHT HOLDER,9,993,15,1600,607,1,30
6442,RED HANGING HEART T-LIGHT HOLDER,8,255,10,1100,845,1,20
6443,HANGING METAL STAR LANTERN,1,161,15,1600,1439,1,30
6444,SILVER HANGING T-LIGHT HOLDER,5,792,16,1700,908,1,32
6445,DOORMAT RED RETROSPOT,1,1350,15,1600,250,1,30
6446,DOORMAT HEARTS,10,1478,15,1600,122,1,30
6447,NATURAL SLATE RECTANGLE CHALKBOARD,3,1732,21,2200,468,1,42
6448,LOVEBIRD HANGING DECORATION WHITE ,5,808,10,1100,292,1,20
6449,ASSORTED COLOUR BIRD ORNAMENT,5,363,18,1900,1537,1,36
6450,HOME BUILDING BLOCK WORD,1,353,15,1600,1247,1,30
6451,LOVE BUILDING BLOCK WORD,3,2299,22,2300,1,1,44
6452,PHOTO FRAME CORNICE,5,1400,17,1800,400,1,34
6453,PENS ASSORTED FUNNY FACE,7,698,7,800,102,1,14
6454,CARD CIRCUS PARADE,10,792,23,2400,1608,1,46
6455,WRAP COWBOYS  ,4,999,9,1000,1,1,18
6456,AIRLINE BAG VINTAGE TOKYO 83,6,793,10,1100,307,1,20
6457,RED RETROSPOT UMBRELLA,3,1147,15,1600,453,1,30
6458,BLACK/BLUE POLKADOT UMBRELLA,7,356,8,900,544,1,16
6459,RED 3 PIECE RETROSPOT CUTLERY SET,1,648,21,2200,1552,1,42
6460,PACK OF 72 RETROSPOT CAKE CASES,1,100,0,100,0,1,0
6461,SET OF 72 RETROSPOT PAPER  DOILIES,3,147,4,500,353,1,8
6462,BLUE COAT RACK PARIS FASHION,4,409,8,900,491,1,16
6463,PLASTERS IN TIN SKULLS,8,220,7,800,580,1,14
6464,SLEEPING CAT ERASERS,2,609,17,1800,1191,1,34
6465,CARD BIRTHDAY COWBOY,3,597,14,1500,903,1,28
6466,PACK 3 BOXES CHRISTMAS PANNETONE,4,100,0,100,0,1,0
6467,ROTATING SILVER ANGELS T-LIGHT HLDR,5,434,6,700,266,1,12
6468,COSY HOUR GIANT TUBE MATCHES,9,770,7,800,30,1,14
6469,RIBBON REEL MAKING SNOWMEN ,4,395,23,2400,2005,1,46
6470,MINI PAINT SET VINTAGE ,8,1011,19,2000,989,1,38
6471,9 TRADITIONAL SPINNING TOPS,4,597,13,1400,803,1,26
6472,SET OF 6 SOLDIER SKITTLES,1,1845,18,1900,55,1,36
6473,BAG 500g SWIRLY MARBLES,6,563,20,2100,1537,1,40
6474,10 STRAND GLASS NECKLACE CRYSTAL,2,1006,23,2400,1394,1,46
6475,WHITE SKULL HOT WATER BOTTLE ,5,745,10,1100,355,1,20
6476,SCOTTIE DOG HOT WATER BOTTLE,8,1050,21,2200,1150,1,42
6477,SQUARECUSHION COVER PINK UNION FLAG,2,575,11,1200,625,1,22
6478,SPACEBOY CHILDRENS EGG CUP,3,193,10,1100,907,1,20
6479,CHILDREN'S SPACEBOY MUG,2,1668,23,2400,732,1,46
6480,HAND WARMER SCOTTY DOG DESIGN,1,580,23,2400,1820,1,46
6481,FELTCRAFT CUSHION OWL,4,100,0,100,0,1,0
6482,BLACK CANDELABRA T-LIGHT HOLDER,3,1905,19,2000,95,1,38
6483,TOY TIDY DOLLY GIRL DESIGN,1,1022,13,1400,378,1,26
6484,SET 12 LAVENDER  BOTANICAL T-LIGHTS,2,1425,14,1500,75,1,28
6485,UNION JACK FLAG LUGGAGE TAG,2,456,10,1100,644,1,20
6486,RED HEART LUGGAGE TAG,10,562,6,700,138,1,12
6487,RED GLASS TASSLE BAG CHARM,1,460,4,500,40,1,8
6488,CLEAR ACRYLIC FACETED BANGLE,4,2095,20,2100,5,1,40
6489,10 STRAND GLASS NECKLACE CRYSTAL,9,131,1,200,69,1,2
6490,DOORMAT UNION JACK GUNS AND ROSES,2,751,8,900,149,1,16
6491,VANILLA SCENT CANDLE JEWELLED BOX,3,1106,24,2500,1394,1,48
6492,FULL ENGLISH BREAKFAST PLATE,3,2017,22,2300,283,1,44
6493,BLACK CANDELABRA T-LIGHT HOLDER,6,1310,19,2000,690,1,38
6494,MAGIC DRAWING SLATE CIRCUS PARADE  ,8,2100,23,2400,300,1,46
6495,CHRISTMAS HANGING HEART WITH BELL,9,537,5,600,63,1,10
6496,CAKE STAND VICTORIAN FILIGREE MED,6,1667,16,1700,33,1,32
6497,PAISLEY PATTERN  STICKERS,9,1760,23,2400,640,1,46
6498,FLOWERS  STICKERS,5,1407,23,2400,993,1,46
6499,PINK NEW BAROQUECANDLESTICK CANDLE,6,1214,14,1500,286,1,28
6500,BLUE NEW BAROQUE CANDLESTICK CANDLE,7,785,17,1800,1015,1,34
6501,JUMBO STORAGE BAG SUKI,9,676,13,1400,724,1,26
6502,BLACK LOVE BIRD CANDLE,4,152,1,200,48,1,2
6503,PARTY TIME PENCIL ERASERS,9,157,2,300,143,1,4
6504,DISCO BALL CHRISTMAS DECORATION,4,537,11,1200,663,1,22
6505,PINK B'FLY C/COVER W BOBBLES,1,461,19,2000,1539,1,38
6506,PINK UNION JACK  LUGGAGE TAG,6,1061,10,1100,39,1,20
6507,11 RIBBONS ELEGANT CHRISTMAS ,6,1248,17,1800,552,1,34
6508,UNION JACK FLAG LUGGAGE TAG,4,873,14,1500,627,1,28
6509,AGED GLASS SILVER T-LIGHT HOLDER,5,274,2,300,26,1,4
6510,BOOM BOX SPEAKER GIRLS,3,232,7,800,568,1,14
6511,11 RIBBONS SHIMMERING PINKS ,3,898,10,1100,202,1,20
6512, SET 2 TEA TOWELS I LOVE LONDON ,1,1390,13,1400,10,1,26
6513,JUMBO BAG OWLS,8,698,11,1200,502,1,22
6514,SANDWICH BATH SPONGE,7,276,2,300,24,1,4
6515,OWL DOORSTOP,2,642,18,1900,1258,1,36
6516,10 STRAND GLASS NECKLACE CRYSTAL,6,851,12,1300,449,1,24
6517,HAND WARMER UNION JACK,2,372,6,700,328,1,12
6518,HAND WARMER SCOTTY DOG DESIGN,5,1106,14,1500,394,1,28
6519,LARGE POPCORN HOLDER ,7,1595,24,2500,905,1,48
6520,PAINTED METAL STAR WITH HOLLY BELLS,4,343,6,700,357,1,12
6521,PAINTED METAL HEART WITH HOLLY BELL,3,2183,22,2300,117,1,44
6522,ANGEL DECORATION STARS ON DRESS,9,941,22,2300,1359,1,44
6523,SMALL POPCORN HOLDER,1,936,9,1000,64,1,18
6524,JUMBO BAG RED RETROSPOT,5,407,4,500,93,1,8
6525,JUMBO BAG STRAWBERRY,8,702,25,2600,1898,1,50
6526,STRAWBERRY SHOPPER BAG,8,223,14,1500,1277,1,28
6527,STRAWBERRY CHARLOTTE BAG,1,1370,23,2400,1030,1,46
6528, SET 2 TEA TOWELS I LOVE LONDON ,10,199,1,200,1,1,2
6529,PACK OF 12 RED RETROSPOT TISSUES ,6,474,7,800,326,1,14
6530,SCOTTIE DOG HOT WATER BOTTLE,6,425,4,500,75,1,8
6531,CHOCOLATE HOT WATER BOTTLE,10,937,14,1500,563,1,28
6532,LUNCH BAG CARS BLUE,5,266,16,1700,1434,1,32
6533,LUNCH BAG SPACEBOY DESIGN ,1,100,0,100,0,1,0
6534,ROUND SNACK BOXES SET OF4 WOODLAND ,3,554,18,1900,1346,1,36
6535,LUNCH BAG DOLLY GIRL DESIGN,4,1362,19,2000,638,1,38
6536,LUNCH BAG SUKI  DESIGN ,2,636,16,1700,1064,1,32
6537,LUNCH BAG  BLACK SKULL.,6,455,6,700,245,1,12
6538,ROUND SNACK BOXES SET OF 4 FRUITS ,5,129,12,1300,1171,1,24
6539,ROUND SNACK BOXES SET OF 4 SKULLS,3,504,6,700,196,1,12
6540,DOLLY GIRL LUNCH BOX,6,1371,24,2500,1129,1,48
6541,SPACEBOY LUNCH BOX ,3,913,11,1200,287,1,22
6542,GREEN POLKADOT PLATE ,1,758,13,1400,642,1,26
6543,BLUE POLKADOT PLATE ,6,100,0,100,0,1,0
6544,RED RETROSPOT PLATE ,2,100,0,100,0,1,0
6545,PINK  POLKADOT PLATE ,3,223,6,700,477,1,12
6546,ROUND SNACK BOXES SET OF 4 SKULLS,1,115,3,400,285,1,6
6547,FELTCRAFT DOLL MOLLY,4,147,1,200,53,1,2
6548,FELTCRAFT CHRISTMAS FAIRY,6,499,8,900,401,1,16
6549,TRAVEL SEWING KIT,10,100,0,100,0,1,0
6550,SET OF 3 NOTEBOOKS IN PARCEL,1,219,11,1200,981,1,22
6551,RED RETROSPOT TAPE,3,385,13,1400,1015,1,26
6552,COSY SLIPPER SHOES SMALL  RED ,4,1894,19,2000,106,1,38
6553,11 RIBBONS RUSTIC CHARM,1,411,4,500,89,1,8
6554,SCANDINAVIAN REDS RIBBONS,3,261,10,1100,839,1,20
6555,JAM MAKING SET PRINTED,8,825,8,900,75,1,16
6556,17 DAISY PEGS IN WOOD BOX,4,1149,12,1300,151,1,24
6557,HOT WATER BOTTLE BABUSHKA ,4,371,8,900,529,1,16
6558,FELTCRAFT PRINCESS CHARLOTTE DOLL,3,1020,11,1200,180,1,22
6559,FELTCRAFT CHRISTMAS FAIRY,10,650,8,900,250,1,16
6560,FELTCRAFT PRINCESS CHARLOTTE DOLL,3,365,3,400,35,1,6
6561,11 RIBBONS RUSTIC CHARM,2,100,0,100,0,1,0
6562,COSY SLIPPER SHOES SMALL  RED ,4,673,21,2200,1527,1,42
6563,SCANDINAVIAN REDS RIBBONS,9,1536,17,1800,264,1,34
6564,10 HOOK HANGER RED MAGIC TOADSTOOL,5,1080,23,2400,1320,1,46
6565,CHRISTMAS CRAFT TREE TOP ANGEL,5,192,18,1900,1708,1,36
6566,CHRISTMAS CRAFT LITTLE FRIENDS,5,254,12,1300,1046,1,24
6567,10 HOOK HANGER RED MAGIC TOADSTOOL,10,951,9,1000,49,1,18
6568,11 RIBBONS RUSTIC CHARM,6,672,15,1600,928,1,30
6569,17 DAISY PEGS IN WOOD BOX,10,474,8,900,426,1,16
6570,SET OF 3 NOTEBOOKS IN PARCEL,9,188,3,400,212,1,6
6571,10 HOOK HANGER MAGIC TOADSTOOL,6,591,19,2000,1409,1,38
6572,SCANDINAVIAN REDS RIBBONS,8,530,11,1200,670,1,22
6573,RED TOADSTOOL LED NIGHT LIGHT,3,345,5,600,255,1,10
6574,10 HOOK HANGER RED MAGIC TOADSTOOL,9,1299,15,1600,301,1,30
6575,COSY SLIPPER SHOES SMALL GREEN,9,100,0,100,0,1,0
6576,COSY SLIPPER SHOES SMALL  RED ,5,185,4,500,315,1,8
6577,FELTCRAFT DOLL ROSIE,4,273,4,500,227,1,8
6578,FELTCRAFT DOLL MOLLY,10,208,15,1600,1392,1,30
6579,FELTCRAFT DOLL EMILY,1,218,13,1400,1182,1,26
6580,FELTCRAFT PRINCESS CHARLOTTE DOLL,8,297,3,400,103,1,6
6581,FELTCRAFT PRINCESS OLIVIA DOLL,10,486,24,2500,2014,1,48
6582,REX CASH+CARRY JUMBO SHOPPER,9,1216,15,1600,384,1,30
6583,FELTCRAFT DOLL MOLLY,9,100,1,200,100,1,2
6584,FELTCRAFT CUSHION OWL,6,355,25,2600,2245,1,50
6585,CHRISTMAS CRAFT TREE TOP ANGEL,3,317,15,1600,1283,1,30
6586,CHRISTMAS CRAFT LITTLE FRIENDS,5,175,4,500,325,1,8
6587,FELTCRAFT CUSHION RABBIT,8,332,17,1800,1468,1,34
6588,FELTCRAFT CUSHION BUTTERFLY,4,1654,21,2200,546,1,42
6589,17 DAISY PEGS IN WOOD BOX,6,1389,20,2100,711,1,40
6590,PAPER CHAIN KIT 50'S CHRISTMAS ,1,348,4,500,152,1,8
6591,FELTCRAFT CUSHION BUTTERFLY,7,770,11,1200,430,1,22
6592,17 DAISY PEGS IN WOOD BOX,4,432,10,1100,668,1,20
6593,ROSE COTTAGE KEEPSAKE BOX ,8,520,14,1500,980,1,28
6594,TOTE BAG I LOVE LONDON,7,919,16,1700,781,1,32
6595,17 DAISY PEGS IN WOOD BOX,4,1549,15,1600,51,1,30
6596,TOTE BAG I LOVE LONDON,6,1277,20,2100,823,1,40
6597,FOLDING UMBRELLA PINKWHITE POLKADOT,6,1772,20,2100,328,1,40
6598,FOLDING UMBRELLA CREAM POLKADOT,6,136,5,600,464,1,10
6599,FOLDING UMBRELLA WHITE/RED POLKADOT,1,325,5,600,275,1,10
6600,SET 10 LIGHTS NIGHT OWL,3,1215,24,2500,1285,1,48
6601,SMALL POPCORN HOLDER,8,732,13,1400,668,1,26
6602, SET 2 TEA TOWELS I LOVE LONDON ,5,277,9,1000,723,1,18
6603,FOLDING UMBRELLA RED/WHITE POLKADOT,1,854,14,1500,646,1,28
6604,BABUSHKA LIGHTS STRING OF 15,6,1461,16,1700,239,1,32
6605,LUNCH BAG RED RETROSPOT,9,1980,19,2000,20,1,38
6606,S/4 VALENTINE DECOUPAGE HEART BOX,1,646,18,1900,1254,1,36
6607,FOLDING UMBRELLA CREAM POLKADOT,7,100,0,100,0,1,0
6608, SET 2 TEA TOWELS I LOVE LONDON ,6,273,7,800,527,1,14
6609,FOLDING UMBRELLA RED/WHITE POLKADOT,2,1217,12,1300,83,1,24
6610,SOLDIERS EGG CUP ,1,723,21,2200,1477,1,42
6611,S/4 VALENTINE DECOUPAGE HEART BOX,10,717,9,1000,283,1,18
6612,RED RETROSPOT MINI CASES,1,752,17,1800,1048,1,34
6613,,4,171,7,800,629,1,14
6614,65 CAKE CASES VINTAGE CHRISTMAS,6,543,6,700,157,1,12
6615,PAPER CHAIN KIT VINTAGE CHRISTMAS,3,1173,14,1500,327,1,28
6616,RIBBON REEL CHRISTMAS SOCK BAUBLE,4,1669,22,2300,631,1,44
6617,RIBBON REEL SNOWY VILLAGE,7,1309,23,2400,1091,1,46
6618,RIBBON REEL MAKING SNOWMEN ,3,453,9,1000,547,1,18
6619,SET OF 20 VINTAGE CHRISTMAS NAPKINS,5,592,14,1500,908,1,28
6620,TURQUOISE CHRISTMAS TREE ,2,1566,17,1800,234,1,34
6621,RED STAR CARD HOLDER,2,155,2,300,145,1,4
6622,WICKER WREATH SMALL,9,378,18,1900,1522,1,36
6623,HEART OF WICKER LARGE,1,593,5,600,7,1,10
6624,ADVENT CALENDAR GINGHAM SACK,9,201,14,1500,1299,1,28
6625,HEART OF WICKER SMALL,5,352,4,500,148,1,8
6626,FELTCRAFT BUTTERFLY HEARTS,9,1157,23,2400,1243,1,46
6627,PARTY CONE CHRISTMAS DECORATION ,1,130,4,500,370,1,8
6628,VINTAGE HEADS AND TAILS CARD GAME ,1,1238,18,1900,662,1,36
6629,WICKER STAR ,3,455,19,2000,1545,1,38
6630,VINTAGE SNAP CARDS,2,315,6,700,385,1,12
6631,FELTCRAFT 6 FLOWER FRIENDS,6,348,8,900,552,1,16
6632, SET 2 TEA TOWELS I LOVE LONDON ,4,100,0,100,0,1,0
6633,JAM MAKING SET PRINTED,4,246,10,1100,854,1,20
6634,BIRD DECORATION RED RETROSPOT,10,643,10,1100,457,1,20
6635,CHRISTMAS GINGHAM TREE,8,625,14,1500,875,1,28
6636,CHRISTMAS GINGHAM STAR,6,2250,22,2300,50,1,44
6637,CHRISTMAS GINGHAM HEART,1,513,11,1200,687,1,22
6638,PACK OF 12 PINK POLKADOT TISSUES,7,117,13,1400,1283,1,26
6639,FELTCRAFT PRINCESS LOLA DOLL,1,233,4,500,267,1,8
6640,PACK OF 12 LONDON TISSUES ,5,1543,16,1700,157,1,32
6641,PURPLE DRAWERKNOB ACRYLIC EDWARDIAN,1,1079,13,1400,321,1,26
6642,CHILDREN'S APRON DOLLY GIRL ,7,285,7,800,515,1,14
6643,CHILDRENS APRON SPACEBOY DESIGN,9,673,16,1700,1027,1,32
6644,CHRISTMAS LIGHTS 10 SANTAS ,5,332,6,700,368,1,12
6645,CHRISTMAS LIGHTS 10 REINDEER,10,522,14,1500,978,1,28
6646,PAPER CHAIN KIT 50'S CHRISTMAS ,4,112,3,400,288,1,6
6647,FELTCRAFT CHRISTMAS FAIRY,10,766,13,1400,634,1,26
6648,PACK OF 72 RETROSPOT CAKE CASES,4,789,8,900,111,1,16
6649,PACK OF 60 MUSHROOM CAKE CASES,5,100,0,100,0,1,0
6650,65 CAKE CASES DOLLY GIRL DESIGN,6,169,1,200,31,1,2
6651,PACK OF 60 PINK PAISLEY CAKE CASES,4,2058,25,2600,542,1,50
6652,HAND WARMER BABUSHKA DESIGN,7,613,6,700,87,1,12
6653,HAND WARMER BIRD DESIGN,3,290,10,1100,810,1,20
6654,HAND WARMER OWL DESIGN,9,906,11,1200,294,1,22
6655,HAND WARMER RED RETROSPOT,6,1138,13,1400,262,1,26
6656,SET 12 RETRO WHITE CHALK STICKS,6,1817,18,1900,83,1,36
6657,FELTCRAFT HAIRBAND RED AND BLUE,6,722,19,2000,1278,1,38
6658,FELTCRAFT HAIRBAND PINK AND PURPLE,3,126,21,2200,2074,1,42
6659,FELTCRAFT HAIRBANDS PINK AND WHITE ,3,405,16,1700,1295,1,32
6660,TV DINNER TRAY DOLLY GIRL,1,440,6,700,260,1,12
6661,PLASTERS IN TIN VINTAGE PAISLEY ,5,199,9,1000,801,1,18
6662,PLASTERS IN TIN SPACEBOY,8,158,18,1900,1742,1,36
6663,PLASTERS IN TIN WOODLAND ANIMALS,6,373,21,2200,1827,1,42
6664,MAGIC DRAWING SLATE SPACEBOY ,5,1784,18,1900,116,1,36
6665,MAGIC DRAWING SLATE CIRCUS PARADE  ,4,575,5,600,25,1,10
6666,MAGIC DRAWING SLATE GO TO THE FAIR ,1,1009,15,1600,591,1,30
6667,MAGIC DRAWING SLATE DOLLY GIRL ,3,363,10,1100,737,1,20
6668,CHARLIE + LOLA RED HOT WATER BOTTLE,5,164,1,200,36,1,2
6669,HOT WATER BOTTLE BABUSHKA ,2,171,8,900,729,1,16
6670,URBAN BLACK RIBBONS ,5,175,7,800,625,1,14
6671,FELTCRAFT PRINCESS CHARLOTTE DOLL,9,213,12,1300,1087,1,24
6672,SET OF 6 T-LIGHTS TOADSTOOLS,5,421,21,2200,1779,1,42
6673,ROTATING LEAVES T-LIGHT HOLDER,5,575,9,1000,425,1,18
6674,RED  HARMONICA IN BOX ,2,812,12,1300,488,1,24
6675,CUPCAKE LACE PAPER SET 11,8,180,1,200,20,1,2
6676,FAMILY PHOTO FRAME CORNICE,2,221,8,900,679,1,16
6677,TRIPLE PHOTO FRAME CORNICE ,6,525,16,1700,1175,1,32
6678,WOODEN FRAME ANTIQUE WHITE ,6,167,5,600,433,1,10
6679,WOODEN BOX OF DOMINOES,4,524,23,2400,1876,1,46
6680,TRADITIONAL WOODEN CATCH CUP GAME ,3,312,5,600,288,1,10
6681,TRADITIONAL WOODEN SKIPPING ROPE,7,1212,18,1900,688,1,36
6682,S/6 WOODEN SKITTLES IN COTTON BAG,8,1046,21,2200,1154,1,42
6683,RED METAL BEACH SPADE ,7,886,9,1000,114,1,18
6684,BOYS VINTAGE TIN SEASIDE BUCKET,2,100,0,100,0,1,0
6685,GIRLS VINTAGE TIN SEASIDE BUCKET,10,1131,24,2500,1369,1,48
6686,GREY HEART HOT WATER BOTTLE,5,100,0,100,0,1,0
6687,SCOTTIE DOG HOT WATER BOTTLE,1,383,23,2400,2017,1,46
6688,BIRD HOUSE HOT WATER BOTTLE,4,100,0,100,0,1,0
6689,KINGS CHOICE TEA CADDY ,1,737,11,1200,463,1,22
6690,KINGS CHOICE BISCUIT TIN,3,752,12,1300,548,1,24
6691,METAL SIGN EMPIRE TEA,3,828,12,1300,472,1,24
6692,HOMEMADE JAM SCENTED CANDLES,6,270,2,300,30,1,4
6693,SET OF 6 SOLDIER SKITTLES,9,100,0,100,0,1,0
6694,FAWN BLUE HOT WATER BOTTLE,5,1391,17,1800,409,1,34
6695,HAND WARMER RED RETROSPOT,6,748,13,1400,652,1,26
6696,HOT WATER BOTTLE BABUSHKA ,10,283,8,900,617,1,16
6697,WHITE SKULL HOT WATER BOTTLE ,6,100,0,100,0,1,0
6698,RETROSPOT HEART HOT WATER BOTTLE,6,1208,20,2100,892,1,40
6699,RED WOOLLY HOTTIE WHITE HEART.,6,100,0,100,0,1,0
6700,SCOTTIE DOG HOT WATER BOTTLE,7,723,9,1000,277,1,18
6701,GREY HEART HOT WATER BOTTLE,9,686,25,2600,1914,1,50
6702,HOT WATER BOTTLE BABUSHKA ,4,170,2,300,130,1,4
6703,PACK OF 6 BIRDY GIFT TAGS,9,741,7,800,59,1,14
6704,CHILLI LIGHTS,1,999,21,2200,1201,1,42
6705,PIGGY BANK RETROSPOT ,7,366,10,1100,734,1,20
6706,CERAMIC STRAWBERRY MONEY BOX,6,1469,15,1600,131,1,30
6707,CERAMIC STRAWBERRY CAKE MONEY BANK,2,2460,24,2500,40,1,48
6708,CERAMIC CHERRY CAKE MONEY BANK,6,106,16,1700,1594,1,32
6709,CERAMIC HEART FAIRY CAKE MONEY BANK,7,489,14,1500,1011,1,28
6710,CERAMIC PIRATE CHEST MONEY BANK,10,637,17,1800,1163,1,34
6711,DOORSTOP RETROSPOT HEART,10,317,6,700,383,1,12
6712,GINGHAM HEART  DOORSTOP RED,5,205,13,1400,1195,1,26
6713,RETROSPOT BABUSHKA DOORSTOP,5,1808,20,2100,292,1,40
6714,SILK PURSE BABUSHKA RED,4,356,3,400,44,1,6
6715,SILK PURSE BABUSHKA PINK,6,470,13,1400,930,1,26
6716,FAMILY PHOTO FRAME CORNICE,4,1279,15,1600,321,1,30
6717,SWEETHEART WIRE WALL TIDY,3,437,7,800,363,1,14
6718,JAM MAKING SET PRINTED,10,1238,23,2400,1162,1,46
6719,RED RETROSPOT OVEN GLOVE ,5,294,5,600,306,1,10
6720,CREAM HEART CARD HOLDER,7,290,24,2500,2210,1,48
6721,NAMASTE SWAGAT INCENSE,2,184,4,500,316,1,8
6722,CERAMIC STRAWBERRY DESIGN MUG,2,268,13,1400,1132,1,26
6723,BLACK HEART CARD HOLDER,8,776,23,2400,1624,1,46
6724,CLASSICAL ROSE SMALL VASE,3,297,8,900,603,1,16
6725,HYACINTH BULB T-LIGHT CANDLES,4,845,15,1600,755,1,30
6726,CHRISTMAS CRAFT WHITE FAIRY ,1,319,4,500,181,1,8
6727,CHRISTMAS CRAFT LITTLE FRIENDS,8,1142,18,1900,758,1,36
6728,COSY HOUR CIGAR BOX MATCHES ,4,690,20,2100,1410,1,40
6729,RED TEA TOWEL CLASSIC DESIGN,1,1433,20,2100,667,1,40
6730,HEART FILIGREE DOVE  SMALL,5,2401,25,2600,199,1,50
6731,RETROSPOT CHILDRENS APRON,8,1910,22,2300,390,1,44
6732,COLOURING PENCILS BROWN TUBE,3,1039,16,1700,661,1,32
6733,9 IVORY DINNER CANDLES SILVER FLOCK,5,325,3,400,75,1,6
6734,HEART FILIGREE DOVE  SMALL,5,350,3,400,50,1,6
6735,ZINC METAL HEART DECORATION,5,1244,15,1600,356,1,30
6736,GREEN FERN NOTEBOOK,2,206,13,1400,1194,1,26
6737,BLUE PAISLEY NOTEBOOK,1,612,7,800,188,1,14
6738,CHRYSANTHEMUM NOTEBOOK,3,360,4,500,140,1,8
6739,LARGE CHINESE STYLE SCISSOR,2,512,16,1700,1188,1,32
6740,SMALL CHINESE STYLE SCISSOR,6,731,12,1300,569,1,24
6741,S/6 WOODEN SKITTLES IN COTTON BAG,6,100,0,100,0,1,0
6742,TRADITIONAL WOODEN SKIPPING ROPE,8,1635,19,2000,365,1,38
6743,SET OF 6 SOLDIER SKITTLES,5,123,6,700,577,1,12
6744,9 TRADITIONAL SPINNING TOPS,4,198,11,1200,1002,1,22
6745,ROTATING SILVER ANGELS T-LIGHT HLDR,8,842,18,1900,1058,1,36
6746,BLACK LOVE BIRD CANDLE,7,380,23,2400,2020,1,46
6747,RETROSPOT CHILDRENS APRON,3,458,6,700,242,1,12
6748,HANGING GLASS ETCHED TEALIGHT,3,100,0,100,0,1,0
6749,HANGING GLASS ETCHED TEALIGHT,4,1486,21,2200,714,1,42
6750,BLUE NEW BAROQUE CANDLESTICK CANDLE,6,232,2,300,68,1,4
6751,COOKING SET RETROSPOT,10,1712,19,2000,288,1,38
6752,KINGS CHOICE GIANT TUBE MATCHES,7,446,13,1400,954,1,26
6753,COSY HOUR GIANT TUBE MATCHES,2,532,5,600,68,1,10
6754,PLACE SETTING WHITE STAR,10,1733,22,2300,567,1,44
6755,HYACINTH BULB T-LIGHT CANDLES,8,597,5,600,3,1,10
6756,S/15 SILVER GLASS BAUBLES IN BAG,6,113,23,2400,2287,1,46
6757,FRENCH WC SIGN BLUE METAL,8,724,13,1400,676,1,26
6758,KINGS CHOICE GIANT TUBE MATCHES,1,1272,14,1500,228,1,28
6759,77 SWEETHEART FAIRY CAKE CASES,9,229,2,300,71,1,4
6760,ASSORTED COLOUR BIRD ORNAMENT,1,1466,19,2000,534,1,38
6761,FAIRY SOAP SOAP HOLDER,2,1314,20,2100,786,1,40
6762,GREEN GIANT GARDEN THERMOMETER,1,959,11,1200,241,1,22
6763,IVORY GIANT GARDEN THERMOMETER,1,354,8,900,546,1,16
6764,BLUE GIANT GARDEN THERMOMETER,2,976,21,2200,1224,1,42
6765,PACK OF 60 PINK PAISLEY CAKE CASES,6,618,11,1200,582,1,22
6766,RETROSPOT HEART HOT WATER BOTTLE,7,345,21,2200,1855,1,42
6767,CHICK GREY HOT WATER BOTTLE,3,1126,11,1200,74,1,22
6768,VICTORIAN SEWING BOX SMALL ,8,276,13,1400,1124,1,26
6769,VICTORIAN SEWING BOX MEDIUM,2,492,13,1400,908,1,26
6770,SET/10 RED POLKADOT PARTY CANDLES,6,146,16,1700,1554,1,32
6771,WASHROOM METAL SIGN,10,2402,24,2500,98,1,48
6772,BLACK SWEETHEART BRACELET,6,360,14,1500,1140,1,28
6773,DIAMANTE HAIR GRIP PACK/2 BLACK DIA,3,440,9,1000,560,1,18
6774,BLACK DIAMANTE EXPANDABLE RING,5,264,10,1100,836,1,20
6775,DIAMANTE HAIR GRIP PACK/2 RUBY,10,757,12,1300,543,1,24
6776,DIAMANTE HAIR GRIP PACK/2 MONTANA,9,554,6,700,146,1,12
6777,BLUE SWEETHEART BRACELET,7,161,3,400,239,1,6
6778,PINK SWEETHEART BRACELET,9,1329,15,1600,271,1,30
6779,PURPLE SWEETHEART BRACELET,9,571,16,1700,1129,1,32
6780,JUMBO BAG PINK POLKADOT,8,110,1,200,90,1,2
6781,JUMBO BAG RED RETROSPOT,3,984,12,1300,316,1,24
6782,ASSORTED COLOUR BIRD ORNAMENT,8,241,12,1300,1059,1,24
6783,PAPER CHAIN KIT 50'S CHRISTMAS ,7,404,17,1800,1396,1,34
6784,RIBBON REEL CHRISTMAS PRESENT ,2,200,12,1300,1100,1,24
6785,FIRST AID TIN,2,512,8,900,388,1,16
6786,MAKE YOUR OWN MONSOON CARD KIT,1,1533,24,2500,967,1,48
6787,PACK OF 12 HEARTS DESIGN TISSUES ,9,1544,16,1700,156,1,32
6788,PACK OF 12 RED RETROSPOT TISSUES ,7,1275,15,1600,325,1,30
6789,SOLDIERS EGG CUP ,2,2010,24,2500,490,1,48
6790,HEART IVORY TRELLIS SMALL,1,248,3,400,152,1,6
6791,HEART FILIGREE DOVE  SMALL,10,100,0,100,0,1,0
6792,HEART FILIGREE DOVE LARGE,4,1120,13,1400,280,1,26
6793,PACK 3 BOXES BIRD PANNETONE ,6,287,15,1600,1313,1,30
6794,PACK 3 BOXES CHRISTMAS PANNETONE,5,667,6,700,33,1,12
6795,SMALL POPCORN HOLDER,6,225,2,300,75,1,4
6796,PACK OF 60 PINK PAISLEY CAKE CASES,1,314,3,400,86,1,6
6797,SET OF 6 SOLDIER SKITTLES,8,461,16,1700,1239,1,32
6798,SWIRLY CIRCULAR RUBBERS IN BAG,6,452,14,1500,1048,1,28
6799,VINTAGE PAISLEY STATIONERY SET,8,481,21,2200,1719,1,42
6800,PAPER CHAIN KIT VINTAGE CHRISTMAS,3,354,7,800,446,1,14
6801,SET/10 BLUE POLKADOT PARTY CANDLES,10,183,7,800,617,1,14
6802,RIBBON REEL SOCKS AND MITTENS,8,597,10,1100,503,1,20
6803,65 CAKE CASES VINTAGE CHRISTMAS,6,147,14,1500,1353,1,28
6804,CHRISTMAS METAL TAGS ASSORTED ,1,100,0,100,0,1,0
6805,CHRISTMAS TREE T-LIGHT HOLDER,1,568,9,1000,432,1,18
6806,STAR  T-LIGHT HOLDER ,8,2221,25,2600,379,1,50
6807,HEART T-LIGHT HOLDER ,5,1632,25,2600,968,1,50
6808,MINI FUNKY DESIGN TAPES,10,1063,12,1300,237,1,24
6809,SET OF 6 T-LIGHTS SNOWMEN,10,873,9,1000,127,1,18
6810,STAR WOODEN CHRISTMAS DECORATION,4,252,13,1400,1148,1,26
6811,WOODEN HEART CHRISTMAS SCANDINAVIAN,2,623,15,1600,977,1,30
6812,CHRISTMAS RETROSPOT TREE WOOD,2,877,21,2200,1323,1,42
6813,SET OF 6 T-LIGHTS SANTA,6,1053,15,1600,547,1,30
6814,SET/9 CHRISTMAS T-LIGHTS SCENTED ,1,950,9,1000,50,1,18
6815,BLUE ROSE FABRIC MIRROR,8,100,0,100,0,1,0
6816,THREE CANVAS LUGGAGE TAGS,1,1069,21,2200,1131,1,42
6817,RETROSPOT PARTY BAG + STICKER SET,9,101,10,1100,999,1,20
6818,PLASTERS IN TIN VINTAGE PAISLEY ,4,163,1,200,37,1,2
6819,RETROSPOT SMALL TUBE MATCHES,2,1210,23,2400,1190,1,46
6820,HAND WARMER SCOTTY DOG DESIGN,5,198,12,1300,1102,1,24
6821,3D CHRISTMAS STAMPS STICKERS ,5,280,7,800,520,1,14
6822,HAND WARMER SCOTTY DOG DESIGN,2,128,1,200,72,1,2
6823,HAND WARMER SCOTTY DOG DESIGN,9,1686,24,2500,814,1,48
6824,CLOTHES PEGS RETROSPOT PACK 29,10,138,1,200,62,1,2
6825,41 FOIL HEART CAKE CASES,3,884,11,1200,316,1,22
6826,CHRISTMAS METAL TAGS ASSORTED ,8,1196,12,1300,104,1,24
6827,PACK OF 6 SWEETIE GIFT BOXES,9,1109,19,2000,891,1,38
6828,PACK OF 72 RETROSPOT CAKE CASES,5,448,20,2100,1652,1,40
6829,PACK OF 72 RETROSPOT CAKE CASES,1,437,4,500,63,1,8
6830,PACK OF 6 BIRDY GIFT TAGS,7,186,1,200,14,1,2
6831,SET/10 RED POLKADOT PARTY CANDLES,10,693,11,1200,507,1,22
6832,SET/10 PINK POLKADOT PARTY CANDLES,4,162,5,600,438,1,10
6833,SET OF 3 NOTEBOOKS IN PARCEL,1,1575,16,1700,125,1,32
6834,STAR  T-LIGHT HOLDER ,9,911,20,2100,1189,1,40
6835,CINAMMON SET OF 9 T-LIGHTS,10,478,7,800,322,1,14
6836,ORANGE SCENTED SET/9 T-LIGHTS,8,226,8,900,674,1,16
6837,RIBBON REEL STRIPES DESIGN ,4,989,16,1700,711,1,32
6838,SET OF 2 TINS JARDIN DE PROVENCE,10,1554,15,1600,46,1,30
6839,MAKE YOUR OWN PLAYTIME CARD KIT,1,1068,16,1700,632,1,32
6840,DINOSAURS  WRITING SET ,2,1364,20,2100,736,1,40
6841,BALLOONS  WRITING SET ,7,398,17,1800,1402,1,34
6842,SKULLS WRITING SET ,2,784,22,2300,1516,1,44
6843,VINTAGE PAISLEY STATIONERY SET,6,243,9,1000,757,1,18
6844,COSY SLIPPER SHOES SMALL  RED ,3,162,2,300,138,1,4
6845,DOORMAT BLACK FLOCK ,2,272,22,2300,2028,1,44
6846,JUMBO  BAG BAROQUE BLACK WHITE,8,146,1,200,54,1,2
6847,JAM MAKING SET WITH JARS,7,716,7,800,84,1,14
6848,ORANGE SCENTED SET/9 T-LIGHTS,10,356,5,600,244,1,10
6849,CINAMMON SET OF 9 T-LIGHTS,4,113,2,300,187,1,4
6850,HAND WARMER SCOTTY DOG DESIGN,1,180,14,1500,1320,1,28
6851,CHRISTMAS DECOUPAGE CANDLE,5,1017,17,1800,783,1,34
6852,HEART T-LIGHT HOLDER ,5,165,1,200,35,1,2
6853,GROW YOUR OWN BASIL IN ENAMEL MUG,6,1387,15,1600,213,1,30
6854,OFFICE MUG WARMER POLKADOT,1,1540,25,2600,1060,1,50
6855,SMALL POPCORN HOLDER,9,492,25,2600,2108,1,50
6856,JUMBO BAG DOLLY GIRL DESIGN,7,508,17,1800,1292,1,34
6857,JAM MAKING SET WITH JARS,2,267,15,1600,1333,1,30
6858,JAM MAKING SET PRINTED,2,284,17,1800,1516,1,34
6859,SMALL GLASS HEART TRINKET POT,7,420,4,500,80,1,8
6860,RED WOOLLY HOTTIE WHITE HEART.,6,834,18,1900,1066,1,36
6861,BLACK RECORD COVER FRAME,6,100,0,100,0,1,0
6862,"RECORD FRAME 7"" SINGLE SIZE ",6,156,6,700,544,1,12
6863,41 PENCILS TUBE RED RETROSPOT,1,1949,23,2400,451,1,46
6864,41 PENCILS TUBE WOODLAND,5,239,22,2300,2061,1,44
6865,SET OF 6 SOLDIER SKITTLES,9,178,24,2500,2322,1,48
6866,ROCKING HORSE RED CHRISTMAS ,8,1155,13,1400,245,1,26
6867,CHRISTMAS GINGHAM HEART,4,134,1,200,66,1,2
6868,CHRISTMAS GINGHAM STAR,8,354,13,1400,1046,1,26
6869,HAND WARMER UNION JACK,9,155,1,200,45,1,2
6870,HAND WARMER RED RETROSPOT,6,632,22,2300,1668,1,44
6871,REGENCY CAKESTAND 3 TIER,7,579,12,1300,721,1,24
6872,JUMBO SHOPPER VINTAGE RED PAISLEY,5,127,9,1000,873,1,18
6873,RIBBON REEL SNOWY VILLAGE,3,2150,24,2500,350,1,48
6874,VINTAGE UNION JACK BUNTING,3,497,14,1500,1003,1,28
6875,JAM MAKING SET WITH JARS,8,1431,20,2100,669,1,40
6876,RIBBON REEL STRIPES DESIGN ,3,336,3,400,64,1,6
6877,RETRO LONGBOARD IRONING BOARD COVER,4,879,21,2200,1321,1,42
6878,3D DOG PICTURE PLAYING CARDS,6,1495,23,2400,905,1,46
6879,RETROSPOT CIGAR BOX MATCHES ,5,711,16,1700,989,1,32
6880,SET/9 CHRISTMAS T-LIGHTS SCENTED ,8,210,12,1300,1090,1,24
6881,ROTATING SILVER ANGELS T-LIGHT HLDR,6,234,15,1600,1366,1,30
6882,ROTATING SILVER ANGELS T-LIGHT HLDR,4,1259,23,2400,1141,1,46
6883,SAVE THE PLANET COTTON TOTE BAG,9,546,9,1000,454,1,18
6884,SET OF 20 VINTAGE CHRISTMAS NAPKINS,3,366,3,400,34,1,6
6885,PAPER BUNTING WHITE LACE,6,571,5,600,29,1,10
6886,GENTLEMAN SHIRT REPAIR KIT ,1,229,7,800,571,1,14
6887,CARD I LOVE LONDON ,1,940,9,1000,60,1,18
6888,PAPER CHAIN KIT VINTAGE CHRISTMAS,1,1388,18,1900,512,1,36
6889,MIRRORED WALL ART FOXY,2,143,13,1400,1257,1,26
6890,MIRRORED WALL ART GENTS,2,1238,23,2400,1162,1,46
6891,AIRLINE BAG VINTAGE JET SET WHITE,10,588,6,700,112,1,12
6892,JAM MAKING SET PRINTED,8,248,18,1900,1652,1,36
6893,POTTING SHED SOW 'N' GROW SET,7,388,6,700,312,1,12
6894,BABUSHKA LIGHTS STRING OF 15,9,596,17,1800,1204,1,34
6895,REX CASH+CARRY JUMBO SHOPPER,7,113,3,400,287,1,6
6896,AIRLINE BAG VINTAGE WORLD CHAMPION ,2,170,2,300,130,1,4
6897,HAND WARMER BIRD DESIGN,5,442,11,1200,758,1,22
6898,CHRISTMAS CRAFT LITTLE FRIENDS,10,356,6,700,344,1,12
6899,PINK HEARTS PAPER GARLAND,1,1143,25,2600,1457,1,50
6900,POTTING SHED SEED ENVELOPES,5,525,5,600,75,1,10
6901,HI TEC ALPINE HAND WARMER,9,401,19,2000,1599,1,38
6902,FELTCRAFT CHRISTMAS FAIRY,8,671,11,1200,529,1,22
6903,HI TEC ALPINE HAND WARMER,5,2010,21,2200,190,1,42
6904,ROTATING SILVER ANGELS T-LIGHT HLDR,3,1203,15,1600,397,1,30
6905,8 STRIPEY MICE FELTCRAFT,5,152,4,500,348,1,8
6906,FELTCRAFT 6 FLOWER FRIENDS,8,487,15,1600,1113,1,30
6907,CHRISTMAS CRAFT LITTLE FRIENDS,4,552,19,2000,1448,1,38
6908,VINTAGE UNION JACK CUSHION COVER,1,422,16,1700,1278,1,32
6909,POLYESTER FILLER PAD 45x45cm,3,150,1,200,50,1,2
6910,DOLLY GIRL LUNCH BOX,4,2056,20,2100,44,1,40
6911,PACK OF 12 LONDON TISSUES ,7,1070,12,1300,230,1,24
6912,CARD DOLLY GIRL ,1,391,8,900,509,1,16
6913,CARD BILLBOARD FONT,2,192,1,200,8,1,2
6914,RAINY LADIES BIRTHDAY CARD,6,345,13,1400,1055,1,26
6915,GREY HEART HOT WATER BOTTLE,2,1167,19,2000,833,1,38
6916,RED WOOLLY HOTTIE WHITE HEART.,3,1366,15,1600,234,1,30
6917,RED WHITE SCARF  HOT WATER BOTTLE,8,291,5,600,309,1,10
6918, SET 2 TEA TOWELS I LOVE LONDON ,1,1313,20,2100,787,1,40
6919,SET OF 2 TEA TOWELS APPLE AND PEARS,2,1135,18,1900,765,1,36
6920,SET/2 RED RETROSPOT TEA TOWELS ,5,696,6,700,4,1,12
6921,LOVE BUILDING BLOCK WORD,7,124,1,200,76,1,2
6922,HOME BUILDING BLOCK WORD,7,1648,24,2500,852,1,48
6923,ASSORTED COLOUR BIRD ORNAMENT,4,100,0,100,0,1,0
6924,LANTERN CREAM GAZEBO ,5,215,4,500,285,1,8
6925,BLUE BIRDHOUSE DECORATION,3,206,15,1600,1394,1,30
6926,WHITE HANGING HEART T-LIGHT HOLDER,4,358,6,700,342,1,12
6927,REGENCY CAKESTAND 3 TIER,3,818,16,1700,882,1,32
6928,ANTIQUE SILVER TEA GLASS ENGRAVED,5,1671,24,2500,829,1,48
6929,AGED GLASS SILVER T-LIGHT HOLDER,5,1396,16,1700,304,1,32
6930,JAM MAKING SET WITH JARS,6,110,3,400,290,1,6
6931,HAND WARMER OWL DESIGN,8,201,10,1100,899,1,20
6932,SET OF 2 WOODEN MARKET CRATES,5,409,18,1900,1491,1,36
6933,SET OF 6 T-LIGHTS TOADSTOOLS,7,175,1,200,25,1,2
6934,HAND WARMER UNION JACK,9,568,5,600,32,1,10
6935,HAND WARMER SCOTTY DOG DESIGN,4,783,15,1600,817,1,30
6936,CLASSIC FRENCH STYLE BASKET NATURAL,5,1948,21,2200,252,1,42
6937,CRAZY DAISY HEART DECORATION,2,422,9,1000,578,1,18
6938,GIN + TONIC DIET METAL SIGN,7,1428,15,1600,172,1,30
6939,IVORY GIANT GARDEN THERMOMETER,4,247,6,700,453,1,12
6940,CARD HOLDER GINGHAM HEART,1,100,0,100,0,1,0
6941,SMALL STRIPES CHOCOLATE GIFT BAG ,2,262,3,400,138,1,6
6942,S/6 WOODEN SKITTLES IN COTTON BAG,10,1158,12,1300,142,1,24
6943,HAND WARMER RED RETROSPOT,3,1297,14,1500,203,1,28
6944,HAND WARMER UNION JACK,5,500,21,2200,1700,1,42
6945,FRENCH WC SIGN BLUE METAL,3,110,1,200,90,1,2
6946,PINK UNION JACK  LUGGAGE TAG,7,924,10,1100,176,1,20
6947,"TRAY, BREAKFAST IN BED",6,347,21,2200,1853,1,42
6948,PIZZA PLATE IN BOX,1,119,4,500,381,1,8
6949,HEART OF WICKER LARGE,7,100,0,100,0,1,0
6950,PINK HEART DOTS HOT WATER BOTTLE,3,606,23,2400,1794,1,46
6951,PLACE SETTING WHITE HEART,2,2404,25,2600,196,1,50
6952,SET OF 4 NAPKIN CHARMS LEAVES   ,9,1323,22,2300,977,1,44
6953,SET OF 4 NAPKIN CHARMS STARS   ,5,189,14,1500,1311,1,28
6954,SET OF 4 NAPKIN CHARMS CUTLERY,8,467,19,2000,1533,1,38
6955,CARAVAN SQUARE TISSUE BOX,6,858,15,1600,742,1,30
6956,PLASTERS IN TIN SKULLS,9,611,11,1200,589,1,22
6957,PLASTERS IN TIN SPACEBOY,7,176,7,800,624,1,14
6958,BUTTON BOX ,4,425,4,500,75,1,8
6959,PLASTERS IN TIN VINTAGE PAISLEY ,6,884,14,1500,616,1,28
6960,17 MESSAGE CARDS WITH ENVELOPES,9,118,1,200,82,1,2
6961,SMALL RED BABUSHKA NOTEBOOK ,6,751,25,2600,1849,1,50
6962,CUPCAKE LACE PAPER SET 11,3,796,9,1000,204,1,18
6963,PACK 3 BOXES CHRISTMAS PANNETONE,10,172,8,900,728,1,16
6964,HERB MARKER MINT,6,1066,12,1300,234,1,24
6965,HERB MARKER ROSEMARY,3,1051,18,1900,849,1,36
6966,HERB MARKER BASIL,2,586,9,1000,414,1,18
6967,HERB MARKER CHIVES ,6,267,5,600,333,1,10
6968,HERB MARKER PARSLEY,5,1087,23,2400,1313,1,46
6969,HERB MARKER THYME,8,276,8,900,624,1,16
6970,WHITE HANGING HEART T-LIGHT HOLDER,4,1666,16,1700,34,1,32
6971,METAL MERRY CHRISTMAS WREATH,10,256,12,1300,1044,1,24
6972,WHITE CHRISTMAS GARLAND STARS TREES,10,112,4,500,388,1,8
6973,RETROSPOT SMALL TUBE MATCHES,9,778,9,1000,222,1,18
6974,RETROSPOT GIANT TUBE MATCHES,3,295,8,900,605,1,16
6975,PLACE SETTING WHITE STAR,7,1243,15,1600,357,1,30
6976,GROW YOUR OWN BASIL IN ENAMEL MUG,4,187,1,200,13,1,2
6977,41 FOIL STAR CAKE CASES ,8,481,5,600,119,1,10
6978,41 FOIL HEART CAKE CASES,4,487,13,1400,913,1,26
6979,PACK OF 6 SWEETIE GIFT BOXES,9,180,23,2400,2220,1,46
6980,PACK OF 6 HANDBAG GIFT BOXES,10,100,0,100,0,1,0
6981,GARLAND WOODEN HAPPY EASTER,3,350,3,400,50,1,6
6982,CALENDAR PAPER CUT DESIGN,1,853,17,1800,947,1,34
6983,CALENDAR IN SEASON DESIGN,9,176,2,300,124,1,4
6984,SMALL POPCORN HOLDER,7,128,2,300,172,1,4
6985,BLUE PAISLEY TISSUE BOX,8,592,13,1400,808,1,26
6986,HEART OF WICKER SMALL,5,505,11,1200,695,1,22
6987,SKULLS SQUARE TISSUE BOX,6,100,0,100,0,1,0
6988,SKULLS SQUARE TISSUE BOX,9,2143,24,2500,357,1,48
6989,WHITE HANGING HEART T-LIGHT HOLDER,1,483,4,500,17,1,8
6990,WHITE METAL LANTERN,3,154,21,2200,2046,1,42
6991,CREAM CUPID HEARTS COAT HANGER,8,100,0,100,0,1,0
6992,KNITTED UNION FLAG HOT WATER BOTTLE,9,321,17,1800,1479,1,34
6993,RED WOOLLY HOTTIE WHITE HEART.,5,100,0,100,0,1,0
6994,SET 7 BABUSHKA NESTING BOXES,9,646,10,1100,454,1,20
6995,GLASS STAR FROSTED T-LIGHT HOLDER,10,557,12,1300,743,1,24
6996,HAND WARMER UNION JACK,2,1582,25,2600,1018,1,50
6997,HAND WARMER RED POLKA DOT,3,488,4,500,12,1,8
6998,ASSORTED COLOUR BIRD ORNAMENT,2,2205,24,2500,295,1,48
6999,POPPY'S PLAYHOUSE BEDROOM ,9,1539,18,1900,361,1,36
7000,POPPY'S PLAYHOUSE KITCHEN,8,313,3,400,87,1,6
7001,FELTCRAFT PRINCESS CHARLOTTE DOLL,6,483,8,900,417,1,16
7002,IVORY KNITTED MUG COSY ,9,682,11,1200,518,1,22
7003,BOX OF 6 ASSORTED COLOUR TEASPOONS,9,315,3,400,85,1,6
7004,BOX OF VINTAGE JIGSAW BLOCKS ,4,645,12,1300,655,1,24
7005,BOX OF VINTAGE ALPHABET BLOCKS,9,618,9,1000,382,1,18
7006,HOME BUILDING BLOCK WORD,10,232,6,700,468,1,12
7007,LOVE BUILDING BLOCK WORD,3,1842,24,2500,658,1,48
7008,RECIPE BOX WITH METAL HEART,7,234,4,500,266,1,8
7009,DOORMAT NEW ENGLAND,8,842,22,2300,1458,1,44
7010,JAM MAKING SET WITH JARS,5,212,3,400,188,1,6
7011,RED COAT RACK PARIS FASHION,7,100,0,100,0,1,0
7012,YELLOW COAT RACK PARIS FASHION,8,512,6,700,188,1,12
7013,BLUE COAT RACK PARIS FASHION,2,891,12,1300,409,1,24
7014,BATH BUILDING BLOCK WORD,9,634,8,900,266,1,16
7015,ALARM CLOCK BAKELIKE PINK,10,209,5,600,391,1,10
7016,ALARM CLOCK BAKELIKE RED ,8,1336,20,2100,764,1,40
7017,ALARM CLOCK BAKELIKE GREEN,10,306,22,2300,1994,1,44
7018,PANDA AND BUNNIES STICKER SHEET,2,723,24,2500,1777,1,48
7019,STARS GIFT TAPE ,5,184,5,600,416,1,10
7020,INFLATABLE POLITICAL GLOBE ,2,976,9,1000,24,1,18
7021,VINTAGE HEADS AND TAILS CARD GAME ,6,899,12,1300,401,1,24
7022,SET/2 RED RETROSPOT TEA TOWELS ,9,626,6,700,74,1,12
7023,ROUND SNACK BOXES SET OF4 WOODLAND ,8,361,14,1500,1139,1,28
7024,SPACEBOY LUNCH BOX ,5,1299,22,2300,1001,1,44
7025,LUNCH BOX I LOVE LONDON,4,1476,17,1800,324,1,34
7026,CIRCUS PARADE LUNCH BOX ,8,559,10,1100,541,1,20
7027,CHARLOTTE BAG DOLLY GIRL DESIGN,10,645,12,1300,655,1,24
7028,RED TOADSTOOL LED NIGHT LIGHT,9,259,2,300,41,1,4
7029, SET 2 TEA TOWELS I LOVE LONDON ,8,976,9,1000,24,1,18
7030,VINTAGE SEASIDE JIGSAW PUZZLES,1,1147,18,1900,753,1,36
7031,MINI JIGSAW CIRCUS PARADE ,6,274,18,1900,1626,1,36
7032,MINI JIGSAW SPACEBOY,4,1259,21,2200,941,1,42
7033,MINI PAINT SET VINTAGE ,6,321,5,600,279,1,10
7034,POSTAGE,3,205,14,1500,1295,1,28
7035,PAPER CHAIN KIT 50'S CHRISTMAS ,4,1382,14,1500,118,1,28
7036,HAND WARMER RED POLKA DOT,1,537,21,2200,1663,1,42
7037,HAND WARMER UNION JACK,5,153,4,500,347,1,8
7038,WHITE HANGING HEART T-LIGHT HOLDER,7,741,25,2600,1859,1,50
7039,WHITE METAL LANTERN,5,328,3,400,72,1,6
7040,CREAM CUPID HEARTS COAT HANGER,10,1657,16,1700,43,1,32
7041,EDWARDIAN PARASOL RED,3,100,0,100,0,1,0
7042,RETRO COFFEE MUGS ASSORTED,1,450,8,900,450,1,16
7043,SAVE THE PLANET MUG,9,728,7,800,72,1,14
7044,VINTAGE BILLBOARD DRINK ME MUG,6,1199,15,1600,401,1,30
7045,VINTAGE BILLBOARD LOVE/HATE MUG,3,467,11,1200,733,1,22
7046,WOOD 2 DRAWER CABINET WHITE FINISH,8,326,22,2300,1974,1,44
7047,WOOD S/3 CABINET ANT WHITE FINISH,1,1251,25,2600,1349,1,50
7048,WOODEN PICTURE FRAME WHITE FINISH,2,534,6,700,166,1,12
7049,WOODEN FRAME ANTIQUE WHITE ,8,427,22,2300,1873,1,44
7050,KNITTED UNION FLAG HOT WATER BOTTLE,2,1299,13,1400,101,1,26
7051,RED WOOLLY HOTTIE WHITE HEART.,3,918,23,2400,1482,1,46
7052,SET 7 BABUSHKA NESTING BOXES,9,206,20,2100,1894,1,40
7053,GLASS STAR FROSTED T-LIGHT HOLDER,10,1422,20,2100,678,1,40
7054,VICTORIAN SEWING BOX LARGE,4,100,0,100,0,1,0
7055,WHITE HANGING HEART T-LIGHT HOLDER,1,818,15,1600,782,1,30
7056,WHITE METAL LANTERN,2,1473,14,1500,27,1,28
7057,CREAM CUPID HEARTS COAT HANGER,7,253,4,500,247,1,8
7058,EDWARDIAN PARASOL RED,3,1295,12,1300,5,1,24
7059,RETRO COFFEE MUGS ASSORTED,6,1791,25,2600,809,1,50
7060,SAVE THE PLANET MUG,10,2043,21,2200,157,1,42
7061,VINTAGE BILLBOARD DRINK ME MUG,10,1339,14,1500,161,1,28
7062,VINTAGE BILLBOARD LOVE/HATE MUG,10,466,16,1700,1234,1,32
7063,WOOD 2 DRAWER CABINET WHITE FINISH,1,912,16,1700,788,1,32
7064,WOOD S/3 CABINET ANT WHITE FINISH,3,587,5,600,13,1,10
7065,WOODEN PICTURE FRAME WHITE FINISH,7,220,2,300,80,1,4
7066,WOODEN FRAME ANTIQUE WHITE ,1,282,11,1200,918,1,22
7067,KNITTED UNION FLAG HOT WATER BOTTLE,6,117,2,300,183,1,4
7068,RED WOOLLY HOTTIE WHITE HEART.,9,662,24,2500,1838,1,48
7069,SET 7 BABUSHKA NESTING BOXES,10,973,14,1500,527,1,28
7070,GLASS STAR FROSTED T-LIGHT HOLDER,5,1839,18,1900,61,1,36
7071,HOT WATER BOTTLE TEA AND SYMPATHY,4,650,6,700,50,1,12
7072,RED HANGING HEART T-LIGHT HOLDER,8,355,14,1500,1145,1,28
7073,HAND WARMER RED POLKA DOT,5,1109,11,1200,91,1,22
7074,HAND WARMER UNION JACK,6,2131,22,2300,169,1,44
7075,JUMBO BAG PINK POLKADOT,4,454,13,1400,946,1,26
7076,JUMBO  BAG BAROQUE BLACK WHITE,5,1056,14,1500,444,1,28
7077,JUMBO BAG CHARLIE AND LOLA TOYS,4,263,7,800,537,1,14
7078,STRAWBERRY CHARLOTTE BAG,8,274,7,800,526,1,14
7079,RED 3 PIECE RETROSPOT CUTLERY SET,10,1562,19,2000,438,1,38
7080,BLUE 3 PIECE POLKADOT CUTLERY SET,4,303,9,1000,697,1,18
7081,SET/6 RED SPOTTY PAPER PLATES,3,454,23,2400,1946,1,46
7082,LUNCH BAG RED RETROSPOT,9,2352,23,2400,48,1,46
7083,STRAWBERRY LUNCH BOX WITH CUTLERY,1,2063,25,2600,537,1,50
7084,LUNCH BOX WITH CUTLERY RETROSPOT ,6,288,10,1100,812,1,20
7085,PACK OF 72 RETROSPOT CAKE CASES,9,100,0,100,0,1,0
7086,PACK OF 60 DINOSAUR CAKE CASES,3,1235,16,1700,465,1,32
7087,PACK OF 60 PINK PAISLEY CAKE CASES,4,190,2,300,110,1,4
7088,66 TEATIME FAIRY CAKE CASES,8,100,0,100,0,1,0
7089,TOMATO CHARLIE+LOLA COASTER SET,2,1353,16,1700,347,1,32
7090,CHARLIE & LOLA WASTEPAPER BIN FLORA,9,917,20,2100,1183,1,40
7091,RED CHARLIE+LOLA PERSONAL DOORSIGN,2,2075,21,2200,125,1,42
7092,JUMBO STORAGE BAG SUKI,9,597,11,1200,603,1,22
7093,JUMBO BAG PINK VINTAGE PAISLEY,3,283,14,1500,1217,1,28
7094,JAM MAKING SET PRINTED,5,877,9,1000,123,1,18
7095,RETROSPOT TEA SET CERAMIC 11 PC ,8,205,12,1300,1095,1,24
7096,GIRLY PINK TOOL SET,2,813,11,1200,387,1,22
7097,JUMBO SHOPPER VINTAGE RED PAISLEY,10,345,6,700,355,1,12
7098,"AIRLINE LOUNGE,METAL SIGN",2,335,10,1100,765,1,20
7099,WHITE SPOT RED CERAMIC DRAWER KNOB,7,327,13,1400,1073,1,26
7100,RED DRAWER KNOB ACRYLIC EDWARDIAN,10,171,4,500,329,1,8
7101,CLEAR DRAWER KNOB ACRYLIC EDWARDIAN,3,1864,25,2600,736,1,50
7102,PHOTO CLIP LINE,10,1541,16,1700,159,1,32
7103,FELT EGG COSY CHICKEN,8,135,6,700,565,1,12
7104,PIGGY BANK RETROSPOT ,1,100,0,100,0,1,0
7105,SKULL SHOULDER BAG,9,187,1,200,13,1,2
7106,YOU'RE CONFUSING ME METAL SIGN ,8,980,15,1600,620,1,30
7107,COOK WITH WINE METAL SIGN ,1,1411,20,2100,689,1,40
7108,GIN + TONIC DIET METAL SIGN,10,455,11,1200,745,1,22
7109,YELLOW BREAKFAST CUP AND SAUCER,5,123,1,200,77,1,2
7110,PINK BREAKFAST CUP AND SAUCER ,8,375,15,1600,1225,1,30
7111,PAPER CHAIN KIT 50'S CHRISTMAS ,1,920,19,2000,1080,1,38
7112,PAPER CHAIN KIT RETROSPOT,3,143,2,300,157,1,4
7113,SMALL HEART FLOWERS HOOK ,3,980,10,1100,120,1,20
7114,PHOTO CLIP LINE,8,489,8,900,411,1,16
7115,TEA TIME DES TEA COSY,5,186,1,200,14,1,2
7116,FELT EGG COSY WHITE RABBIT ,8,1395,13,1400,5,1,26
7117,ZINC WILLIE WINKIE  CANDLE STICK,1,1221,24,2500,1279,1,48
7118,CERAMIC CHERRY CAKE MONEY BANK,6,100,0,100,0,1,0
7119,RETROSPOT LARGE MILK JUG,9,100,0,100,0,1,0
7120,SET OF 6 FUNKY BEAKERS,8,100,0,100,0,1,0
7121,EDWARDIAN PARASOL BLACK,10,570,9,1000,430,1,18
7122,EDWARDIAN PARASOL NATURAL,3,352,7,800,448,1,14
7123,CERAMIC STRAWBERRY CAKE MONEY BANK,5,936,20,2100,1164,1,40
7124,BLUE OWL SOFT TOY,8,1086,15,1600,514,1,30
7125,BALLOON ART MAKE YOUR OWN FLOWERS,5,214,16,1700,1486,1,32
7126,RED TOADSTOOL LED NIGHT LIGHT,7,2491,25,2600,109,1,50
7127,GLASS CLOCHE SMALL,3,1179,21,2200,1021,1,42
7128,GUMBALL MONOCHROME COAT RACK,7,452,8,900,448,1,16
7129,DOORMAT FANCY FONT HOME SWEET HOME,8,1712,25,2600,888,1,50
7130,Discount,3,1899,23,2400,501,1,46
7131,INFLATABLE POLITICAL GLOBE ,5,185,2,300,115,1,4
7132,VINTAGE SNAKES & LADDERS,8,474,5,600,126,1,10
7133,CHOCOLATE CALCULATOR,10,1413,21,2200,787,1,42
7134,JUMBO SHOPPER VINTAGE RED PAISLEY,9,1137,13,1400,263,1,26
7135,RECYCLING BAG RETROSPOT ,1,2265,24,2500,235,1,48
7136,TOY TIDY PINK POLKADOT,1,1797,18,1900,103,1,36
7137,ANTIQUE GLASS DRESSING TABLE POT,7,198,1,200,2,1,2
7138,ALARM CLOCK BAKELIKE GREEN,7,1889,24,2500,611,1,48
7139,IVORY GIANT GARDEN THERMOMETER,3,115,4,500,385,1,8
7140,9 TIER CAKE TIN GREEN AND CREAM,10,801,10,1100,299,1,20
7141,9 TIER CAKE TIN RED AND CREAM,2,100,0,100,0,1,0
7142,SET 3 WICKER OVAL BASKETS W LIDS,7,555,10,1100,545,1,20
7143,SET OF 3 COLOURED  FLYING DUCKS,2,207,11,1200,993,1,22
7144,WOOD BLACK BOARD ANT WHITE FINISH,3,367,10,1100,733,1,20
7145,COLOUR GLASS T-LIGHT HOLDER HANGING,9,323,8,900,577,1,16
7146,HANGING METAL HEART LANTERN,9,1647,25,2600,953,1,50
7147,HANGING MEDINA LANTERN SMALL,4,302,6,700,398,1,12
7148,NATURAL SLATE HEART CHALKBOARD ,7,385,3,400,15,1,6
7149,HEART OF WICKER SMALL,6,2243,23,2400,157,1,46
7150,HEART OF WICKER LARGE,8,1565,19,2000,435,1,38
7151,WHITE LOVEBIRD LANTERN,9,639,11,1200,561,1,22
7152,CLASSIC METAL BIRDCAGE PLANT HOLDER,9,140,7,800,660,1,14
7153,CREAM HEART CARD HOLDER,5,158,1,200,42,1,2
7154,ENAMEL FLOWER JUG CREAM,1,382,13,1400,1018,1,26
7155,ENAMEL FIRE BUCKET CREAM,8,603,9,1000,397,1,18
7156,ENAMEL BREAD BIN CREAM,4,1542,17,1800,258,1,34
7157,SET 3 WICKER OVAL BASKETS W LIDS,9,292,6,700,408,1,12
7158,JAM MAKING SET PRINTED,1,1098,10,1100,2,1,20
7159,JAM MAKING SET WITH JARS,4,100,0,100,0,1,0
7160,JUMBO BAG DOLLY GIRL DESIGN,7,182,15,1600,1418,1,30
7161,TRADITIONAL CHRISTMAS RIBBONS,3,113,5,600,487,1,10
7162,ORGANISER WOOD ANTIQUE WHITE ,6,726,9,1000,274,1,18
7163,LUNCH BAG DOLLY GIRL DESIGN,3,353,3,400,47,1,6
7164,WHITE WIRE EGG HOLDER,8,391,11,1200,809,1,22
7165,JUMBO  BAG BAROQUE BLACK WHITE,7,165,2,300,135,1,4
7166,JUMBO BAG RED RETROSPOT,4,810,21,2200,1390,1,42
7167,CHILLI LIGHTS,1,366,16,1700,1334,1,32
7168,LIGHT GARLAND BUTTERFILES PINK,4,188,1,200,12,1,2
7169,WOODEN OWLS LIGHT GARLAND ,6,423,10,1100,677,1,20
7170,FAIRY TALE COTTAGE NIGHTLIGHT,2,1823,19,2000,177,1,38
7171,RED TOADSTOOL LED NIGHT LIGHT,1,526,5,600,74,1,10
7172,HOME BUILDING BLOCK WORD,1,2164,21,2200,36,1,42
7173,LOVE BUILDING BLOCK WORD,4,622,21,2200,1578,1,42
7174,DOORMAT FANCY FONT HOME SWEET HOME,1,434,7,800,366,1,14
7175,HOME SMALL WOOD LETTERS,9,125,10,1100,975,1,20
7176,GINGHAM HEART  DOORSTOP RED,3,462,21,2200,1738,1,42
7177,FIVE HEART HANGING DECORATION,8,571,23,2400,1829,1,46
7178,HANGING METAL HEART LANTERN,2,367,4,500,133,1,8
7179,ASSORTED BOTTLE TOP  MAGNETS ,1,1313,14,1500,187,1,28
7180,FRIDGE MAGNETS US DINER ASSORTED,1,725,22,2300,1575,1,44
7181,HOMEMADE JAM SCENTED CANDLES,3,295,4,500,205,1,8
7182,FRIDGE MAGNETS LES ENFANTS ASSORTED,7,635,16,1700,1065,1,32
7183,ROSE CARAVAN DOORSTOP,5,474,16,1700,1226,1,32
7184,HEART OF WICKER SMALL,4,211,7,800,589,1,14
7185,11 HOOK HANGER MAGIC TOADSTOOL,3,375,9,1000,625,1,18
7186,CHRISTMAS LIGHTS 10 REINDEER,3,268,9,1000,732,1,18
7187,VINTAGE UNION JACK CUSHION COVER,2,317,12,1300,983,1,24
7188,VINTAGE HEADS AND TAILS CARD GAME ,9,139,1,200,61,1,2
7189,SET OF 3 COLOURED  FLYING DUCKS,5,261,14,1500,1239,1,28
7190,SET OF 3 GOLD FLYING DUCKS,9,100,0,100,0,1,0
7191,RED RETROSPOT UMBRELLA,9,678,8,900,222,1,16
7192,BLACK/BLUE POLKADOT UMBRELLA,8,326,3,400,74,1,6
7193,RED DINER WALL CLOCK,9,447,7,800,353,1,14
7194,ALARM CLOCK BAKELIKE GREEN,10,1917,21,2200,283,1,42
7195,ALARM CLOCK BAKELIKE RED ,9,330,3,400,70,1,6
7196,BLUE DINER WALL CLOCK,1,257,3,400,143,1,6
7197,IVORY DINER WALL CLOCK,8,294,13,1400,1106,1,26
7198,LARGE HEART MEASURING SPOONS,9,739,16,1700,961,1,32
7199,SMALL HEART MEASURING SPOONS,8,617,10,1100,483,1,20
7200,CHRISTMAS LIGHTS 10 REINDEER,3,1527,16,1700,173,1,32
7201,JAM MAKING SET WITH JARS,1,1396,16,1700,304,1,32
7202,JAM MAKING SET PRINTED,9,701,12,1300,599,1,24
7203,JAM JAR WITH PINK LID,10,192,2,300,108,1,4
7204,JAM JAR WITH GREEN LID,3,100,0,100,0,1,0
7205,ROSE COTTAGE KEEPSAKE BOX ,2,1225,25,2600,1375,1,50
7206,HANGING HEART ZINC T-LIGHT HOLDER,5,721,7,800,79,1,14
7207,PAPER CHAIN KIT VINTAGE CHRISTMAS,8,202,12,1300,1098,1,24
7208,DISCO BALL CHRISTMAS DECORATION,5,1057,11,1200,143,1,22
7209,WHITE HANGING HEART T-LIGHT HOLDER,9,161,13,1400,1239,1,26
7210,SMALL POPCORN HOLDER,2,1166,22,2300,1134,1,44
7211,LARGE POPCORN HOLDER ,1,1296,12,1300,4,1,24
7212,RETROSPOT LARGE MILK JUG,6,525,23,2400,1875,1,46
7213,SET/20 RED RETROSPOT PAPER NAPKINS ,3,590,19,2000,1410,1,38
7214,SET/6 RED SPOTTY PAPER PLATES,4,1152,13,1400,248,1,26
7215,SET/6 RED SPOTTY PAPER CUPS,4,1386,25,2600,1214,1,50
7216,POLKADOT RAIN HAT ,5,606,7,800,194,1,14
7217,DELUXE SEWING KIT ,6,1286,12,1300,14,1,24
7218,RETROSPOT HEART HOT WATER BOTTLE,7,100,0,100,0,1,0
7219,KNITTED UNION FLAG HOT WATER BOTTLE,4,1155,21,2200,1045,1,42
7220,ENGLISH ROSE HOT WATER BOTTLE,3,413,17,1800,1387,1,34
7221,PHOTO CUBE,2,481,4,500,19,1,8
7222,HOMEMADE JAM SCENTED CANDLES,2,1973,20,2100,127,1,40
7223,JUMBO BAG RED RETROSPOT,4,2220,22,2300,80,1,44
7224,PLASTERS IN TIN CIRCUS PARADE ,3,114,3,400,286,1,6
7225,PACK OF 12 PINK PAISLEY TISSUES ,2,2055,20,2100,45,1,40
7226,PACK OF 12 BLUE PAISLEY TISSUES ,8,655,7,800,145,1,14
7227,PACK OF 12 RED RETROSPOT TISSUES ,9,100,5,600,500,1,10
7228,CHICK GREY HOT WATER BOTTLE,8,329,9,1000,671,1,18
7229,PLASTERS IN TIN VINTAGE PAISLEY ,5,1952,19,2000,48,1,38
7230,PLASTERS IN TIN SKULLS,7,219,21,2200,1981,1,42
7231,9 STRIPEY MICE FELTCRAFT,7,1614,21,2200,586,1,42
7232,SET OF 6 SOLDIER SKITTLES,7,150,1,200,50,1,2
7233,TRADITIONAL WOODEN SKIPPING ROPE,10,418,8,900,482,1,16
7234,WOODEN BOX OF DOMINOES,4,1553,15,1600,47,1,30
7235,RUSTIC  SEVENTEEN DRAWER SIDEBOARD,9,1078,15,1600,522,1,30
7236,PARTY CONES CARNIVAL ASSORTED,8,907,21,2200,1293,1,42
7237,PARTY CONES CANDY ASSORTED,9,556,11,1200,644,1,22
7238,PICNIC BASKET WICKER SMALL,2,694,16,1700,1006,1,32
7239,ASSORTED COLOUR BIRD ORNAMENT,7,489,4,500,11,1,8
7240,STAR DECORATION PAINTED ZINC ,1,1934,24,2500,566,1,48
7241,RETROSPOT LAMP,3,1659,25,2600,941,1,50
7242,"FANCY FONT BIRTHDAY CARD, ",8,484,6,700,216,1,12
7243,HAND WARMER UNION JACK,4,1427,17,1800,373,1,34
7244,HAND WARMER SCOTTY DOG DESIGN,4,409,12,1300,891,1,24
7245,HAND WARMER OWL DESIGN,3,1527,20,2100,573,1,40
7246,HAND WARMER RED RETROSPOT,7,116,1,200,84,1,2
7247,RETROSPOT HEART HOT WATER BOTTLE,3,626,24,2500,1874,1,48
7248,DOG BOWL CHASING BALL DESIGN,7,282,5,600,318,1,10
7249,CLOTHES PEGS RETROSPOT PACK 30,6,438,15,1600,1162,1,30
7250,HAND OVER THE CHOCOLATE   SIGN ,1,810,20,2100,1290,1,40
7251,WHITE HANGING HEART T-LIGHT HOLDER,4,1592,17,1800,208,1,34
7252,TRAVEL SEWING KIT,10,383,22,2300,1917,1,44
7253,BLACK HEART CARD HOLDER,8,100,0,100,0,1,0
7254,ASSORTED COLOUR BIRD ORNAMENT,9,2303,25,2600,297,1,50
7255,PACK OF 60 PINK PAISLEY CAKE CASES,2,986,9,1000,14,1,18
7256,66 TEATIME FAIRY CAKE CASES,8,1306,24,2500,1194,1,48
7257,PACK OF 72 RETROSPOT CAKE CASES,5,466,5,600,134,1,10
7258,CHICK GREY HOT WATER BOTTLE,6,1930,19,2000,70,1,38
7259,SMALL GLASS HEART TRINKET POT,2,132,2,300,168,1,4
7260,ALARM CLOCK BAKELIKE IVORY,5,677,10,1100,423,1,20
7261,ALARM CLOCK BAKELIKE RED ,4,1999,25,2600,601,1,50
7262,ALARM CLOCK BAKELIKE ORANGE,7,484,6,700,216,1,12
7263,ALARM CLOCK BAKELIKE GREEN,2,260,5,600,340,1,10
7264,HOT WATER BOTTLE TEA AND SYMPATHY,7,546,19,2000,1454,1,38
7265,HAND WARMER BIRD DESIGN,10,761,24,2500,1739,1,48
7266,HAND WARMER SCOTTY DOG DESIGN,6,426,4,500,74,1,8
7267,WHITE HANGING HEART T-LIGHT HOLDER,1,276,12,1300,1024,1,24
7268,WHITE METAL LANTERN,2,681,21,2200,1519,1,42
7269,CREAM CUPID HEARTS COAT HANGER,1,241,14,1500,1259,1,28
7270,EDWARDIAN PARASOL BLACK,2,1453,22,2300,847,1,44
7271,EDWARDIAN PARASOL RED,7,395,17,1800,1405,1,34
7272,RETRO COFFEE MUGS ASSORTED,4,832,16,1700,868,1,32
7273,SAVE THE PLANET MUG,6,371,5,600,229,1,10
7274,VINTAGE BILLBOARD DRINK ME MUG,6,101,22,2300,2199,1,44
7275,VINTAGE BILLBOARD LOVE/HATE MUG,1,670,7,800,130,1,14
7276,WOOD 2 DRAWER CABINET WHITE FINISH,10,1487,14,1500,13,1,28
7277,WOOD S/3 CABINET ANT WHITE FINISH,9,619,21,2200,1581,1,42
7278,WOODEN PICTURE FRAME WHITE FINISH,9,887,9,1000,113,1,18
7279,WOODEN FRAME ANTIQUE WHITE ,1,964,20,2100,1136,1,40
7280,KNITTED UNION FLAG HOT WATER BOTTLE,2,100,0,100,0,1,0
7281,RED WOOLLY HOTTIE WHITE HEART.,7,102,1,200,98,1,2
7282,SET 7 BABUSHKA NESTING BOXES,4,1650,17,1800,150,1,34
7283,IVORY EMBROIDERED QUILT ,9,1687,18,1900,213,1,36
7284,GLASS STAR FROSTED T-LIGHT HOLDER,4,931,13,1400,469,1,26
7285,SET OF 3 BLACK FLYING DUCKS,8,400,8,900,500,1,16
7286,SET OF 3 COLOURED  FLYING DUCKS,7,389,11,1200,811,1,22
7287,PACK OF 12 RED RETROSPOT TISSUES ,4,100,0,100,0,1,0
7288,RED RETROSPOT MUG,10,775,7,800,25,1,14
7289,BABUSHKA LIGHTS STRING OF 16,3,317,3,400,83,1,6
7290,PIGGY BANK RETROSPOT ,9,352,15,1600,1248,1,30
7291,SET 7 BABUSHKA NESTING BOXES,5,873,11,1200,327,1,22
7292,DOORMAT FAIRY CAKE,8,2424,24,2500,76,1,48
7293,HAND WARMER RED RETROSPOT,3,394,3,400,6,1,6
7294,HAND WARMER SCOTTY DOG DESIGN,1,821,17,1800,979,1,34
7295,HAND WARMER OWL DESIGN,3,235,21,2200,1965,1,42
7296,STRAWBERRY CERAMIC TRINKET BOX,10,1861,18,1900,39,1,36
7297,PINK DOUGHNUT TRINKET POT ,3,151,5,600,449,1,10
7298,SILK PURSE BABUSHKA PINK,3,1020,18,1900,880,1,36
7299,HOT WATER BOTTLE TEA AND SYMPATHY,4,2143,24,2500,357,1,48
7300,HOT WATER BOTTLE I AM SO POORLY,4,722,9,1000,278,1,18
7301,CHOCOLATE HOT WATER BOTTLE,1,1924,22,2300,376,1,44
7302,WHITE SKULL HOT WATER BOTTLE ,9,196,6,700,504,1,12
7303,SCOTTIE DOG HOT WATER BOTTLE,2,1061,13,1400,339,1,26
7304,HAND WARMER RED POLKA DOT,8,267,2,300,33,1,4
7305,HAND WARMER UNION JACK,7,942,10,1100,158,1,20
7306,HOMEMADE JAM SCENTED CANDLES,8,1363,14,1500,137,1,28
7307,BIRD HOUSE HOT WATER BOTTLE,5,167,24,2500,2333,1,48
7308,BOUDOIR SQUARE TISSUE BOX,2,1225,19,2000,775,1,38
7309,SKULLS SQUARE TISSUE BOX,9,863,16,1700,837,1,32
7310,PHOTO FRAME CORNICE,4,133,16,1700,1567,1,32
7311,SILK PURSE BABUSHKA RED,7,155,2,300,145,1,4
7312,PICTURE DOMINOES,2,182,8,900,718,1,16
7313,S/6 SEW ON CROCHET FLOWERS,10,1480,16,1700,220,1,32
7314,SCANDINAVIAN REDS RIBBONS,7,1897,19,2000,103,1,38
7315,BALLOONS  WRITING SET ,8,193,5,600,407,1,10
7316,JAM MAKING SET PRINTED,7,503,16,1700,1197,1,32
7317,LAVENDER INCENSE IN TIN,6,320,5,600,280,1,10
7318,TV DINNER TRAY VINTAGE PAISLEY,7,156,2,300,144,1,4
7319,SET OF 4 ENGLISH ROSE PLACEMATS,4,1082,14,1500,418,1,28
7320,SET OF 4 ENGLISH ROSE COASTERS,1,1277,14,1500,223,1,28
7321,TRIPLE PHOTO FRAME CORNICE ,2,1642,21,2200,558,1,42
7322,FAMILY PHOTO FRAME CORNICE,7,1351,15,1600,249,1,30
7323,MIRRORED DISCO BALL ,6,794,15,1600,806,1,30
7324,DISCO BALL ROTATOR BATTERY OPERATED,5,148,1,200,52,1,2
7325,SILVER LOOKING MIRROR,10,933,24,2500,1567,1,48
7326,LADIES & GENTLEMEN METAL SIGN,8,172,12,1300,1128,1,24
7327,METAL SIGN HER DINNER IS SERVED ,4,367,5,600,233,1,10
7328,YOU'RE CONFUSING ME METAL SIGN ,4,829,12,1300,471,1,24
7329,DOORMAT TOPIARY,1,182,11,1200,1018,1,22
7330,BATHROOM METAL SIGN,8,2052,20,2100,48,1,40
7331,KITCHEN METAL SIGN,3,674,7,800,126,1,14
7332,TOILET METAL SIGN,6,267,12,1300,1033,1,24
7333,METAL SIGN TAKE IT OR LEAVE IT ,10,123,3,400,277,1,6
7334,I'M ON HOLIDAY METAL SIGN,1,133,25,2600,2467,1,50
7335,GROW YOUR OWN BASIL IN ENAMEL MUG,10,1625,23,2400,775,1,46
7336,SET/10 PINK POLKADOT PARTY CANDLES,1,175,19,2000,1825,1,38
7337,SET 20 NAPKINS FAIRY CAKES DESIGN ,3,1376,19,2000,624,1,38
7338,66 TEATIME FAIRY CAKE CASES,2,491,14,1500,1009,1,28
7339,SET OF 6 T-LIGHTS SNOWMEN,9,229,2,300,71,1,4
7340,SET OF 6 T-LIGHTS SANTA,8,147,2,300,153,1,4
7341,SET OF 9 HEART SHAPED BALLOONS,7,326,7,800,474,1,14
7342,SANDWICH BATH SPONGE,8,100,0,100,0,1,0
7343,APPLE BATH SPONGE,8,182,7,800,618,1,14
7344,STRAWBERRY BATH SPONGE ,9,100,0,100,0,1,0
7345,BLACK PIRATE TREASURE CHEST,4,118,1,200,82,1,2
7346,STAR PORTABLE TABLE LIGHT ,8,160,19,2000,1840,1,38
7347,SNOWFLAKE PORTABLE TABLE LIGHT ,9,771,11,1200,429,1,22
7348,PINK OVAL JEWELLED MIRROR,10,923,10,1100,177,1,20
7349,RETROSPOT CIGAR BOX MATCHES ,10,100,0,100,0,1,0
7350,COSY HOUR GIANT TUBE MATCHES,2,496,7,800,304,1,14
7351,JAZZ HEARTS PURSE NOTEBOOK,6,139,14,1500,1361,1,28
7352,LUNCH BAG DOLLY GIRL DESIGN,4,1089,13,1400,311,1,26
7353,WHITE HANGING HEART T-LIGHT HOLDER,2,196,10,1100,904,1,20
7354,CANDLEHOLDER PINK HANGING HEART,10,350,5,600,250,1,10
7355,WOOD 2 DRAWER CABINET WHITE FINISH,7,148,1,200,52,1,2
7356,ASSORTED COLOUR MINI CASES,6,110,5,600,490,1,10
7357,LUNCH BAG RED RETROSPOT,3,978,23,2400,1422,1,46
7358,LUNCH BAG SPACEBOY DESIGN ,6,1148,18,1900,752,1,36
7359,LUNCH BAG WOODLAND,6,459,4,500,41,1,8
7360,LUNCH BAG PINK POLKADOT,10,775,11,1200,425,1,22
7361,GUMBALL COAT RACK,1,100,0,100,0,1,0
7362,BLUE NEW BAROQUE CANDLESTICK CANDLE,2,285,3,400,115,1,6
7363,PINK NEW BAROQUECANDLESTICK CANDLE,6,169,1,200,31,1,2
7364,FAIRY CAKE FLANNEL ASSORTED COLOUR,9,468,8,900,432,1,16
7365,BREAD BIN DINER STYLE PINK,5,1162,12,1300,138,1,24
7366,JUMBO BAG CHARLIE AND LOLA TOYS,4,406,8,900,494,1,16
7367,TEA TIME TABLE CLOTH,8,563,23,2400,1837,1,46
7368,ENGLISH ROSE HOT WATER BOTTLE,3,1040,10,1100,60,1,20
7369,ENAMEL FIRE BUCKET CREAM,5,253,4,500,247,1,8
7370,PICNIC BASKET WICKER SMALL,2,513,14,1500,987,1,28
7371,PAPER CHAIN KIT 50'S CHRISTMAS ,2,932,23,2400,1468,1,46
7372,PAPER CHAIN KIT VINTAGE CHRISTMAS,5,148,1,200,52,1,2
7373,HOT WATER BOTTLE BABUSHKA ,2,1952,21,2200,248,1,42
7374,HAND WARMER BIRD DESIGN,2,1272,21,2200,928,1,42
7375,POSTAGE,1,599,5,600,1,1,10
7376,HEART IVORY TRELLIS SMALL,4,190,8,900,710,1,16
7377,CLEAR DRAWER KNOB ACRYLIC EDWARDIAN,6,329,23,2400,2071,1,46
7378,PINK DRAWER KNOB ACRYLIC EDWARDIAN,4,1420,19,2000,580,1,38
7379,GREEN DRAWER KNOB ACRYLIC EDWARDIAN,1,172,8,900,728,1,16
7380,BLUE DRAWER KNOB ACRYLIC EDWARDIAN,6,842,11,1200,358,1,22
7381,HEART OF WICKER SMALL,3,100,0,100,0,1,0
7382,SMALL POPCORN HOLDER,4,775,17,1800,1025,1,34
7383,SET 6 FOOTBALL CELEBRATION CANDLES,2,148,11,1200,1052,1,22
7384,SET OF 6 GIRLS CELEBRATION CANDLES,3,1264,15,1600,336,1,30
7385,ROMANTIC PINKS RIBBONS ,4,186,4,500,314,1,8
7386,BRIGHT BLUES RIBBONS ,4,339,3,400,61,1,6
7387,SCANDINAVIAN REDS RIBBONS,7,487,25,2600,2113,1,50
7388,CHOCOLATE BOX RIBBONS ,7,1178,16,1700,522,1,32
7389,PARTY INVITES FOOTBALL,9,514,23,2400,1886,1,46
7390,PARTY INVITES JAZZ HEARTS,3,1023,15,1600,577,1,30
7391,PARTY INVITES SPACEMAN,4,173,2,300,127,1,4
7392,SET OF 3 BUTTERFLY COOKIE CUTTERS,4,100,0,100,0,1,0
7393,SET OF 3 HEART COOKIE CUTTERS,8,467,11,1200,733,1,22
7394,9 PIECE SPACEBOY COOKIE CUTTER SET,8,134,6,700,566,1,12
7395,PACK OF 72 SKULL CAKE CASES,9,866,8,900,34,1,16
7396,PACK OF 60 SPACEBOY CAKE CASES,4,230,11,1200,970,1,22
7397,PACK OF 72 RETROSPOT CAKE CASES,4,1422,15,1600,178,1,30
7398,78 SWEETHEART FAIRY CAKE CASES,9,642,13,1400,758,1,26
7399,PACK OF 60 DINOSAUR CAKE CASES,4,1275,22,2300,1025,1,44
7400,LUNCH BAG SUKI  DESIGN ,10,451,5,600,149,1,10
7401,LUNCH BAG CARS BLUE,8,100,0,100,0,1,0
7402,LUNCH BAG  BLACK SKULL.,3,253,3,400,147,1,6
7403,HEART IVORY TRELLIS LARGE,5,100,0,100,0,1,0
7404,SET/5 RED RETROSPOT LID GLASS BOWLS,3,2094,23,2400,306,1,46
7405,WHITE HANGING HEART T-LIGHT HOLDER,8,1391,17,1800,409,1,34
7406,WHITE METAL LANTERN,1,209,2,300,91,1,4
7407,CREAM CUPID HEARTS COAT HANGER,6,249,3,400,151,1,6
7408,EDWARDIAN PARASOL RED,1,686,13,1400,714,1,26
7409,RETRO COFFEE MUGS ASSORTED,9,430,5,600,170,1,10
7410,SAVE THE PLANET MUG,10,321,18,1900,1579,1,36
7411,VINTAGE BILLBOARD DRINK ME MUG,5,151,3,400,249,1,6
7412,VINTAGE BILLBOARD LOVE/HATE MUG,1,892,8,900,8,1,16
7413,WOOD 2 DRAWER CABINET WHITE FINISH,6,394,4,500,106,1,8
7414,WOOD S/3 CABINET ANT WHITE FINISH,5,2173,21,2200,27,1,42
7415,WOODEN PICTURE FRAME WHITE FINISH,8,321,17,1800,1479,1,34
7416,WOODEN FRAME ANTIQUE WHITE ,1,417,10,1100,683,1,20
7417,KNITTED UNION FLAG HOT WATER BOTTLE,7,307,3,400,93,1,6
7418,RED WOOLLY HOTTIE WHITE HEART.,1,144,7,800,656,1,14
7419,SET 7 BABUSHKA NESTING BOXES,7,102,12,1300,1198,1,24
7420,IVORY EMBROIDERED QUILT ,5,158,1,200,42,1,2
7421,GLASS STAR FROSTED T-LIGHT HOLDER,4,174,13,1400,1226,1,26
7422,HAND WARMER RED POLKA DOT,7,172,1,200,28,1,2
7423,HAND WARMER UNION JACK,3,200,13,1400,1200,1,26
7424,MAGIC DRAWING SLATE DINOSAUR,6,122,21,2200,2078,1,42
7425,MAGIC DRAWING SLATE BAKE A CAKE ,7,1334,16,1700,366,1,32
7426,18 PENCILS TALL TUBE SKULLS,1,100,0,100,0,1,0
7427,CHOCOLATE CALCULATOR,7,1456,23,2400,944,1,46
7428,RED  HARMONICA IN BOX ,5,1397,21,2200,803,1,42
7429,BLUE HARMONICA IN BOX ,6,160,7,800,640,1,14
7430,SKULLS  WATER TRANSFER TATTOOS ,8,1697,21,2200,503,1,42
7431,PACK 3 BOXES BIRD PANNETONE ,10,454,16,1700,1246,1,32
7432,HOT WATER BOTTLE TEA AND SYMPATHY,5,125,2,300,175,1,4
7433,RED WOOLLY HOTTIE WHITE HEART.,6,435,13,1400,965,1,26
7434,WHITE SKULL HOT WATER BOTTLE ,1,565,16,1700,1135,1,32
7435,9 PIECE SPACEBOY COOKIE CUTTER SET,1,725,13,1400,675,1,26
7436,SET OF 20 KIDS COOKIE CUTTERS,1,1889,24,2500,611,1,48
7437,16 COLOUR SPACEBOY PEN,9,828,13,1400,572,1,26
7438,VICTORIAN GLASS HANGING T-LIGHT,9,228,9,1000,772,1,18
7439,SINGLE HEART ZINC T-LIGHT HOLDER,10,905,14,1500,595,1,28
7440,RED HANGING HEART T-LIGHT HOLDER,3,1147,23,2400,1253,1,46
7441,HANGING METAL STAR LANTERN,4,189,21,2200,2011,1,42
7442,SILVER HANGING T-LIGHT HOLDER,7,966,12,1300,334,1,24
7443,DOORMAT RED RETROSPOT,3,1919,23,2400,481,1,46
7444,DOORMAT HEARTS,1,1091,13,1400,309,1,26
7445,NATURAL SLATE RECTANGLE CHALKBOARD,8,898,19,2000,1102,1,38
7446,LOVEBIRD HANGING DECORATION WHITE ,3,533,6,700,167,1,12
7447,ASSORTED COLOUR BIRD ORNAMENT,2,1219,14,1500,281,1,28
7448,HOME BUILDING BLOCK WORD,3,843,25,2600,1757,1,50
7449,LOVE BUILDING BLOCK WORD,6,517,15,1600,1083,1,30
7450,PHOTO FRAME CORNICE,7,831,19,2000,1169,1,38
7451,PENS ASSORTED FUNNY FACE,10,296,2,300,4,1,4
7452,CARD CIRCUS PARADE,9,100,0,100,0,1,0
7453,WRAP COWBOYS  ,1,1789,25,2600,811,1,50
7454,AIRLINE BAG VINTAGE TOKYO 84,3,272,2,300,28,1,4
7455,RED RETROSPOT UMBRELLA,10,237,4,500,263,1,8
7456,BLACK/BLUE POLKADOT UMBRELLA,5,591,5,600,9,1,10
7457,RED 3 PIECE RETROSPOT CUTLERY SET,8,475,13,1400,925,1,26
7458,PACK OF 72 RETROSPOT CAKE CASES,4,1142,17,1800,658,1,34
7459,SET OF 72 RETROSPOT PAPER  DOILIES,9,840,21,2200,1360,1,42
7460,BLUE COAT RACK PARIS FASHION,6,274,17,1800,1526,1,34
7461,PLASTERS IN TIN SKULLS,8,229,9,1000,771,1,18
7462,SLEEPING CAT ERASERS,8,399,10,1100,701,1,20
7463,CARD BIRTHDAY COWBOY,4,345,9,1000,655,1,18
7464,PACK 3 BOXES CHRISTMAS PANNETONE,1,732,18,1900,1168,1,36
7465,ROTATING SILVER ANGELS T-LIGHT HLDR,10,1637,18,1900,263,1,36
7466,COSY HOUR GIANT TUBE MATCHES,7,347,23,2400,2053,1,46
7467,RIBBON REEL MAKING SNOWMEN ,3,218,4,500,282,1,8
7468,MINI PAINT SET VINTAGE ,9,727,20,2100,1373,1,40
7469,10 TRADITIONAL SPINNING TOPS,7,1479,19,2000,521,1,38
7470,SET OF 6 SOLDIER SKITTLES,10,1021,14,1500,479,1,28
7471,BAG 500g SWIRLY MARBLES,10,1498,16,1700,202,1,32
7472,11 STRAND GLASS NECKLACE CRYSTAL,2,2331,24,2500,169,1,48
7473,WHITE SKULL HOT WATER BOTTLE ,4,1739,25,2600,861,1,50
7474,SCOTTIE DOG HOT WATER BOTTLE,1,1124,19,2000,876,1,38
7475,SQUARECUSHION COVER PINK UNION FLAG,7,100,0,100,0,1,0
7476,SPACEBOY CHILDRENS EGG CUP,3,382,3,400,18,1,6
7477,CHILDREN'S SPACEBOY MUG,8,419,15,1600,1181,1,30
7478,HAND WARMER SCOTTY DOG DESIGN,2,521,6,700,179,1,12
7479,FELTCRAFT CUSHION OWL,5,243,3,400,157,1,6
7480,BLACK CANDELABRA T-LIGHT HOLDER,6,160,3,400,240,1,6
7481,TOY TIDY DOLLY GIRL DESIGN,1,533,7,800,267,1,14
7482,SET 12 LAVENDER  BOTANICAL T-LIGHTS,9,112,12,1300,1188,1,24
7483,UNION JACK FLAG LUGGAGE TAG,10,1226,15,1600,374,1,30
7484,RED HEART LUGGAGE TAG,2,1571,20,2100,529,1,40
7485,RED GLASS TASSLE BAG CHARM,6,775,10,1100,325,1,20
7486,CLEAR ACRYLIC FACETED BANGLE,7,542,6,700,158,1,12
7487,11 STRAND GLASS NECKLACE CRYSTAL,4,339,11,1200,861,1,22
7488,DOORMAT UNION JACK GUNS AND ROSES,4,819,12,1300,481,1,24
7489,VANILLA SCENT CANDLE JEWELLED BOX,10,1947,21,2200,253,1,42
7490,FULL ENGLISH BREAKFAST PLATE,3,864,20,2100,1236,1,40
7491,BLACK CANDELABRA T-LIGHT HOLDER,7,483,21,2200,1717,1,42
7492,MAGIC DRAWING SLATE CIRCUS PARADE  ,7,292,2,300,8,1,4
7493,CHRISTMAS HANGING HEART WITH BELL,1,804,12,1300,496,1,24
7494,CAKE STAND VICTORIAN FILIGREE MED,1,629,9,1000,371,1,18
7495,PAISLEY PATTERN  STICKERS,9,621,23,2400,1779,1,46
7496,FLOWERS  STICKERS,1,231,11,1200,969,1,22
7497,PINK NEW BAROQUECANDLESTICK CANDLE,8,406,6,700,294,1,12
7498,BLUE NEW BAROQUE CANDLESTICK CANDLE,5,1775,20,2100,325,1,40
7499,JUMBO STORAGE BAG SUKI,7,397,13,1400,1003,1,26
7500,BLACK LOVE BIRD CANDLE,1,568,13,1400,832,1,26
7501,PARTY TIME PENCIL ERASERS,1,279,9,1000,721,1,18
7502,DISCO BALL CHRISTMAS DECORATION,3,835,10,1100,265,1,20
7503,PINK B'FLY C/COVER W BOBBLES,6,106,11,1200,1094,1,22
7504,PINK UNION JACK  LUGGAGE TAG,4,1087,19,2000,913,1,38
7505,12 RIBBONS ELEGANT CHRISTMAS ,4,846,25,2600,1754,1,50
7506,UNION JACK FLAG LUGGAGE TAG,3,803,23,2400,1597,1,46
7507,AGED GLASS SILVER T-LIGHT HOLDER,5,329,10,1100,771,1,20
7508,BOOM BOX SPEAKER GIRLS,5,366,3,400,34,1,6
7509,12 RIBBONS SHIMMERING PINKS ,1,521,6,700,179,1,12
7510, SET 2 TEA TOWELS I LOVE LONDON ,1,438,4,500,62,1,8
7511,JUMBO BAG OWLS,5,409,12,1300,891,1,24
7512,SANDWICH BATH SPONGE,9,2365,25,2600,235,1,50
7513,OWL DOORSTOP,3,396,5,600,204,1,10
7514,11 STRAND GLASS NECKLACE CRYSTAL,8,277,13,1400,1123,1,26
7515,HAND WARMER UNION JACK,2,238,3,400,162,1,6
7516,HAND WARMER SCOTTY DOG DESIGN,1,2151,21,2200,49,1,42
7517,LARGE POPCORN HOLDER ,1,500,21,2200,1700,1,42
7518,PAINTED METAL STAR WITH HOLLY BELLS,2,688,23,2400,1712,1,46
7519,PAINTED METAL HEART WITH HOLLY BELL,7,642,7,800,158,1,14
7520,ANGEL DECORATION STARS ON DRESS,5,153,7,800,647,1,14
7521,SMALL POPCORN HOLDER,8,1549,24,2500,951,1,48
7522,JUMBO BAG RED RETROSPOT,9,723,15,1600,877,1,30
7523,JUMBO BAG STRAWBERRY,4,143,15,1600,1457,1,30
7524,STRAWBERRY SHOPPER BAG,4,172,15,1600,1428,1,30
7525,STRAWBERRY CHARLOTTE BAG,10,140,3,400,260,1,6
7526, SET 2 TEA TOWELS I LOVE LONDON ,6,166,4,500,334,1,8
7527,PACK OF 12 RED RETROSPOT TISSUES ,3,333,7,800,467,1,14
7528,SCOTTIE DOG HOT WATER BOTTLE,3,131,2,300,169,1,4
7529,CHOCOLATE HOT WATER BOTTLE,4,1249,15,1600,351,1,30
7530,LUNCH BAG CARS BLUE,6,467,6,700,233,1,12
7531,LUNCH BAG SPACEBOY DESIGN ,6,2244,24,2500,256,1,48
7532,ROUND SNACK BOXES SET OF4 WOODLAND ,10,377,14,1500,1123,1,28
7533,LUNCH BAG DOLLY GIRL DESIGN,8,446,22,2300,1854,1,44
7534,LUNCH BAG SUKI  DESIGN ,7,1452,21,2200,748,1,42
7535,LUNCH BAG  BLACK SKULL.,1,100,0,100,0,1,0
7536,ROUND SNACK BOXES SET OF 4 FRUITS ,3,356,10,1100,744,1,20
7537,ROUND SNACK BOXES SET OF 4 SKULLS,3,175,8,900,725,1,16
7538,DOLLY GIRL LUNCH BOX,9,198,17,1800,1602,1,34
7539,SPACEBOY LUNCH BOX ,2,154,16,1700,1546,1,32
7540,GREEN POLKADOT PLATE ,10,870,13,1400,530,1,26
7541,BLUE POLKADOT PLATE ,9,119,2,300,181,1,4
7542,RED RETROSPOT PLATE ,7,800,11,1200,400,1,22
7543,PINK  POLKADOT PLATE ,1,2151,25,2600,449,1,50
7544,ROUND SNACK BOXES SET OF 4 SKULLS,8,327,4,500,173,1,8
7545,FELTCRAFT DOLL MOLLY,4,1420,19,2000,580,1,38
7546,FELTCRAFT CHRISTMAS FAIRY,7,186,1,200,14,1,2
7547,TRAVEL SEWING KIT,1,397,3,400,3,1,6
7548,SET OF 3 NOTEBOOKS IN PARCEL,4,2287,25,2600,313,1,50
7549,RED RETROSPOT TAPE,1,556,7,800,244,1,14
7550,COSY SLIPPER SHOES SMALL  RED ,6,177,2,300,123,1,4
7551,12 RIBBONS RUSTIC CHARM,10,1603,19,2000,397,1,38
7552,SCANDINAVIAN REDS RIBBONS,4,1070,25,2600,1530,1,50
7553,JAM MAKING SET PRINTED,8,1025,11,1200,175,1,22
7554,18 DAISY PEGS IN WOOD BOX,7,100,0,100,0,1,0
7555,HOT WATER BOTTLE BABUSHKA ,2,222,2,300,78,1,4
7556,FELTCRAFT PRINCESS CHARLOTTE DOLL,1,1210,18,1900,690,1,36
7557,FELTCRAFT CHRISTMAS FAIRY,8,378,7,800,422,1,14
7558,FELTCRAFT PRINCESS CHARLOTTE DOLL,9,273,9,1000,727,1,18
7559,12 RIBBONS RUSTIC CHARM,10,1910,20,2100,190,1,40
7560,COSY SLIPPER SHOES SMALL  RED ,5,1685,19,2000,315,1,38
7561,SCANDINAVIAN REDS RIBBONS,10,1273,13,1400,127,1,26
7562,11 HOOK HANGER RED MAGIC TOADSTOOL,2,363,21,2200,1837,1,42
7563,CHRISTMAS CRAFT TREE TOP ANGEL,9,179,4,500,321,1,8
7564,CHRISTMAS CRAFT LITTLE FRIENDS,2,729,7,800,71,1,14
7565,11 HOOK HANGER RED MAGIC TOADSTOOL,1,456,4,500,44,1,8
7566,12 RIBBONS RUSTIC CHARM,6,486,11,1200,714,1,22
7567,18 DAISY PEGS IN WOOD BOX,3,100,0,100,0,1,0
7568,SET OF 3 NOTEBOOKS IN PARCEL,4,390,13,1400,1010,1,26
7569,11 HOOK HANGER MAGIC TOADSTOOL,9,946,11,1200,254,1,22
7570,SCANDINAVIAN REDS RIBBONS,10,480,14,1500,1020,1,28
7571,RED TOADSTOOL LED NIGHT LIGHT,10,181,13,1400,1219,1,26
7572,11 HOOK HANGER RED MAGIC TOADSTOOL,1,100,0,100,0,1,0
7573,COSY SLIPPER SHOES SMALL GREEN,5,538,20,2100,1562,1,40
7574,COSY SLIPPER SHOES SMALL  RED ,2,513,8,900,387,1,16
7575,FELTCRAFT DOLL ROSIE,6,153,13,1400,1247,1,26
7576,FELTCRAFT DOLL MOLLY,4,834,10,1100,266,1,20
7577,FELTCRAFT DOLL EMILY,5,1589,16,1700,111,1,32
7578,FELTCRAFT PRINCESS CHARLOTTE DOLL,2,882,8,900,18,1,16
7579,FELTCRAFT PRINCESS OLIVIA DOLL,7,146,2,300,154,1,4
7580,REX CASH+CARRY JUMBO SHOPPER,2,317,3,400,83,1,6
7581,FELTCRAFT DOLL MOLLY,2,1860,19,2000,140,1,38
7582,FELTCRAFT CUSHION OWL,5,172,4,500,328,1,8
7583,CHRISTMAS CRAFT TREE TOP ANGEL,1,404,7,800,396,1,14
7584,CHRISTMAS CRAFT LITTLE FRIENDS,7,100,0,100,0,1,0
7585,FELTCRAFT CUSHION RABBIT,2,1244,18,1900,656,1,36
7586,FELTCRAFT CUSHION BUTTERFLY,7,776,11,1200,424,1,22
7587,18 DAISY PEGS IN WOOD BOX,10,176,1,200,24,1,2
7588,PAPER CHAIN KIT 50'S CHRISTMAS ,3,2376,24,2500,124,1,48
7589,FELTCRAFT CUSHION BUTTERFLY,1,123,6,700,577,1,12
7590,18 DAISY PEGS IN WOOD BOX,1,1089,21,2200,1111,1,42
7591,ROSE COTTAGE KEEPSAKE BOX ,2,1285,17,1800,515,1,34
7592,TOTE BAG I LOVE LONDON,5,292,7,800,508,1,14
7593,18 DAISY PEGS IN WOOD BOX,10,1137,22,2300,1163,1,44
7594,TOTE BAG I LOVE LONDON,9,1695,23,2400,705,1,46
7595,FOLDING UMBRELLA PINKWHITE POLKADOT,1,249,7,800,551,1,14
7596,FOLDING UMBRELLA CREAM POLKADOT,4,846,9,1000,154,1,18
7597,FOLDING UMBRELLA WHITE/RED POLKADOT,5,1075,13,1400,325,1,26
7598,SET 10 LIGHTS NIGHT OWL,7,101,21,2200,2099,1,42
7599,SMALL POPCORN HOLDER,1,585,7,800,215,1,14
7600, SET 2 TEA TOWELS I LOVE LONDON ,5,352,10,1100,748,1,20
7601,FOLDING UMBRELLA RED/WHITE POLKADOT,9,915,17,1800,885,1,34
7602,BABUSHKA LIGHTS STRING OF 16,6,1186,18,1900,714,1,36
7603,LUNCH BAG RED RETROSPOT,6,1656,23,2400,744,1,46
7604,S/4 VALENTINE DECOUPAGE HEART BOX,2,263,4,500,237,1,8
7605,FOLDING UMBRELLA CREAM POLKADOT,6,1686,17,1800,114,1,34
7606, SET 2 TEA TOWELS I LOVE LONDON ,7,563,5,600,37,1,10
7607,FOLDING UMBRELLA RED/WHITE POLKADOT,6,334,4,500,166,1,8
7608,SOLDIERS EGG CUP ,7,1028,15,1600,572,1,30
7609,S/4 VALENTINE DECOUPAGE HEART BOX,2,131,3,400,269,1,6
7610,RED RETROSPOT MINI CASES,9,250,15,1600,1350,1,30
7611,,1,670,19,2000,1330,1,38
7612,66 CAKE CASES VINTAGE CHRISTMAS,7,318,3,400,82,1,6
7613,PAPER CHAIN KIT VINTAGE CHRISTMAS,2,283,2,300,17,1,4
7614,RIBBON REEL CHRISTMAS SOCK BAUBLE,6,220,3,400,180,1,6
7615,RIBBON REEL SNOWY VILLAGE,10,1131,22,2300,1169,1,44
7616,RIBBON REEL MAKING SNOWMEN ,2,958,10,1100,142,1,20
7617,SET OF 20 VINTAGE CHRISTMAS NAPKINS,3,100,0,100,0,1,0
7618,TURQUOISE CHRISTMAS TREE ,3,201,2,300,99,1,4
7619,RED STAR CARD HOLDER,8,1409,22,2300,891,1,44
7620,WICKER WREATH SMALL,4,294,3,400,106,1,6
7621,HEART OF WICKER LARGE,7,367,9,1000,633,1,18
7622,ADVENT CALENDAR GINGHAM SACK,10,518,9,1000,482,1,18
7623,HEART OF WICKER SMALL,2,663,15,1600,937,1,30
7624,FELTCRAFT BUTTERFLY HEARTS,10,286,3,400,114,1,6
7625,PARTY CONE CHRISTMAS DECORATION ,5,174,1,200,26,1,2
7626,VINTAGE HEADS AND TAILS CARD GAME ,7,571,16,1700,1129,1,32
7627,WICKER STAR ,7,164,15,1600,1436,1,30
7628,VINTAGE SNAP CARDS,7,627,24,2500,1873,1,48
7629,FELTCRAFT 6 FLOWER FRIENDS,9,1350,22,2300,950,1,44
7630, SET 2 TEA TOWELS I LOVE LONDON ,6,1109,11,1200,91,1,22
7631,JAM MAKING SET PRINTED,5,242,20,2100,1858,1,40
7632,BIRD DECORATION RED RETROSPOT,1,372,7,800,428,1,14
7633,CHRISTMAS GINGHAM TREE,1,1089,21,2200,1111,1,42
7634,CHRISTMAS GINGHAM STAR,3,222,12,1300,1078,1,24
7635,CHRISTMAS GINGHAM HEART,3,1812,18,1900,88,1,36
7636,PACK OF 12 PINK POLKADOT TISSUES,9,100,0,100,0,1,0
7637,FELTCRAFT PRINCESS LOLA DOLL,2,945,12,1300,355,1,24
7638,PACK OF 12 LONDON TISSUES ,5,256,5,600,344,1,10
7639,PURPLE DRAWERKNOB ACRYLIC EDWARDIAN,3,390,10,1100,710,1,20
7640,CHILDREN'S APRON DOLLY GIRL ,10,197,12,1300,1103,1,24
7641,CHILDRENS APRON SPACEBOY DESIGN,9,518,16,1700,1182,1,32
7642,CHRISTMAS LIGHTS 10 SANTAS ,4,1886,19,2000,114,1,38
7643,CHRISTMAS LIGHTS 10 REINDEER,6,1339,23,2400,1061,1,46
7644,PAPER CHAIN KIT 50'S CHRISTMAS ,9,904,16,1700,796,1,32
7645,FELTCRAFT CHRISTMAS FAIRY,10,668,12,1300,632,1,24
7646,PACK OF 72 RETROSPOT CAKE CASES,7,1061,19,2000,939,1,38
7647,PACK OF 60 MUSHROOM CAKE CASES,8,154,10,1100,946,1,20
7648,66 CAKE CASES DOLLY GIRL DESIGN,8,771,17,1800,1029,1,34
7649,PACK OF 60 PINK PAISLEY CAKE CASES,6,114,9,1000,886,1,18
7650,HAND WARMER BABUSHKA DESIGN,7,1454,25,2600,1146,1,50
7651,HAND WARMER BIRD DESIGN,8,870,23,2400,1530,1,46
7652,HAND WARMER OWL DESIGN,10,635,18,1900,1265,1,36
7653,HAND WARMER RED RETROSPOT,6,609,19,2000,1391,1,38
7654,SET 12 RETRO WHITE CHALK STICKS,9,675,6,700,25,1,12
7655,FELTCRAFT HAIRBAND RED AND BLUE,2,1175,11,1200,25,1,22
7656,FELTCRAFT HAIRBAND PINK AND PURPLE,10,1650,20,2100,450,1,40
7657,FELTCRAFT HAIRBANDS PINK AND WHITE ,4,224,4,500,276,1,8
7658,TV DINNER TRAY DOLLY GIRL,3,363,12,1300,937,1,24
7659,PLASTERS IN TIN VINTAGE PAISLEY ,3,350,24,2500,2150,1,48
7660,PLASTERS IN TIN SPACEBOY,3,1736,18,1900,164,1,36
7661,PLASTERS IN TIN WOODLAND ANIMALS,2,118,1,200,82,1,2
7662,MAGIC DRAWING SLATE SPACEBOY ,7,158,2,300,142,1,4
7663,MAGIC DRAWING SLATE CIRCUS PARADE  ,7,229,4,500,271,1,8
7664,MAGIC DRAWING SLATE GO TO THE FAIR ,10,396,3,400,4,1,6
7665,MAGIC DRAWING SLATE DOLLY GIRL ,1,494,11,1200,706,1,22
7666,CHARLIE + LOLA RED HOT WATER BOTTLE,3,2379,25,2600,221,1,50
7667,HOT WATER BOTTLE BABUSHKA ,9,217,10,1100,883,1,20
7668,URBAN BLACK RIBBONS ,5,896,24,2500,1604,1,48
7669,FELTCRAFT PRINCESS CHARLOTTE DOLL,9,122,2,300,178,1,4
7670,SET OF 6 T-LIGHTS TOADSTOOLS,6,128,7,800,672,1,14
7671,ROTATING LEAVES T-LIGHT HOLDER,3,1242,17,1800,558,1,34
7672,RED  HARMONICA IN BOX ,7,1510,21,2200,690,1,42
7673,CUPCAKE LACE PAPER SET 12,5,1254,14,1500,246,1,28
7674,FAMILY PHOTO FRAME CORNICE,5,457,13,1400,943,1,26
7675,TRIPLE PHOTO FRAME CORNICE ,4,1289,17,1800,511,1,34
7676,WOODEN FRAME ANTIQUE WHITE ,1,1206,14,1500,294,1,28
7677,WOODEN BOX OF DOMINOES,6,965,14,1500,535,1,28
7678,TRADITIONAL WOODEN CATCH CUP GAME ,5,389,19,2000,1611,1,38
7679,TRADITIONAL WOODEN SKIPPING ROPE,10,704,7,800,96,1,14
7680,S/6 WOODEN SKITTLES IN COTTON BAG,2,309,5,600,291,1,10
7681,RED METAL BEACH SPADE ,9,1793,20,2100,307,1,40
7682,BOYS VINTAGE TIN SEASIDE BUCKET,7,198,3,400,202,1,6
7683,GIRLS VINTAGE TIN SEASIDE BUCKET,9,251,14,1500,1249,1,28
7684,GREY HEART HOT WATER BOTTLE,9,1027,10,1100,73,1,20
7685,SCOTTIE DOG HOT WATER BOTTLE,7,1163,15,1600,437,1,30
7686,BIRD HOUSE HOT WATER BOTTLE,3,497,20,2100,1603,1,40
7687,KINGS CHOICE TEA CADDY ,6,115,17,1800,1685,1,34
7688,KINGS CHOICE BISCUIT TIN,5,1059,10,1100,41,1,20
7689,METAL SIGN EMPIRE TEA,3,410,15,1600,1190,1,30
7690,HOMEMADE JAM SCENTED CANDLES,1,471,15,1600,1129,1,30
7691,SET OF 6 SOLDIER SKITTLES,3,787,21,2200,1413,1,42
7692,FAWN BLUE HOT WATER BOTTLE,6,897,20,2100,1203,1,40
7693,HAND WARMER RED RETROSPOT,7,490,6,700,210,1,12
7694,HOT WATER BOTTLE BABUSHKA ,4,486,18,1900,1414,1,36
7695,WHITE SKULL HOT WATER BOTTLE ,4,850,21,2200,1350,1,42
7696,RETROSPOT HEART HOT WATER BOTTLE,9,459,8,900,441,1,16
7697,RED WOOLLY HOTTIE WHITE HEART.,4,421,4,500,79,1,8
7698,SCOTTIE DOG HOT WATER BOTTLE,1,455,23,2400,1945,1,46
7699,GREY HEART HOT WATER BOTTLE,3,1068,21,2200,1132,1,42
7700,HOT WATER BOTTLE BABUSHKA ,4,880,15,1600,720,1,30
7701,PACK OF 6 BIRDY GIFT TAGS,2,1489,23,2400,911,1,46
7702,CHILLI LIGHTS,9,913,16,1700,787,1,32
7703,PIGGY BANK RETROSPOT ,6,2035,20,2100,65,1,40
7704,CERAMIC STRAWBERRY MONEY BOX,8,702,9,1000,298,1,18
7705,CERAMIC STRAWBERRY CAKE MONEY BANK,7,381,22,2300,1919,1,44
7706,CERAMIC CHERRY CAKE MONEY BANK,2,804,9,1000,196,1,18
7707,CERAMIC HEART FAIRY CAKE MONEY BANK,7,1018,15,1600,582,1,30
7708,CERAMIC PIRATE CHEST MONEY BANK,5,124,14,1500,1376,1,28
7709,DOORSTOP RETROSPOT HEART,1,190,4,500,310,1,8
7710,GINGHAM HEART  DOORSTOP RED,1,684,10,1100,416,1,20
7711,RETROSPOT BABUSHKA DOORSTOP,8,1721,25,2600,879,1,50
7712,SILK PURSE BABUSHKA RED,2,1093,12,1300,207,1,24
7713,SILK PURSE BABUSHKA PINK,3,1304,13,1400,96,1,26
7714,FAMILY PHOTO FRAME CORNICE,9,887,24,2500,1613,1,48
7715,SWEETHEART WIRE WALL TIDY,10,1871,18,1900,29,1,36
7716,JAM MAKING SET PRINTED,4,322,17,1800,1478,1,34
7717,RED RETROSPOT OVEN GLOVE ,10,730,16,1700,970,1,32
7718,CREAM HEART CARD HOLDER,1,324,5,600,276,1,10
7719,NAMASTE SWAGAT INCENSE,3,1793,18,1900,107,1,36
7720,CERAMIC STRAWBERRY DESIGN MUG,6,670,21,2200,1530,1,42
7721,BLACK HEART CARD HOLDER,4,879,24,2500,1621,1,48
7722,CLASSICAL ROSE SMALL VASE,3,156,1,200,44,1,2
7723,HYACINTH BULB T-LIGHT CANDLES,1,263,21,2200,1937,1,42
7724,CHRISTMAS CRAFT WHITE FAIRY ,1,555,11,1200,645,1,22
7725,CHRISTMAS CRAFT LITTLE FRIENDS,8,1276,13,1400,124,1,26
7726,COSY HOUR CIGAR BOX MATCHES ,5,544,11,1200,656,1,22
7727,RED TEA TOWEL CLASSIC DESIGN,2,205,11,1200,995,1,22
7728,HEART FILIGREE DOVE  SMALL,1,634,24,2500,1866,1,48
7729,RETROSPOT CHILDRENS APRON,2,886,16,1700,814,1,32
7730,COLOURING PENCILS BROWN TUBE,5,520,18,1900,1380,1,36
7731,10 IVORY DINNER CANDLES SILVER FLOCK,4,270,4,500,230,1,8
7732,HEART FILIGREE DOVE  SMALL,4,345,15,1600,1255,1,30
7733,ZINC METAL HEART DECORATION,7,143,1,200,57,1,2
7734,GREEN FERN NOTEBOOK,10,687,12,1300,613,1,24
7735,BLUE PAISLEY NOTEBOOK,6,173,5,600,427,1,10
7736,CHRYSANTHEMUM NOTEBOOK,4,488,12,1300,812,1,24
7737,LARGE CHINESE STYLE SCISSOR,10,1751,23,2400,649,1,46
7738,SMALL CHINESE STYLE SCISSOR,6,138,4,500,362,1,8
7739,S/6 WOODEN SKITTLES IN COTTON BAG,5,996,21,2200,1204,1,42
7740,TRADITIONAL WOODEN SKIPPING ROPE,1,127,3,400,273,1,6
7741,SET OF 6 SOLDIER SKITTLES,8,100,0,100,0,1,0
7742,10 TRADITIONAL SPINNING TOPS,3,1461,17,1800,339,1,34
7743,ROTATING SILVER ANGELS T-LIGHT HLDR,1,786,11,1200,414,1,22
7744,BLACK LOVE BIRD CANDLE,4,100,0,100,0,1,0
7745,RETROSPOT CHILDRENS APRON,9,588,6,700,112,1,12
7746,HANGING GLASS ETCHED TEALIGHT,9,535,10,1100,565,1,20
7747,HANGING GLASS ETCHED TEALIGHT,8,385,17,1800,1415,1,34
7748,BLUE NEW BAROQUE CANDLESTICK CANDLE,3,995,23,2400,1405,1,46
7749,COOKING SET RETROSPOT,7,1034,16,1700,666,1,32
7750,KINGS CHOICE GIANT TUBE MATCHES,5,273,8,900,627,1,16
7751,COSY HOUR GIANT TUBE MATCHES,1,1093,10,1100,7,1,20
7752,PLACE SETTING WHITE STAR,3,1144,22,2300,1156,1,44
7753,HYACINTH BULB T-LIGHT CANDLES,3,235,4,500,265,1,8
7754,S/15 SILVER GLASS BAUBLES IN BAG,1,107,6,700,593,1,12
7755,FRENCH WC SIGN BLUE METAL,9,228,5,600,372,1,10
7756,KINGS CHOICE GIANT TUBE MATCHES,2,278,17,1800,1522,1,34
7757,78 SWEETHEART FAIRY CAKE CASES,4,1144,21,2200,1056,1,42
7758,ASSORTED COLOUR BIRD ORNAMENT,2,1345,25,2600,1255,1,50
7759,FAIRY SOAP SOAP HOLDER,2,135,4,500,365,1,8
7760,GREEN GIANT GARDEN THERMOMETER,4,2124,23,2400,276,1,46
7761,IVORY GIANT GARDEN THERMOMETER,5,100,0,100,0,1,0
7762,BLUE GIANT GARDEN THERMOMETER,10,277,2,300,23,1,4
7763,PACK OF 60 PINK PAISLEY CAKE CASES,2,486,5,600,114,1,10
7764,RETROSPOT HEART HOT WATER BOTTLE,7,125,1,200,75,1,2
7765,CHICK GREY HOT WATER BOTTLE,1,1397,14,1500,103,1,28
7766,VICTORIAN SEWING BOX SMALL ,7,327,21,2200,1873,1,42
7767,VICTORIAN SEWING BOX MEDIUM,7,172,21,2200,2028,1,42
7768,SET/10 RED POLKADOT PARTY CANDLES,5,894,11,1200,306,1,22
7769,WASHROOM METAL SIGN,3,115,2,300,185,1,4
7770,BLACK SWEETHEART BRACELET,1,795,9,1000,205,1,18
7771,DIAMANTE HAIR GRIP PACK/2 BLACK DIA,6,1584,18,1900,316,1,36
7772,BLACK DIAMANTE EXPANDABLE RING,7,1123,11,1200,77,1,22
7773,DIAMANTE HAIR GRIP PACK/2 RUBY,10,198,21,2200,2002,1,42
7774,DIAMANTE HAIR GRIP PACK/2 MONTANA,7,2559,25,2600,41,1,50
7775,BLUE SWEETHEART BRACELET,1,173,1,200,27,1,2
7776,PINK SWEETHEART BRACELET,6,573,5,600,27,1,10
7777,PURPLE SWEETHEART BRACELET,3,232,10,1100,868,1,20
7778,JUMBO BAG PINK POLKADOT,3,1446,20,2100,654,1,40
7779,JUMBO BAG RED RETROSPOT,10,947,18,1900,953,1,36
7780,ASSORTED COLOUR BIRD ORNAMENT,7,2256,23,2400,144,1,46
7781,PAPER CHAIN KIT 50'S CHRISTMAS ,1,1455,16,1700,245,1,32
7782,RIBBON REEL CHRISTMAS PRESENT ,9,341,13,1400,1059,1,26
7783,FIRST AID TIN,3,1209,25,2600,1391,1,50
7784,MAKE YOUR OWN MONSOON CARD KIT,2,131,21,2200,2069,1,42
7785,PACK OF 12 HEARTS DESIGN TISSUES ,5,1864,20,2100,236,1,40
7786,PACK OF 12 RED RETROSPOT TISSUES ,7,472,10,1100,628,1,20
7787,SOLDIERS EGG CUP ,4,2119,23,2400,281,1,46
7788,HEART IVORY TRELLIS SMALL,5,842,16,1700,858,1,32
7789,HEART FILIGREE DOVE  SMALL,5,529,11,1200,671,1,22
7790,HEART FILIGREE DOVE LARGE,4,244,4,500,256,1,8
7791,PACK 3 BOXES BIRD PANNETONE ,9,1989,24,2500,511,1,48
7792,PACK 3 BOXES CHRISTMAS PANNETONE,2,808,18,1900,1092,1,36
7793,SMALL POPCORN HOLDER,3,926,21,2200,1274,1,42
7794,PACK OF 60 PINK PAISLEY CAKE CASES,3,486,7,800,314,1,14
7795,SET OF 6 SOLDIER SKITTLES,3,931,15,1600,669,1,30
7796,SWIRLY CIRCULAR RUBBERS IN BAG,1,294,3,400,106,1,6
7797,VINTAGE PAISLEY STATIONERY SET,4,2440,24,2500,60,1,48
7798,PAPER CHAIN KIT VINTAGE CHRISTMAS,9,822,21,2200,1378,1,42
7799,SET/10 BLUE POLKADOT PARTY CANDLES,4,1087,10,1100,13,1,20
7800,RIBBON REEL SOCKS AND MITTENS,4,407,11,1200,793,1,22
7801,66 CAKE CASES VINTAGE CHRISTMAS,4,2033,20,2100,67,1,40
7802,CHRISTMAS METAL TAGS ASSORTED ,6,122,6,700,578,1,12
7803,CHRISTMAS TREE T-LIGHT HOLDER,10,995,14,1500,505,1,28
7804,STAR  T-LIGHT HOLDER ,1,100,0,100,0,1,0
7805,HEART T-LIGHT HOLDER ,2,106,2,300,194,1,4
7806,MINI FUNKY DESIGN TAPES,4,362,13,1400,1038,1,26
7807,SET OF 6 T-LIGHTS SNOWMEN,5,132,1,200,68,1,2
7808,STAR WOODEN CHRISTMAS DECORATION,6,624,23,2400,1776,1,46
7809,WOODEN HEART CHRISTMAS SCANDINAVIAN,9,847,13,1400,553,1,26
7810,CHRISTMAS RETROSPOT TREE WOOD,5,509,12,1300,791,1,24
7811,SET OF 6 T-LIGHTS SANTA,10,346,12,1300,954,1,24
7812,SET/9 CHRISTMAS T-LIGHTS SCENTED ,8,1254,13,1400,146,1,26
7813,BLUE ROSE FABRIC MIRROR,2,608,15,1600,992,1,30
7814,THREE CANVAS LUGGAGE TAGS,8,244,2,300,56,1,4
7815,RETROSPOT PARTY BAG + STICKER SET,10,249,2,300,51,1,4
7816,PLASTERS IN TIN VINTAGE PAISLEY ,1,344,15,1600,1256,1,30
7817,RETROSPOT SMALL TUBE MATCHES,10,365,5,600,235,1,10
7818,HAND WARMER SCOTTY DOG DESIGN,3,258,5,600,342,1,10
7819,3D CHRISTMAS STAMPS STICKERS ,2,511,15,1600,1089,1,30
7820,HAND WARMER SCOTTY DOG DESIGN,2,100,0,100,0,1,0
7821,HAND WARMER SCOTTY DOG DESIGN,2,601,18,1900,1299,1,36
7822,CLOTHES PEGS RETROSPOT PACK 30,3,107,14,1500,1393,1,28
7823,42 FOIL HEART CAKE CASES,9,1196,21,2200,1004,1,42
7824,CHRISTMAS METAL TAGS ASSORTED ,8,1045,23,2400,1355,1,46
7825,PACK OF 6 SWEETIE GIFT BOXES,2,120,1,200,80,1,2
7826,PACK OF 72 RETROSPOT CAKE CASES,10,1648,25,2600,952,1,50
7827,PACK OF 72 RETROSPOT CAKE CASES,9,163,1,200,37,1,2
7828,PACK OF 6 BIRDY GIFT TAGS,5,791,20,2100,1309,1,40
7829,SET/10 RED POLKADOT PARTY CANDLES,2,139,7,800,661,1,14
7830,SET/10 PINK POLKADOT PARTY CANDLES,7,374,23,2400,2026,1,46
7831,SET OF 3 NOTEBOOKS IN PARCEL,9,213,5,600,387,1,10
7832,STAR  T-LIGHT HOLDER ,9,264,6,700,436,1,12
7833,CINAMMON SET OF 9 T-LIGHTS,6,424,6,700,276,1,12
7834,ORANGE SCENTED SET/9 T-LIGHTS,4,435,23,2400,1965,1,46
7835,RIBBON REEL STRIPES DESIGN ,10,758,12,1300,542,1,24
7836,SET OF 2 TINS JARDIN DE PROVENCE,9,784,9,1000,216,1,18
7837,MAKE YOUR OWN PLAYTIME CARD KIT,10,136,2,300,164,1,4
7838,DINOSAURS  WRITING SET ,8,411,12,1300,889,1,24
7839,BALLOONS  WRITING SET ,7,2278,24,2500,222,1,48
7840,SKULLS WRITING SET ,8,847,10,1100,253,1,20
7841,VINTAGE PAISLEY STATIONERY SET,10,375,7,800,425,1,14
7842,COSY SLIPPER SHOES SMALL  RED ,7,2089,25,2600,511,1,50
7843,DOORMAT BLACK FLOCK ,9,774,21,2200,1426,1,42
7844,JUMBO  BAG BAROQUE BLACK WHITE,10,1364,14,1500,136,1,28
7845,JAM MAKING SET WITH JARS,2,411,18,1900,1489,1,36
7846,ORANGE SCENTED SET/9 T-LIGHTS,1,169,1,200,31,1,2
7847,CINAMMON SET OF 9 T-LIGHTS,4,454,6,700,246,1,12
7848,HAND WARMER SCOTTY DOG DESIGN,4,1066,16,1700,634,1,32
7849,CHRISTMAS DECOUPAGE CANDLE,7,385,7,800,415,1,14
7850,HEART T-LIGHT HOLDER ,10,1078,18,1900,822,1,36
7851,GROW YOUR OWN BASIL IN ENAMEL MUG,7,496,9,1000,504,1,18
7852,OFFICE MUG WARMER POLKADOT,2,1091,16,1700,609,1,32
7853,SMALL POPCORN HOLDER,5,747,11,1200,453,1,22
7854,JUMBO BAG DOLLY GIRL DESIGN,4,482,4,500,18,1,8
7855,JAM MAKING SET WITH JARS,10,1573,22,2300,727,1,44
7856,JAM MAKING SET PRINTED,1,1901,19,2000,99,1,38
7857,SMALL GLASS HEART TRINKET POT,10,259,4,500,241,1,8
7858,RED WOOLLY HOTTIE WHITE HEART.,7,171,1,200,29,1,2
7859,BLACK RECORD COVER FRAME,1,752,18,1900,1148,1,36
7860,"RECORD FRAME 7"" SINGLE SIZE ",10,176,23,2400,2224,1,46
7861,42 PENCILS TUBE RED RETROSPOT,7,1263,19,2000,737,1,38
7862,42 PENCILS TUBE WOODLAND,3,1368,16,1700,332,1,32
7863,SET OF 6 SOLDIER SKITTLES,9,252,2,300,48,1,4
7864,ROCKING HORSE RED CHRISTMAS ,10,250,21,2200,1950,1,42
7865,CHRISTMAS GINGHAM HEART,4,2027,25,2600,573,1,50
7866,CHRISTMAS GINGHAM STAR,9,931,16,1700,769,1,32
7867,HAND WARMER UNION JACK,9,933,18,1900,967,1,36
7868,HAND WARMER RED RETROSPOT,1,413,4,500,87,1,8
7869,REGENCY CAKESTAND 3 TIER,3,100,0,100,0,1,0
7870,JUMBO SHOPPER VINTAGE RED PAISLEY,1,1639,23,2400,761,1,46
7871,RIBBON REEL SNOWY VILLAGE,1,1924,23,2400,476,1,46
7872,VINTAGE UNION JACK BUNTING,3,807,10,1100,293,1,20
7873,JAM MAKING SET WITH JARS,3,1042,24,2500,1458,1,48
7874,RIBBON REEL STRIPES DESIGN ,7,935,13,1400,465,1,26
7875,RETRO LONGBOARD IRONING BOARD COVER,6,1557,20,2100,543,1,40
7876,3D DOG PICTURE PLAYING CARDS,9,202,7,800,598,1,14
7877,RETROSPOT CIGAR BOX MATCHES ,4,170,2,300,130,1,4
7878,SET/9 CHRISTMAS T-LIGHTS SCENTED ,6,219,4,500,281,1,8
7879,ROTATING SILVER ANGELS T-LIGHT HLDR,7,909,13,1400,491,1,26
7880,ROTATING SILVER ANGELS T-LIGHT HLDR,9,106,13,1400,1294,1,26
7881,SAVE THE PLANET COTTON TOTE BAG,1,1341,13,1400,59,1,26
7882,SET OF 20 VINTAGE CHRISTMAS NAPKINS,7,1191,17,1800,609,1,34
7883,PAPER BUNTING WHITE LACE,5,1614,20,2100,486,1,40
7884,GENTLEMAN SHIRT REPAIR KIT ,4,1600,24,2500,900,1,48
7885,CARD I LOVE LONDON ,2,295,2,300,5,1,4
7886,PAPER CHAIN KIT VINTAGE CHRISTMAS,6,308,17,1800,1492,1,34
7887,MIRRORED WALL ART FOXY,1,140,1,200,60,1,2
7888,MIRRORED WALL ART GENTS,5,824,9,1000,176,1,18
7889,AIRLINE BAG VINTAGE JET SET WHITE,4,1013,17,1800,787,1,34
7890,JAM MAKING SET PRINTED,3,1665,17,1800,135,1,34
7891,POTTING SHED SOW 'N' GROW SET,9,376,4,500,124,1,8
7892,BABUSHKA LIGHTS STRING OF 16,10,531,6,700,169,1,12
7893,REX CASH+CARRY JUMBO SHOPPER,3,988,14,1500,512,1,28
7894,AIRLINE BAG VINTAGE WORLD CHAMPION ,1,1013,24,2500,1487,1,48
7895,HAND WARMER BIRD DESIGN,7,122,12,1300,1178,1,24
7896,CHRISTMAS CRAFT LITTLE FRIENDS,1,1453,25,2600,1147,1,50
7897,PINK HEARTS PAPER GARLAND,7,104,1,200,96,1,2
7898,POTTING SHED SEED ENVELOPES,8,1058,19,2000,942,1,38
7899,HI TEC ALPINE HAND WARMER,5,100,0,100,0,1,0
7900,FELTCRAFT CHRISTMAS FAIRY,1,1093,24,2500,1407,1,48
7901,HI TEC ALPINE HAND WARMER,9,1675,22,2300,625,1,44
7902,ROTATING SILVER ANGELS T-LIGHT HLDR,9,1707,24,2500,793,1,48
7903,9 STRIPEY MICE FELTCRAFT,6,490,20,2100,1610,1,40
7904,FELTCRAFT 6 FLOWER FRIENDS,3,364,14,1500,1136,1,28
7905,CHRISTMAS CRAFT LITTLE FRIENDS,6,100,0,100,0,1,0
7906,VINTAGE UNION JACK CUSHION COVER,7,2015,20,2100,85,1,40
7907,POLYESTER FILLER PAD 45x45cm,6,113,2,300,187,1,4
7908,DOLLY GIRL LUNCH BOX,4,554,7,800,246,1,14
7909,PACK OF 12 LONDON TISSUES ,10,2551,25,2600,49,1,50
7910,CARD DOLLY GIRL ,2,2147,25,2600,453,1,50
7911,CARD BILLBOARD FONT,3,350,3,400,50,1,6
7912,RAINY LADIES BIRTHDAY CARD,10,423,12,1300,877,1,24
7913,GREY HEART HOT WATER BOTTLE,7,1143,15,1600,457,1,30
7914,RED WOOLLY HOTTIE WHITE HEART.,2,1534,21,2200,666,1,42
7915,RED WHITE SCARF  HOT WATER BOTTLE,9,413,7,800,387,1,14
7916, SET 2 TEA TOWELS I LOVE LONDON ,3,283,24,2500,2217,1,48
7917,SET OF 2 TEA TOWELS APPLE AND PEARS,4,236,2,300,64,1,4
7918,SET/2 RED RETROSPOT TEA TOWELS ,8,688,10,1100,412,1,20
7919,LOVE BUILDING BLOCK WORD,6,2098,22,2300,202,1,44
7920,HOME BUILDING BLOCK WORD,8,1250,15,1600,350,1,30
7921,ASSORTED COLOUR BIRD ORNAMENT,2,791,19,2000,1209,1,38
7922,LANTERN CREAM GAZEBO ,10,794,9,1000,206,1,18
7923,BLUE BIRDHOUSE DECORATION,9,813,10,1100,287,1,20
7924,WHITE HANGING HEART T-LIGHT HOLDER,3,1982,19,2000,18,1,38
7925,REGENCY CAKESTAND 3 TIER,5,804,11,1200,396,1,22
7926,ANTIQUE SILVER TEA GLASS ENGRAVED,4,845,10,1100,255,1,20
7927,AGED GLASS SILVER T-LIGHT HOLDER,6,378,4,500,122,1,8
7928,JAM MAKING SET WITH JARS,3,464,19,2000,1536,1,38
7929,HAND WARMER OWL DESIGN,3,1219,18,1900,681,1,36
7930,SET OF 2 WOODEN MARKET CRATES,1,875,12,1300,425,1,24
7931,SET OF 6 T-LIGHTS TOADSTOOLS,7,1183,22,2300,1117,1,44
7932,HAND WARMER UNION JACK,7,1242,12,1300,58,1,24
7933,HAND WARMER SCOTTY DOG DESIGN,7,1062,25,2600,1538,1,50
7934,CLASSIC FRENCH STYLE BASKET NATURAL,1,300,17,1800,1500,1,34
7935,CRAZY DAISY HEART DECORATION,8,132,7,800,668,1,14
7936,GIN + TONIC DIET METAL SIGN,9,220,13,1400,1180,1,26
7937,IVORY GIANT GARDEN THERMOMETER,9,1354,17,1800,446,1,34
7938,CARD HOLDER GINGHAM HEART,9,184,7,800,616,1,14
7939,SMALL STRIPES CHOCOLATE GIFT BAG ,8,100,0,100,0,1,0
7940,S/6 WOODEN SKITTLES IN COTTON BAG,3,373,12,1300,927,1,24
7941,HAND WARMER RED RETROSPOT,10,1785,22,2300,515,1,44
7942,HAND WARMER UNION JACK,10,1883,24,2500,617,1,48
7943,FRENCH WC SIGN BLUE METAL,8,436,12,1300,864,1,24
7944,PINK UNION JACK  LUGGAGE TAG,1,109,11,1200,1091,1,22
7945,"TRAY, BREAKFAST IN BED",4,228,2,300,72,1,4
7946,PIZZA PLATE IN BOX,9,154,3,400,246,1,6
7947,HEART OF WICKER LARGE,4,100,0,100,0,1,0
7948,PINK HEART DOTS HOT WATER BOTTLE,1,185,11,1200,1015,1,22
7949,PLACE SETTING WHITE HEART,2,1170,19,2000,830,1,38
7950,SET OF 4 NAPKIN CHARMS LEAVES   ,1,223,19,2000,1777,1,38
7951,SET OF 4 NAPKIN CHARMS STARS   ,1,295,2,300,5,1,4
7952,SET OF 4 NAPKIN CHARMS CUTLERY,3,499,8,900,401,1,16
7953,CARAVAN SQUARE TISSUE BOX,3,903,14,1500,597,1,28
7954,PLASTERS IN TIN SKULLS,9,100,0,100,0,1,0
7955,PLASTERS IN TIN SPACEBOY,3,138,23,2400,2262,1,46
7956,BUTTON BOX ,8,643,9,1000,357,1,18
7957,PLASTERS IN TIN VINTAGE PAISLEY ,6,166,3,400,234,1,6
7958,18 MESSAGE CARDS WITH ENVELOPES,10,1378,14,1500,122,1,28
7959,SMALL RED BABUSHKA NOTEBOOK ,1,788,10,1100,312,1,20
7960,CUPCAKE LACE PAPER SET 12,8,362,3,400,38,1,6
7961,PACK 3 BOXES CHRISTMAS PANNETONE,9,371,5,600,229,1,10
7962,HERB MARKER MINT,1,353,19,2000,1647,1,38
7963,HERB MARKER ROSEMARY,5,379,3,400,21,1,6
7964,HERB MARKER BASIL,5,475,8,900,425,1,16
7965,HERB MARKER CHIVES ,8,121,5,600,479,1,10
7966,HERB MARKER PARSLEY,5,226,7,800,574,1,14
7967,HERB MARKER THYME,6,576,6,700,124,1,12
7968,WHITE HANGING HEART T-LIGHT HOLDER,6,242,7,800,558,1,14
7969,METAL MERRY CHRISTMAS WREATH,2,127,22,2300,2173,1,44
7970,WHITE CHRISTMAS GARLAND STARS TREES,1,257,4,500,243,1,8
7971,RETROSPOT SMALL TUBE MATCHES,1,368,17,1800,1432,1,34
7972,RETROSPOT GIANT TUBE MATCHES,6,100,0,100,0,1,0
7973,PLACE SETTING WHITE STAR,4,319,18,1900,1581,1,36
7974,GROW YOUR OWN BASIL IN ENAMEL MUG,6,1495,15,1600,105,1,30
7975,42 FOIL STAR CAKE CASES ,1,390,12,1300,910,1,24
7976,42 FOIL HEART CAKE CASES,9,806,19,2000,1194,1,38
7977,PACK OF 6 SWEETIE GIFT BOXES,3,266,3,400,134,1,6
7978,PACK OF 6 HANDBAG GIFT BOXES,4,706,18,1900,1194,1,36
7979,GARLAND WOODEN HAPPY EASTER,10,100,0,100,0,1,0
7980,CALENDAR PAPER CUT DESIGN,9,276,6,700,424,1,12
7981,CALENDAR IN SEASON DESIGN,6,838,14,1500,662,1,28
7982,SMALL POPCORN HOLDER,2,205,10,1100,895,1,20
7983,BLUE PAISLEY TISSUE BOX,2,619,13,1400,781,1,26
7984,HEART OF WICKER SMALL,1,188,1,200,12,1,2
7985,SKULLS SQUARE TISSUE BOX,8,260,2,300,40,1,4
7986,SKULLS SQUARE TISSUE BOX,7,395,3,400,5,1,6
7987,WHITE HANGING HEART T-LIGHT HOLDER,9,698,14,1500,802,1,28
7988,WHITE METAL LANTERN,7,1470,18,1900,430,1,36
7989,CREAM CUPID HEARTS COAT HANGER,6,294,6,700,406,1,12
7990,KNITTED UNION FLAG HOT WATER BOTTLE,7,704,10,1100,396,1,20
7991,RED WOOLLY HOTTIE WHITE HEART.,7,1995,25,2600,605,1,50
7992,SET 7 BABUSHKA NESTING BOXES,6,810,22,2300,1490,1,44
7993,GLASS STAR FROSTED T-LIGHT HOLDER,5,1211,19,2000,789,1,38
7994,HAND WARMER UNION JACK,3,1165,12,1300,135,1,24
7995,HAND WARMER RED POLKA DOT,3,597,18,1900,1303,1,36
7996,ASSORTED COLOUR BIRD ORNAMENT,2,654,17,1800,1146,1,34
7997,POPPY'S PLAYHOUSE BEDROOM ,6,262,2,300,38,1,4
7998,POPPY'S PLAYHOUSE KITCHEN,7,139,9,1000,861,1,18
7999,FELTCRAFT PRINCESS CHARLOTTE DOLL,5,190,1,200,10,1,2
8000,IVORY KNITTED MUG COSY ,9,1586,24,2500,914,1,48
8001,BOX OF 6 ASSORTED COLOUR TEASPOONS,2,762,9,1000,238,1,18
8002,BOX OF VINTAGE JIGSAW BLOCKS ,8,2111,23,2400,289,1,46
8003,BOX OF VINTAGE ALPHABET BLOCKS,4,974,20,2100,1126,1,40
8004,HOME BUILDING BLOCK WORD,1,595,11,1200,605,1,22
8005,LOVE BUILDING BLOCK WORD,6,584,25,2600,2016,1,50
8006,RECIPE BOX WITH METAL HEART,5,261,12,1300,1039,1,24
8007,DOORMAT NEW ENGLAND,8,255,2,300,45,1,4
8008,JAM MAKING SET WITH JARS,9,170,7,800,630,1,14
8009,RED COAT RACK PARIS FASHION,5,496,12,1300,804,1,24
8010,YELLOW COAT RACK PARIS FASHION,5,739,23,2400,1661,1,46
8011,BLUE COAT RACK PARIS FASHION,2,1121,12,1300,179,1,24
8012,BATH BUILDING BLOCK WORD,6,1361,22,2300,939,1,44
8013,ALARM CLOCK BAKELIKE PINK,5,431,6,700,269,1,12
8014,ALARM CLOCK BAKELIKE RED ,2,1818,23,2400,582,1,46
8015,ALARM CLOCK BAKELIKE GREEN,9,370,19,2000,1630,1,38
8016,PANDA AND BUNNIES STICKER SHEET,6,249,25,2600,2351,1,50
8017,STARS GIFT TAPE ,9,491,10,1100,609,1,20
8018,INFLATABLE POLITICAL GLOBE ,1,217,3,400,183,1,6
8019,VINTAGE HEADS AND TAILS CARD GAME ,4,427,10,1100,673,1,20
8020,SET/2 RED RETROSPOT TEA TOWELS ,7,445,18,1900,1455,1,36
8021,ROUND SNACK BOXES SET OF4 WOODLAND ,3,1423,22,2300,877,1,44
8022,SPACEBOY LUNCH BOX ,3,814,18,1900,1086,1,36
8023,LUNCH BOX I LOVE LONDON,6,220,3,400,180,1,6
8024,CIRCUS PARADE LUNCH BOX ,10,1515,17,1800,285,1,34
8025,CHARLOTTE BAG DOLLY GIRL DESIGN,5,1050,17,1800,750,1,34
8026,RED TOADSTOOL LED NIGHT LIGHT,6,263,7,800,537,1,14
8027, SET 2 TEA TOWELS I LOVE LONDON ,3,993,24,2500,1507,1,48
8028,VINTAGE SEASIDE JIGSAW PUZZLES,5,316,8,900,584,1,16
8029,MINI JIGSAW CIRCUS PARADE ,5,1496,20,2100,604,1,40
8030,MINI JIGSAW SPACEBOY,4,609,6,700,91,1,12
8031,MINI PAINT SET VINTAGE ,4,1140,24,2500,1360,1,48
8032,POSTAGE,8,409,11,1200,791,1,22
8033,PAPER CHAIN KIT 50'S CHRISTMAS ,1,552,9,1000,448,1,18
8034,HAND WARMER RED POLKA DOT,1,365,8,900,535,1,16
8035,HAND WARMER UNION JACK,8,468,16,1700,1232,1,32
8036,WHITE HANGING HEART T-LIGHT HOLDER,3,494,13,1400,906,1,26
8037,WHITE METAL LANTERN,2,653,18,1900,1247,1,36
8038,CREAM CUPID HEARTS COAT HANGER,10,541,7,800,259,1,14
8039,EDWARDIAN PARASOL RED,3,462,19,2000,1538,1,38
8040,RETRO COFFEE MUGS ASSORTED,4,167,3,400,233,1,6
8041,SAVE THE PLANET MUG,8,124,6,700,576,1,12
8042,VINTAGE BILLBOARD DRINK ME MUG,2,307,3,400,93,1,6
8043,VINTAGE BILLBOARD LOVE/HATE MUG,3,209,3,400,191,1,6
8044,WOOD 2 DRAWER CABINET WHITE FINISH,1,246,3,400,154,1,6
8045,WOOD S/3 CABINET ANT WHITE FINISH,4,2365,23,2400,35,1,46
8046,WOODEN PICTURE FRAME WHITE FINISH,1,1203,23,2400,1197,1,46
8047,WOODEN FRAME ANTIQUE WHITE ,6,255,3,400,145,1,6
8048,KNITTED UNION FLAG HOT WATER BOTTLE,6,120,3,400,280,1,6
8049,RED WOOLLY HOTTIE WHITE HEART.,8,868,23,2400,1532,1,46
8050,SET 7 BABUSHKA NESTING BOXES,3,898,24,2500,1602,1,48
8051,GLASS STAR FROSTED T-LIGHT HOLDER,1,1221,12,1300,79,1,24
8052,VICTORIAN SEWING BOX LARGE,2,138,1,200,62,1,2
8053,WHITE HANGING HEART T-LIGHT HOLDER,7,1555,18,1900,345,1,36
8054,WHITE METAL LANTERN,2,254,14,1500,1246,1,28
8055,CREAM CUPID HEARTS COAT HANGER,6,1441,19,2000,559,1,38
8056,EDWARDIAN PARASOL RED,3,100,0,100,0,1,0
8057,RETRO COFFEE MUGS ASSORTED,6,365,3,400,35,1,6
8058,SAVE THE PLANET MUG,8,691,10,1100,409,1,20
8059,VINTAGE BILLBOARD DRINK ME MUG,2,702,8,900,198,1,16
8060,VINTAGE BILLBOARD LOVE/HATE MUG,5,117,2,300,183,1,4
8061,WOOD 2 DRAWER CABINET WHITE FINISH,8,257,5,600,343,1,10
8062,WOOD S/3 CABINET ANT WHITE FINISH,7,409,24,2500,2091,1,48
8063,WOODEN PICTURE FRAME WHITE FINISH,3,172,3,400,228,1,6
8064,WOODEN FRAME ANTIQUE WHITE ,9,917,11,1200,283,1,22
8065,KNITTED UNION FLAG HOT WATER BOTTLE,2,632,23,2400,1768,1,46
8066,RED WOOLLY HOTTIE WHITE HEART.,8,1108,14,1500,392,1,28
8067,SET 7 BABUSHKA NESTING BOXES,7,172,4,500,328,1,8
8068,GLASS STAR FROSTED T-LIGHT HOLDER,5,836,24,2500,1664,1,48
8069,HOT WATER BOTTLE TEA AND SYMPATHY,1,172,4,500,328,1,8
8070,RED HANGING HEART T-LIGHT HOLDER,8,611,6,700,89,1,12
8071,HAND WARMER RED POLKA DOT,5,922,22,2300,1378,1,44
8072,HAND WARMER UNION JACK,1,620,12,1300,680,1,24
8073,JUMBO BAG PINK POLKADOT,2,1063,13,1400,337,1,26
8074,JUMBO  BAG BAROQUE BLACK WHITE,3,1242,19,2000,758,1,38
8075,JUMBO BAG CHARLIE AND LOLA TOYS,9,1141,13,1400,259,1,26
8076,STRAWBERRY CHARLOTTE BAG,6,915,18,1900,985,1,36
8077,RED 3 PIECE RETROSPOT CUTLERY SET,4,578,6,700,122,1,12
8078,BLUE 3 PIECE POLKADOT CUTLERY SET,3,553,11,1200,647,1,22
8079,SET/6 RED SPOTTY PAPER PLATES,2,199,5,600,401,1,10
8080,LUNCH BAG RED RETROSPOT,1,265,9,1000,735,1,18
8081,STRAWBERRY LUNCH BOX WITH CUTLERY,4,342,23,2400,2058,1,46
8082,LUNCH BOX WITH CUTLERY RETROSPOT ,5,904,22,2300,1396,1,44
8083,PACK OF 72 RETROSPOT CAKE CASES,6,142,1,200,58,1,2
8084,PACK OF 60 DINOSAUR CAKE CASES,3,651,25,2600,1949,1,50
8085,PACK OF 60 PINK PAISLEY CAKE CASES,9,590,23,2400,1810,1,46
8086,67 TEATIME FAIRY CAKE CASES,9,100,0,100,0,1,0
8087,TOMATO CHARLIE+LOLA COASTER SET,9,692,8,900,208,1,16
8088,CHARLIE & LOLA WASTEPAPER BIN FLORA,9,398,14,1500,1102,1,28
8089,RED CHARLIE+LOLA PERSONAL DOORSIGN,2,634,22,2300,1666,1,44
8090,JUMBO STORAGE BAG SUKI,10,1062,19,2000,938,1,38
8091,JUMBO BAG PINK VINTAGE PAISLEY,10,419,8,900,481,1,16
8092,JAM MAKING SET PRINTED,6,127,7,800,673,1,14
8093,RETROSPOT TEA SET CERAMIC 11 PC ,1,738,16,1700,962,1,32
8094,GIRLY PINK TOOL SET,6,241,4,500,259,1,8
8095,JUMBO SHOPPER VINTAGE RED PAISLEY,7,412,11,1200,788,1,22
8096,"AIRLINE LOUNGE,METAL SIGN",7,885,16,1700,815,1,32
8097,WHITE SPOT RED CERAMIC DRAWER KNOB,6,928,15,1600,672,1,30
8098,RED DRAWER KNOB ACRYLIC EDWARDIAN,6,381,3,400,19,1,6
8099,CLEAR DRAWER KNOB ACRYLIC EDWARDIAN,10,1598,15,1600,2,1,30
8100,PHOTO CLIP LINE,4,1649,16,1700,51,1,32
8101,FELT EGG COSY CHICKEN,6,1142,11,1200,58,1,22
8102,PIGGY BANK RETROSPOT ,1,974,25,2600,1626,1,50
8103,SKULL SHOULDER BAG,2,390,12,1300,910,1,24
8104,YOU'RE CONFUSING ME METAL SIGN ,4,180,3,400,220,1,6
8105,COOK WITH WINE METAL SIGN ,10,870,17,1800,930,1,34
8106,GIN + TONIC DIET METAL SIGN,6,105,5,600,495,1,10
8107,YELLOW BREAKFAST CUP AND SAUCER,6,526,12,1300,774,1,24
8108,PINK BREAKFAST CUP AND SAUCER ,9,112,8,900,788,1,16
8109,PAPER CHAIN KIT 50'S CHRISTMAS ,3,717,21,2200,1483,1,42
8110,PAPER CHAIN KIT RETROSPOT,6,130,9,1000,870,1,18
8111,SMALL HEART FLOWERS HOOK ,9,103,11,1200,1097,1,22
8112,PHOTO CLIP LINE,4,1137,12,1300,163,1,24
8113,TEA TIME DES TEA COSY,10,333,23,2400,2067,1,46
8114,FELT EGG COSY WHITE RABBIT ,8,342,7,800,458,1,14
8115,ZINC WILLIE WINKIE  CANDLE STICK,4,1631,21,2200,569,1,42
8116,CERAMIC CHERRY CAKE MONEY BANK,10,111,1,200,89,1,2
8117,RETROSPOT LARGE MILK JUG,4,758,7,800,42,1,14
8118,SET OF 6 FUNKY BEAKERS,6,769,8,900,131,1,16
8119,EDWARDIAN PARASOL BLACK,5,1367,15,1600,233,1,30
8120,EDWARDIAN PARASOL NATURAL,1,337,8,900,563,1,16
8121,CERAMIC STRAWBERRY CAKE MONEY BANK,9,896,21,2200,1304,1,42
8122,BLUE OWL SOFT TOY,5,252,4,500,248,1,8
8123,BALLOON ART MAKE YOUR OWN FLOWERS,9,1415,25,2600,1185,1,50
8124,RED TOADSTOOL LED NIGHT LIGHT,2,941,13,1400,459,1,26
8125,GLASS CLOCHE SMALL,4,1315,18,1900,585,1,36
8126,GUMBALL MONOCHROME COAT RACK,3,377,11,1200,823,1,22
8127,DOORMAT FANCY FONT HOME SWEET HOME,6,610,9,1000,390,1,18
8128,Discount,5,972,12,1300,328,1,24
8129,INFLATABLE POLITICAL GLOBE ,2,1957,22,2300,343,1,44
8130,VINTAGE SNAKES & LADDERS,3,237,3,400,163,1,6
8131,CHOCOLATE CALCULATOR,5,534,15,1600,1066,1,30
8132,JUMBO SHOPPER VINTAGE RED PAISLEY,4,690,8,900,210,1,16
8133,RECYCLING BAG RETROSPOT ,1,186,10,1100,914,1,20
8134,TOY TIDY PINK POLKADOT,10,233,24,2500,2267,1,48
8135,ANTIQUE GLASS DRESSING TABLE POT,4,256,2,300,44,1,4
8136,ALARM CLOCK BAKELIKE GREEN,6,2217,22,2300,83,1,44
8137,IVORY GIANT GARDEN THERMOMETER,2,174,3,400,226,1,6
8138,10 TIER CAKE TIN GREEN AND CREAM,8,1927,24,2500,573,1,48
8139,10 TIER CAKE TIN RED AND CREAM,7,1208,20,2100,892,1,40
8140,SET 3 WICKER OVAL BASKETS W LIDS,9,371,10,1100,729,1,20
8141,SET OF 3 COLOURED  FLYING DUCKS,7,856,25,2600,1744,1,50
8142,WOOD BLACK BOARD ANT WHITE FINISH,5,927,11,1200,273,1,22
8143,COLOUR GLASS T-LIGHT HOLDER HANGING,4,842,24,2500,1658,1,48
8144,HANGING METAL HEART LANTERN,5,678,12,1300,622,1,24
8145,HANGING MEDINA LANTERN SMALL,7,753,11,1200,447,1,22
8146,NATURAL SLATE HEART CHALKBOARD ,4,111,10,1100,989,1,20
8147,HEART OF WICKER SMALL,9,1596,22,2300,704,1,44
8148,HEART OF WICKER LARGE,4,269,7,800,531,1,14
8149,WHITE LOVEBIRD LANTERN,10,639,7,800,161,1,14
8150,CLASSIC METAL BIRDCAGE PLANT HOLDER,8,525,11,1200,675,1,22
8151,CREAM HEART CARD HOLDER,7,657,8,900,243,1,16
8152,ENAMEL FLOWER JUG CREAM,7,924,23,2400,1476,1,46
8153,ENAMEL FIRE BUCKET CREAM,1,1618,16,1700,82,1,32
8154,ENAMEL BREAD BIN CREAM,4,2370,24,2500,130,1,48
8155,SET 3 WICKER OVAL BASKETS W LIDS,1,535,5,600,65,1,10
8156,JAM MAKING SET PRINTED,7,1236,13,1400,164,1,26
8157,JAM MAKING SET WITH JARS,5,314,24,2500,2186,1,48
8158,JUMBO BAG DOLLY GIRL DESIGN,9,304,13,1400,1096,1,26
8159,TRADITIONAL CHRISTMAS RIBBONS,10,1008,17,1800,792,1,34
8160,ORGANISER WOOD ANTIQUE WHITE ,7,693,8,900,207,1,16
8161,LUNCH BAG DOLLY GIRL DESIGN,7,1261,25,2600,1339,1,50
8162,WHITE WIRE EGG HOLDER,2,392,10,1100,708,1,20
8163,JUMBO  BAG BAROQUE BLACK WHITE,4,439,20,2100,1661,1,40
8164,JUMBO BAG RED RETROSPOT,10,267,5,600,333,1,10
8165,CHILLI LIGHTS,5,534,10,1100,566,1,20
8166,LIGHT GARLAND BUTTERFILES PINK,2,549,21,2200,1651,1,42
8167,WOODEN OWLS LIGHT GARLAND ,7,659,21,2200,1541,1,42
8168,FAIRY TALE COTTAGE NIGHTLIGHT,9,203,2,300,97,1,4
8169,RED TOADSTOOL LED NIGHT LIGHT,7,392,4,500,108,1,8
8170,HOME BUILDING BLOCK WORD,3,2258,23,2400,142,1,46
8171,LOVE BUILDING BLOCK WORD,1,172,7,800,628,1,14
8172,DOORMAT FANCY FONT HOME SWEET HOME,4,358,5,600,242,1,10
8173,HOME SMALL WOOD LETTERS,3,1613,20,2100,487,1,40
8174,GINGHAM HEART  DOORSTOP RED,4,468,6,700,232,1,12
8175,FIVE HEART HANGING DECORATION,10,1098,21,2200,1102,1,42
8176,HANGING METAL HEART LANTERN,9,207,4,500,293,1,8
8177,ASSORTED BOTTLE TOP  MAGNETS ,10,388,14,1500,1112,1,28
8178,FRIDGE MAGNETS US DINER ASSORTED,6,165,6,700,535,1,12
8179,HOMEMADE JAM SCENTED CANDLES,5,550,19,2000,1450,1,38
8180,FRIDGE MAGNETS LES ENFANTS ASSORTED,5,297,5,600,303,1,10
8181,ROSE CARAVAN DOORSTOP,8,1116,17,1800,684,1,34
8182,HEART OF WICKER SMALL,2,1085,10,1100,15,1,20
8183,12 HOOK HANGER MAGIC TOADSTOOL,7,156,7,800,644,1,14
8184,CHRISTMAS LIGHTS 10 REINDEER,8,1113,11,1200,87,1,22
8185,VINTAGE UNION JACK CUSHION COVER,8,1148,15,1600,452,1,30
8186,VINTAGE HEADS AND TAILS CARD GAME ,4,100,0,100,0,1,0
8187,SET OF 3 COLOURED  FLYING DUCKS,3,783,25,2600,1817,1,50
8188,SET OF 3 GOLD FLYING DUCKS,9,945,20,2100,1155,1,40
8189,RED RETROSPOT UMBRELLA,7,1400,22,2300,900,1,44
8190,BLACK/BLUE POLKADOT UMBRELLA,8,329,5,600,271,1,10
8191,RED DINER WALL CLOCK,1,1163,23,2400,1237,1,46
8192,ALARM CLOCK BAKELIKE GREEN,5,313,4,500,187,1,8
8193,ALARM CLOCK BAKELIKE RED ,3,918,12,1300,382,1,24
8194,BLUE DINER WALL CLOCK,1,187,1,200,13,1,2
8195,IVORY DINER WALL CLOCK,6,1025,18,1900,875,1,36
8196,LARGE HEART MEASURING SPOONS,3,387,10,1100,713,1,20
8197,SMALL HEART MEASURING SPOONS,5,100,0,100,0,1,0
8198,CHRISTMAS LIGHTS 10 REINDEER,4,157,3,400,243,1,6
8199,JAM MAKING SET WITH JARS,6,376,14,1500,1124,1,28
8200,JAM MAKING SET PRINTED,1,253,5,600,347,1,10
8201,JAM JAR WITH PINK LID,3,373,4,500,127,1,8
8202,JAM JAR WITH GREEN LID,2,189,13,1400,1211,1,26
8203,ROSE COTTAGE KEEPSAKE BOX ,8,152,1,200,48,1,2
8204,HANGING HEART ZINC T-LIGHT HOLDER,6,191,13,1400,1209,1,26
8205,PAPER CHAIN KIT VINTAGE CHRISTMAS,6,1091,17,1800,709,1,34
8206,DISCO BALL CHRISTMAS DECORATION,9,280,3,400,120,1,6
8207,WHITE HANGING HEART T-LIGHT HOLDER,7,2118,23,2400,282,1,46
8208,SMALL POPCORN HOLDER,8,319,9,1000,681,1,18
8209,LARGE POPCORN HOLDER ,9,1819,23,2400,581,1,46
8210,RETROSPOT LARGE MILK JUG,7,470,9,1000,530,1,18
8211,SET/20 RED RETROSPOT PAPER NAPKINS ,4,2077,20,2100,23,1,40
8212,SET/6 RED SPOTTY PAPER PLATES,7,1584,18,1900,316,1,36
8213,SET/6 RED SPOTTY PAPER CUPS,9,953,17,1800,847,1,34
8214,POLKADOT RAIN HAT ,7,1580,25,2600,1020,1,50
8215,DELUXE SEWING KIT ,4,100,0,100,0,1,0
8216,RETROSPOT HEART HOT WATER BOTTLE,6,1420,24,2500,1080,1,48
8217,KNITTED UNION FLAG HOT WATER BOTTLE,2,1821,20,2100,279,1,40
8218,ENGLISH ROSE HOT WATER BOTTLE,2,122,17,1800,1678,1,34
8219,PHOTO CUBE,3,367,8,900,533,1,16
8220,HOMEMADE JAM SCENTED CANDLES,4,463,13,1400,937,1,26
8221,JUMBO BAG RED RETROSPOT,5,941,13,1400,459,1,26
8222,PLASTERS IN TIN CIRCUS PARADE ,8,1044,17,1800,756,1,34
8223,PACK OF 12 PINK PAISLEY TISSUES ,3,125,3,400,275,1,6
8224,PACK OF 12 BLUE PAISLEY TISSUES ,2,1063,18,1900,837,1,36
8225,PACK OF 12 RED RETROSPOT TISSUES ,6,1407,16,1700,293,1,32
8226,CHICK GREY HOT WATER BOTTLE,9,634,24,2500,1866,1,48
8227,PLASTERS IN TIN VINTAGE PAISLEY ,8,1083,18,1900,817,1,36
8228,PLASTERS IN TIN SKULLS,8,704,12,1300,596,1,24
8229,10 STRIPEY MICE FELTCRAFT,4,222,7,800,578,1,14
8230,SET OF 6 SOLDIER SKITTLES,6,333,17,1800,1467,1,34
8231,TRADITIONAL WOODEN SKIPPING ROPE,5,1697,21,2200,503,1,42
8232,WOODEN BOX OF DOMINOES,7,200,21,2200,2000,1,42
8233,RUSTIC  SEVENTEEN DRAWER SIDEBOARD,3,530,8,900,370,1,16
8234,PARTY CONES CARNIVAL ASSORTED,7,732,23,2400,1668,1,46
8235,PARTY CONES CANDY ASSORTED,3,371,16,1700,1329,1,32
8236,PICNIC BASKET WICKER SMALL,3,285,2,300,15,1,4
8237,ASSORTED COLOUR BIRD ORNAMENT,2,1157,24,2500,1343,1,48
8238,STAR DECORATION PAINTED ZINC ,6,1671,20,2100,429,1,40
8239,RETROSPOT LAMP,2,288,5,600,312,1,10
8240,"FANCY FONT BIRTHDAY CARD, ",3,709,12,1300,591,1,24
8241,HAND WARMER UNION JACK,4,583,6,700,117,1,12
8242,HAND WARMER SCOTTY DOG DESIGN,5,766,16,1700,934,1,32
8243,HAND WARMER OWL DESIGN,10,561,10,1100,539,1,20
8244,HAND WARMER RED RETROSPOT,8,134,1,200,66,1,2
8245,RETROSPOT HEART HOT WATER BOTTLE,5,1372,22,2300,928,1,44
8246,DOG BOWL CHASING BALL DESIGN,4,596,14,1500,904,1,28
8247,CLOTHES PEGS RETROSPOT PACK 31,4,153,15,1600,1447,1,30
8248,HAND OVER THE CHOCOLATE   SIGN ,2,146,2,300,154,1,4
8249,WHITE HANGING HEART T-LIGHT HOLDER,5,1226,21,2200,974,1,42
8250,TRAVEL SEWING KIT,1,433,14,1500,1067,1,28
8251,BLACK HEART CARD HOLDER,8,363,16,1700,1337,1,32
8252,ASSORTED COLOUR BIRD ORNAMENT,5,202,6,700,498,1,12
8253,PACK OF 60 PINK PAISLEY CAKE CASES,10,147,1,200,53,1,2
8254,67 TEATIME FAIRY CAKE CASES,1,853,10,1100,247,1,20
8255,PACK OF 72 RETROSPOT CAKE CASES,7,367,8,900,533,1,16
8256,CHICK GREY HOT WATER BOTTLE,3,2031,21,2200,169,1,42
8257,SMALL GLASS HEART TRINKET POT,4,513,7,800,287,1,14
8258,ALARM CLOCK BAKELIKE IVORY,10,367,13,1400,1033,1,26
8259,ALARM CLOCK BAKELIKE RED ,3,620,17,1800,1180,1,34
8260,ALARM CLOCK BAKELIKE ORANGE,9,2434,25,2600,166,1,50
8261,ALARM CLOCK BAKELIKE GREEN,9,151,14,1500,1349,1,28
8262,HOT WATER BOTTLE TEA AND SYMPATHY,6,759,15,1600,841,1,30
8263,HAND WARMER BIRD DESIGN,7,555,6,700,145,1,12
8264,HAND WARMER SCOTTY DOG DESIGN,6,186,15,1600,1414,1,30
8265,WHITE HANGING HEART T-LIGHT HOLDER,4,450,6,700,250,1,12
8266,WHITE METAL LANTERN,3,1422,14,1500,78,1,28
8267,CREAM CUPID HEARTS COAT HANGER,9,946,12,1300,354,1,24
8268,EDWARDIAN PARASOL BLACK,9,451,10,1100,649,1,20
8269,EDWARDIAN PARASOL RED,6,217,2,300,83,1,4
8270,RETRO COFFEE MUGS ASSORTED,9,374,9,1000,626,1,18
8271,SAVE THE PLANET MUG,3,772,22,2300,1528,1,44
8272,VINTAGE BILLBOARD DRINK ME MUG,10,1337,24,2500,1163,1,48
8273,VINTAGE BILLBOARD LOVE/HATE MUG,1,727,13,1400,673,1,26
8274,WOOD 2 DRAWER CABINET WHITE FINISH,10,274,8,900,626,1,16
8275,WOOD S/3 CABINET ANT WHITE FINISH,8,866,14,1500,634,1,28
8276,WOODEN PICTURE FRAME WHITE FINISH,2,287,2,300,13,1,4
8277,WOODEN FRAME ANTIQUE WHITE ,6,369,4,500,131,1,8
8278,KNITTED UNION FLAG HOT WATER BOTTLE,6,1120,17,1800,680,1,34
8279,RED WOOLLY HOTTIE WHITE HEART.,9,165,9,1000,835,1,18
8280,SET 7 BABUSHKA NESTING BOXES,1,1228,15,1600,372,1,30
8281,IVORY EMBROIDERED QUILT ,8,1523,18,1900,377,1,36
8282,GLASS STAR FROSTED T-LIGHT HOLDER,8,100,4,500,400,1,8
8283,SET OF 3 BLACK FLYING DUCKS,2,107,2,300,193,1,4
8284,SET OF 3 COLOURED  FLYING DUCKS,5,100,0,100,0,1,0
8285,PACK OF 12 RED RETROSPOT TISSUES ,4,176,3,400,224,1,6
8286,RED RETROSPOT MUG,8,160,1,200,40,1,2
8287,BABUSHKA LIGHTS STRING OF 17,6,840,10,1100,260,1,20
8288,PIGGY BANK RETROSPOT ,3,107,1,200,93,1,2
8289,SET 7 BABUSHKA NESTING BOXES,1,973,22,2300,1327,1,44
8290,DOORMAT FAIRY CAKE,4,210,3,400,190,1,6
8291,HAND WARMER RED RETROSPOT,4,365,4,500,135,1,8
8292,HAND WARMER SCOTTY DOG DESIGN,9,1519,20,2100,581,1,40
8293,HAND WARMER OWL DESIGN,1,1229,17,1800,571,1,34
8294,STRAWBERRY CERAMIC TRINKET BOX,1,574,6,700,126,1,12
8295,PINK DOUGHNUT TRINKET POT ,5,914,25,2600,1686,1,50
8296,SILK PURSE BABUSHKA PINK,1,1594,15,1600,6,1,30
8297,HOT WATER BOTTLE TEA AND SYMPATHY,1,284,17,1800,1516,1,34
8298,HOT WATER BOTTLE I AM SO POORLY,9,236,6,700,464,1,12
8299,CHOCOLATE HOT WATER BOTTLE,3,212,4,500,288,1,8
8300,WHITE SKULL HOT WATER BOTTLE ,7,1498,21,2200,702,1,42
8301,SCOTTIE DOG HOT WATER BOTTLE,8,227,2,300,73,1,4
8302,HAND WARMER RED POLKA DOT,1,1147,11,1200,53,1,22
8303,HAND WARMER UNION JACK,8,1352,24,2500,1148,1,48
8304,HOMEMADE JAM SCENTED CANDLES,4,181,1,200,19,1,2
8305,BIRD HOUSE HOT WATER BOTTLE,10,130,1,200,70,1,2
8306,BOUDOIR SQUARE TISSUE BOX,1,671,24,2500,1829,1,48
8307,SKULLS SQUARE TISSUE BOX,7,1566,15,1600,34,1,30
8308,PHOTO FRAME CORNICE,6,416,16,1700,1284,1,32
8309,SILK PURSE BABUSHKA RED,6,100,1,200,100,1,2
8310,PICTURE DOMINOES,7,1504,16,1700,196,1,32
8311,S/6 SEW ON CROCHET FLOWERS,2,2141,23,2400,259,1,46
8312,SCANDINAVIAN REDS RIBBONS,3,2307,25,2600,293,1,50
8313,BALLOONS  WRITING SET ,2,1600,15,1600,0,1,30
8314,JAM MAKING SET PRINTED,6,1326,14,1500,174,1,28
8315,LAVENDER INCENSE IN TIN,4,2336,24,2500,164,1,48
8316,TV DINNER TRAY VINTAGE PAISLEY,2,1567,22,2300,733,1,44
8317,SET OF 4 ENGLISH ROSE PLACEMATS,2,318,8,900,582,1,16
8318,SET OF 4 ENGLISH ROSE COASTERS,4,124,4,500,376,1,8
8319,TRIPLE PHOTO FRAME CORNICE ,1,1198,18,1900,702,1,36
8320,FAMILY PHOTO FRAME CORNICE,3,886,16,1700,814,1,32
8321,MIRRORED DISCO BALL ,9,953,13,1400,447,1,26
8322,DISCO BALL ROTATOR BATTERY OPERATED,10,761,22,2300,1539,1,44
8323,SILVER LOOKING MIRROR,1,1093,15,1600,507,1,30
8324,LADIES & GENTLEMEN METAL SIGN,10,895,8,900,5,1,16
8325,METAL SIGN HER DINNER IS SERVED ,3,100,0,100,0,1,0
8326,YOU'RE CONFUSING ME METAL SIGN ,7,936,21,2200,1264,1,42
8327,DOORMAT TOPIARY,10,292,12,1300,1008,1,24
8328,BATHROOM METAL SIGN,2,2326,24,2500,174,1,48
8329,KITCHEN METAL SIGN,1,1346,22,2300,954,1,44
8330,TOILET METAL SIGN,10,1013,18,1900,887,1,36
8331,METAL SIGN TAKE IT OR LEAVE IT ,7,340,13,1400,1060,1,26
8332,I'M ON HOLIDAY METAL SIGN,9,2059,21,2200,141,1,42
8333,GROW YOUR OWN BASIL IN ENAMEL MUG,9,329,6,700,371,1,12
8334,SET/10 PINK POLKADOT PARTY CANDLES,1,821,20,2100,1279,1,40
8335,SET 20 NAPKINS FAIRY CAKES DESIGN ,5,340,7,800,460,1,14
8336,67 TEATIME FAIRY CAKE CASES,5,333,21,2200,1867,1,42
8337,SET OF 6 T-LIGHTS SNOWMEN,7,468,12,1300,832,1,24
8338,SET OF 6 T-LIGHTS SANTA,3,1535,21,2200,665,1,42
8339,SET OF 9 HEART SHAPED BALLOONS,9,1306,16,1700,394,1,32
8340,SANDWICH BATH SPONGE,3,250,9,1000,750,1,18
8341,APPLE BATH SPONGE,1,100,0,100,0,1,0
8342,STRAWBERRY BATH SPONGE ,6,936,14,1500,564,1,28
8343,BLACK PIRATE TREASURE CHEST,2,1047,18,1900,853,1,36
8344,STAR PORTABLE TABLE LIGHT ,6,100,0,100,0,1,0
8345,SNOWFLAKE PORTABLE TABLE LIGHT ,4,622,14,1500,878,1,28
8346,PINK OVAL JEWELLED MIRROR,2,264,11,1200,936,1,22
8347,RETROSPOT CIGAR BOX MATCHES ,3,109,18,1900,1791,1,36
8348,COSY HOUR GIANT TUBE MATCHES,4,238,8,900,662,1,16
8349,JAZZ HEARTS PURSE NOTEBOOK,10,1314,25,2600,1286,1,50
8350,LUNCH BAG DOLLY GIRL DESIGN,10,1086,23,2400,1314,1,46
8351,WHITE HANGING HEART T-LIGHT HOLDER,9,198,1,200,2,1,2
8352,CANDLEHOLDER PINK HANGING HEART,6,202,11,1200,998,1,22
8353,WOOD 2 DRAWER CABINET WHITE FINISH,7,188,2,300,112,1,4
8354,ASSORTED COLOUR MINI CASES,3,2065,21,2200,135,1,42
8355,LUNCH BAG RED RETROSPOT,1,2438,24,2500,62,1,48
8356,LUNCH BAG SPACEBOY DESIGN ,6,392,8,900,508,1,16
8357,LUNCH BAG WOODLAND,2,874,12,1300,426,1,24
8358,LUNCH BAG PINK POLKADOT,4,358,10,1100,742,1,20
8359,GUMBALL COAT RACK,10,655,9,1000,345,1,18
8360,BLUE NEW BAROQUE CANDLESTICK CANDLE,9,359,24,2500,2141,1,48
8361,PINK NEW BAROQUECANDLESTICK CANDLE,10,2308,23,2400,92,1,46
8362,FAIRY CAKE FLANNEL ASSORTED COLOUR,6,809,11,1200,391,1,22
8363,BREAD BIN DINER STYLE PINK,9,1940,20,2100,160,1,40
8364,JUMBO BAG CHARLIE AND LOLA TOYS,1,269,9,1000,731,1,18
8365,TEA TIME TABLE CLOTH,3,996,9,1000,4,1,18
8366,ENGLISH ROSE HOT WATER BOTTLE,3,190,23,2400,2210,1,46
8367,ENAMEL FIRE BUCKET CREAM,2,428,16,1700,1272,1,32
8368,PICNIC BASKET WICKER SMALL,6,302,9,1000,698,1,18
8369,PAPER CHAIN KIT 50'S CHRISTMAS ,2,100,0,100,0,1,0
8370,PAPER CHAIN KIT VINTAGE CHRISTMAS,2,1447,18,1900,453,1,36
8371,HOT WATER BOTTLE BABUSHKA ,3,317,16,1700,1383,1,32
8372,HAND WARMER BIRD DESIGN,9,961,14,1500,539,1,28
8373,POSTAGE,4,1005,21,2200,1195,1,42
8374,HEART IVORY TRELLIS SMALL,10,391,3,400,9,1,6
8375,CLEAR DRAWER KNOB ACRYLIC EDWARDIAN,10,477,19,2000,1523,1,38
8376,PINK DRAWER KNOB ACRYLIC EDWARDIAN,5,100,0,100,0,1,0
8377,GREEN DRAWER KNOB ACRYLIC EDWARDIAN,8,1867,21,2200,333,1,42
8378,BLUE DRAWER KNOB ACRYLIC EDWARDIAN,1,1237,12,1300,63,1,24
8379,HEART OF WICKER SMALL,4,679,13,1400,721,1,26
8380,SMALL POPCORN HOLDER,1,1782,18,1900,118,1,36
8381,SET 6 FOOTBALL CELEBRATION CANDLES,3,1364,20,2100,736,1,40
8382,SET OF 6 GIRLS CELEBRATION CANDLES,1,2100,23,2400,300,1,46
8383,ROMANTIC PINKS RIBBONS ,7,100,0,100,0,1,0
8384,BRIGHT BLUES RIBBONS ,10,1288,20,2100,812,1,40
8385,SCANDINAVIAN REDS RIBBONS,9,104,6,700,596,1,12
8386,CHOCOLATE BOX RIBBONS ,7,1137,20,2100,963,1,40
8387,PARTY INVITES FOOTBALL,1,1315,15,1600,285,1,30
8388,PARTY INVITES JAZZ HEARTS,7,620,11,1200,580,1,22
8389,PARTY INVITES SPACEMAN,8,1168,19,2000,832,1,38
8390,SET OF 3 BUTTERFLY COOKIE CUTTERS,5,380,7,800,420,1,14
8391,SET OF 3 HEART COOKIE CUTTERS,3,506,10,1100,594,1,20
8392,10 PIECE SPACEBOY COOKIE CUTTER SET,6,1635,16,1700,65,1,32
8393,PACK OF 72 SKULL CAKE CASES,6,844,9,1000,156,1,18
8394,PACK OF 60 SPACEBOY CAKE CASES,6,630,8,900,270,1,16
8395,PACK OF 72 RETROSPOT CAKE CASES,1,1869,19,2000,131,1,38
8396,79 SWEETHEART FAIRY CAKE CASES,5,907,17,1800,893,1,34
8397,PACK OF 60 DINOSAUR CAKE CASES,1,238,12,1300,1062,1,24
8398,LUNCH BAG SUKI  DESIGN ,7,225,3,400,175,1,6
8399,LUNCH BAG CARS BLUE,1,262,25,2600,2338,1,50
8400,LUNCH BAG  BLACK SKULL.,1,100,0,100,0,1,0
8401,HEART IVORY TRELLIS LARGE,9,130,4,500,370,1,8
8402,SET/5 RED RETROSPOT LID GLASS BOWLS,8,612,16,1700,1088,1,32
8403,WHITE HANGING HEART T-LIGHT HOLDER,6,459,7,800,341,1,14
8404,WHITE METAL LANTERN,10,1435,21,2200,765,1,42
8405,CREAM CUPID HEARTS COAT HANGER,7,1356,23,2400,1044,1,46
8406,EDWARDIAN PARASOL RED,4,2337,25,2600,263,1,50
8407,RETRO COFFEE MUGS ASSORTED,7,793,10,1100,307,1,20
8408,SAVE THE PLANET MUG,6,541,8,900,359,1,16
8409,VINTAGE BILLBOARD DRINK ME MUG,6,513,11,1200,687,1,22
8410,VINTAGE BILLBOARD LOVE/HATE MUG,5,1154,16,1700,546,1,32
8411,WOOD 2 DRAWER CABINET WHITE FINISH,1,2322,25,2600,278,1,50
8412,WOOD S/3 CABINET ANT WHITE FINISH,1,1461,16,1700,239,1,32
8413,WOODEN PICTURE FRAME WHITE FINISH,3,232,9,1000,768,1,18
8414,WOODEN FRAME ANTIQUE WHITE ,6,114,13,1400,1286,1,26
8415,KNITTED UNION FLAG HOT WATER BOTTLE,5,102,12,1300,1198,1,24
8416,RED WOOLLY HOTTIE WHITE HEART.,2,1668,18,1900,232,1,36
8417,SET 7 BABUSHKA NESTING BOXES,10,881,8,900,19,1,16
8418,IVORY EMBROIDERED QUILT ,2,222,6,700,478,1,12
8419,GLASS STAR FROSTED T-LIGHT HOLDER,3,100,0,100,0,1,0
8420,HAND WARMER RED POLKA DOT,8,834,10,1100,266,1,20
8421,HAND WARMER UNION JACK,10,382,11,1200,818,1,22
8422,MAGIC DRAWING SLATE DINOSAUR,6,1734,24,2500,766,1,48
8423,MAGIC DRAWING SLATE BAKE A CAKE ,4,2381,24,2500,119,1,48
8424,19 PENCILS TALL TUBE SKULLS,8,367,5,600,233,1,10
8425,CHOCOLATE CALCULATOR,2,492,25,2600,2108,1,50
8426,RED  HARMONICA IN BOX ,5,244,6,700,456,1,12
8427,BLUE HARMONICA IN BOX ,3,231,6,700,469,1,12
8428,SKULLS  WATER TRANSFER TATTOOS ,1,228,2,300,72,1,4
8429,PACK 3 BOXES BIRD PANNETONE ,7,171,5,600,429,1,10
8430,HOT WATER BOTTLE TEA AND SYMPATHY,3,977,9,1000,23,1,18
8431,RED WOOLLY HOTTIE WHITE HEART.,5,749,16,1700,951,1,32
8432,WHITE SKULL HOT WATER BOTTLE ,3,881,11,1200,319,1,22
8433,10 PIECE SPACEBOY COOKIE CUTTER SET,10,774,7,800,26,1,14
8434,SET OF 20 KIDS COOKIE CUTTERS,4,371,4,500,129,1,8
8435,17 COLOUR SPACEBOY PEN,1,140,11,1200,1060,1,22
8436,VICTORIAN GLASS HANGING T-LIGHT,5,2225,25,2600,375,1,50
8437,SINGLE HEART ZINC T-LIGHT HOLDER,3,454,20,2100,1646,1,40
8438,RED HANGING HEART T-LIGHT HOLDER,9,778,14,1500,722,1,28
8439,HANGING METAL STAR LANTERN,7,761,13,1400,639,1,26
8440,SILVER HANGING T-LIGHT HOLDER,4,220,5,600,380,1,10
8441,DOORMAT RED RETROSPOT,5,788,7,800,12,1,14
8442,DOORMAT HEARTS,6,100,0,100,0,1,0
8443,NATURAL SLATE RECTANGLE CHALKBOARD,4,151,2,300,149,1,4
8444,LOVEBIRD HANGING DECORATION WHITE ,10,1033,18,1900,867,1,36
8445,ASSORTED COLOUR BIRD ORNAMENT,2,589,10,1100,511,1,20
8446,HOME BUILDING BLOCK WORD,1,204,13,1400,1196,1,26
8447,LOVE BUILDING BLOCK WORD,7,432,9,1000,568,1,18
8448,PHOTO FRAME CORNICE,3,282,8,900,618,1,16
8449,PENS ASSORTED FUNNY FACE,3,142,24,2500,2358,1,48
8450,CARD CIRCUS PARADE,7,290,2,300,10,1,4
8451,WRAP COWBOYS  ,4,1349,14,1500,151,1,28
8452,AIRLINE BAG VINTAGE TOKYO 85,5,1159,14,1500,341,1,28
8453,RED RETROSPOT UMBRELLA,10,444,4,500,56,1,8
8454,BLACK/BLUE POLKADOT UMBRELLA,10,145,2,300,155,1,4
8455,RED 3 PIECE RETROSPOT CUTLERY SET,10,194,6,700,506,1,12
8456,PACK OF 72 RETROSPOT CAKE CASES,7,192,7,800,608,1,14
8457,SET OF 72 RETROSPOT PAPER  DOILIES,2,728,10,1100,372,1,20
8458,BLUE COAT RACK PARIS FASHION,10,1918,22,2300,382,1,44
8459,PLASTERS IN TIN SKULLS,4,199,7,800,601,1,14
8460,SLEEPING CAT ERASERS,9,153,2,300,147,1,4
8461,CARD BIRTHDAY COWBOY,6,150,16,1700,1550,1,32
8462,PACK 3 BOXES CHRISTMAS PANNETONE,3,445,13,1400,955,1,26
8463,ROTATING SILVER ANGELS T-LIGHT HLDR,4,433,4,500,67,1,8
8464,COSY HOUR GIANT TUBE MATCHES,3,713,25,2600,1887,1,50
8465,RIBBON REEL MAKING SNOWMEN ,1,1736,24,2500,764,1,48
8466,MINI PAINT SET VINTAGE ,10,1143,18,1900,757,1,36
8467,11 TRADITIONAL SPINNING TOPS,4,259,24,2500,2241,1,48
8468,SET OF 6 SOLDIER SKITTLES,4,600,23,2400,1800,1,46
8469,BAG 500g SWIRLY MARBLES,10,582,8,900,318,1,16
8470,12 STRAND GLASS NECKLACE CRYSTAL,1,654,25,2600,1946,1,50
8471,WHITE SKULL HOT WATER BOTTLE ,9,923,15,1600,677,1,30
8472,SCOTTIE DOG HOT WATER BOTTLE,5,143,23,2400,2257,1,46
8473,SQUARECUSHION COVER PINK UNION FLAG,7,512,21,2200,1688,1,42
8474,SPACEBOY CHILDRENS EGG CUP,9,1196,20,2100,904,1,40
8475,CHILDREN'S SPACEBOY MUG,9,458,19,2000,1542,1,38
8476,HAND WARMER SCOTTY DOG DESIGN,2,873,21,2200,1327,1,42
8477,FELTCRAFT CUSHION OWL,7,2151,23,2400,249,1,46
8478,BLACK CANDELABRA T-LIGHT HOLDER,3,100,0,100,0,1,0
8479,TOY TIDY DOLLY GIRL DESIGN,6,632,19,2000,1368,1,38
8480,SET 12 LAVENDER  BOTANICAL T-LIGHTS,8,2015,24,2500,485,1,48
8481,UNION JACK FLAG LUGGAGE TAG,10,423,5,600,177,1,10
8482,RED HEART LUGGAGE TAG,10,855,21,2200,1345,1,42
8483,RED GLASS TASSLE BAG CHARM,6,217,13,1400,1183,1,26
8484,CLEAR ACRYLIC FACETED BANGLE,5,731,17,1800,1069,1,34
8485,12 STRAND GLASS NECKLACE CRYSTAL,6,389,8,900,511,1,16
8486,DOORMAT UNION JACK GUNS AND ROSES,7,864,21,2200,1336,1,42
8487,VANILLA SCENT CANDLE JEWELLED BOX,9,1461,21,2200,739,1,42
8488,FULL ENGLISH BREAKFAST PLATE,1,1340,19,2000,660,1,38
8489,BLACK CANDELABRA T-LIGHT HOLDER,9,1152,18,1900,748,1,36
8490,MAGIC DRAWING SLATE CIRCUS PARADE  ,5,1309,17,1800,491,1,34
8491,CHRISTMAS HANGING HEART WITH BELL,6,713,10,1100,387,1,20
8492,CAKE STAND VICTORIAN FILIGREE MED,7,995,10,1100,105,1,20
8493,PAISLEY PATTERN  STICKERS,4,936,9,1000,64,1,18
8494,FLOWERS  STICKERS,6,342,14,1500,1158,1,28
8495,PINK NEW BAROQUECANDLESTICK CANDLE,4,109,1,200,91,1,2
8496,BLUE NEW BAROQUE CANDLESTICK CANDLE,2,461,10,1100,639,1,20
8497,JUMBO STORAGE BAG SUKI,7,194,1,200,6,1,2
8498,BLACK LOVE BIRD CANDLE,5,839,23,2400,1561,1,46
8499,PARTY TIME PENCIL ERASERS,1,584,21,2200,1616,1,42
8500,DISCO BALL CHRISTMAS DECORATION,8,693,21,2200,1507,1,42
8501,PINK B'FLY C/COVER W BOBBLES,4,1087,25,2600,1513,1,50
8502,PINK UNION JACK  LUGGAGE TAG,3,486,11,1200,714,1,22
8503,13 RIBBONS ELEGANT CHRISTMAS ,1,1929,21,2200,271,1,42
8504,UNION JACK FLAG LUGGAGE TAG,7,512,13,1400,888,1,26
8505,AGED GLASS SILVER T-LIGHT HOLDER,6,2203,22,2300,97,1,44
8506,BOOM BOX SPEAKER GIRLS,5,279,2,300,21,1,4
8507,13 RIBBONS SHIMMERING PINKS ,4,1271,13,1400,129,1,26
8508, SET 2 TEA TOWELS I LOVE LONDON ,3,1154,12,1300,146,1,24
8509,JUMBO BAG OWLS,5,1688,23,2400,712,1,46
8510,SANDWICH BATH SPONGE,2,330,7,800,470,1,14
8511,OWL DOORSTOP,1,121,4,500,379,1,8
8512,12 STRAND GLASS NECKLACE CRYSTAL,1,1289,14,1500,211,1,28
8513,HAND WARMER UNION JACK,3,834,9,1000,166,1,18
8514,HAND WARMER SCOTTY DOG DESIGN,10,1904,20,2100,196,1,40
8515,LARGE POPCORN HOLDER ,3,1537,23,2400,863,1,46
8516,PAINTED METAL STAR WITH HOLLY BELLS,2,159,6,700,541,1,12
8517,PAINTED METAL HEART WITH HOLLY BELL,4,376,5,600,224,1,10
8518,ANGEL DECORATION STARS ON DRESS,2,982,9,1000,18,1,18
8519,SMALL POPCORN HOLDER,3,1062,19,2000,938,1,38
8520,JUMBO BAG RED RETROSPOT,9,192,1,200,8,1,2
8521,JUMBO BAG STRAWBERRY,4,2274,22,2300,26,1,44
8522,STRAWBERRY SHOPPER BAG,9,1310,19,2000,690,1,38
8523,STRAWBERRY CHARLOTTE BAG,7,866,8,900,34,1,16
8524, SET 2 TEA TOWELS I LOVE LONDON ,2,116,3,400,284,1,6
8525,PACK OF 12 RED RETROSPOT TISSUES ,4,310,6,700,390,1,12
8526,SCOTTIE DOG HOT WATER BOTTLE,8,594,25,2600,2006,1,50
8527,CHOCOLATE HOT WATER BOTTLE,1,1044,17,1800,756,1,34
8528,LUNCH BAG CARS BLUE,10,348,3,400,52,1,6
8529,LUNCH BAG SPACEBOY DESIGN ,9,219,8,900,681,1,16
8530,ROUND SNACK BOXES SET OF4 WOODLAND ,4,100,0,100,0,1,0
8531,LUNCH BAG DOLLY GIRL DESIGN,3,920,15,1600,680,1,30
8532,LUNCH BAG SUKI  DESIGN ,6,1462,21,2200,738,1,42
8533,LUNCH BAG  BLACK SKULL.,5,373,9,1000,627,1,18
8534,ROUND SNACK BOXES SET OF 4 FRUITS ,4,852,10,1100,248,1,20
8535,ROUND SNACK BOXES SET OF 4 SKULLS,2,1302,18,1900,598,1,36
8536,DOLLY GIRL LUNCH BOX,9,926,11,1200,274,1,22
8537,SPACEBOY LUNCH BOX ,5,218,3,400,182,1,6
8538,GREEN POLKADOT PLATE ,3,880,8,900,20,1,16
8539,BLUE POLKADOT PLATE ,5,2489,24,2500,11,1,48
8540,RED RETROSPOT PLATE ,3,1185,24,2500,1315,1,48
8541,PINK  POLKADOT PLATE ,4,2112,21,2200,88,1,42
8542,ROUND SNACK BOXES SET OF 4 SKULLS,5,402,5,600,198,1,10
8543,FELTCRAFT DOLL MOLLY,5,1114,19,2000,886,1,38
8544,FELTCRAFT CHRISTMAS FAIRY,8,880,11,1200,320,1,22
8545,TRAVEL SEWING KIT,2,150,2,300,150,1,4
8546,SET OF 3 NOTEBOOKS IN PARCEL,1,102,12,1300,1198,1,24
8547,RED RETROSPOT TAPE,1,888,25,2600,1712,1,50
8548,COSY SLIPPER SHOES SMALL  RED ,1,1514,17,1800,286,1,34
8549,13 RIBBONS RUSTIC CHARM,7,1670,24,2500,830,1,48
8550,SCANDINAVIAN REDS RIBBONS,7,882,24,2500,1618,1,48
8551,JAM MAKING SET PRINTED,10,889,11,1200,311,1,22
8552,19 DAISY PEGS IN WOOD BOX,3,639,9,1000,361,1,18
8553,HOT WATER BOTTLE BABUSHKA ,1,1176,15,1600,424,1,30
8554,FELTCRAFT PRINCESS CHARLOTTE DOLL,8,585,9,1000,415,1,18
8555,FELTCRAFT CHRISTMAS FAIRY,6,272,6,700,428,1,12
8556,FELTCRAFT PRINCESS CHARLOTTE DOLL,10,1270,20,2100,830,1,40
8557,13 RIBBONS RUSTIC CHARM,8,582,13,1400,818,1,26
8558,COSY SLIPPER SHOES SMALL  RED ,6,113,6,700,587,1,12
8559,SCANDINAVIAN REDS RIBBONS,2,1409,19,2000,591,1,38
8560,12 HOOK HANGER RED MAGIC TOADSTOOL,3,1521,18,1900,379,1,36
8561,CHRISTMAS CRAFT TREE TOP ANGEL,3,379,23,2400,2021,1,46
8562,CHRISTMAS CRAFT LITTLE FRIENDS,3,261,4,500,239,1,8
8563,12 HOOK HANGER RED MAGIC TOADSTOOL,1,372,24,2500,2128,1,48
8564,13 RIBBONS RUSTIC CHARM,5,221,6,700,479,1,12
8565,19 DAISY PEGS IN WOOD BOX,1,566,7,800,234,1,14
8566,SET OF 3 NOTEBOOKS IN PARCEL,2,181,6,700,519,1,12
8567,12 HOOK HANGER MAGIC TOADSTOOL,4,130,3,400,270,1,6
8568,SCANDINAVIAN REDS RIBBONS,9,1163,14,1500,337,1,28
8569,RED TOADSTOOL LED NIGHT LIGHT,5,1015,13,1400,385,1,26
8570,12 HOOK HANGER RED MAGIC TOADSTOOL,3,661,11,1200,539,1,22
8571,COSY SLIPPER SHOES SMALL GREEN,9,100,0,100,0,1,0
8572,COSY SLIPPER SHOES SMALL  RED ,9,1887,19,2000,113,1,38
8573,FELTCRAFT DOLL ROSIE,6,1453,25,2600,1147,1,50
8574,FELTCRAFT DOLL MOLLY,2,325,9,1000,675,1,18
8575,FELTCRAFT DOLL EMILY,10,513,18,1900,1387,1,36
8576,FELTCRAFT PRINCESS CHARLOTTE DOLL,2,541,9,1000,459,1,18
8577,FELTCRAFT PRINCESS OLIVIA DOLL,3,506,8,900,394,1,16
8578,REX CASH+CARRY JUMBO SHOPPER,3,289,2,300,11,1,4
8579,FELTCRAFT DOLL MOLLY,5,931,14,1500,569,1,28
8580,FELTCRAFT CUSHION OWL,10,649,24,2500,1851,1,48
8581,CHRISTMAS CRAFT TREE TOP ANGEL,8,175,9,1000,825,1,18
8582,CHRISTMAS CRAFT LITTLE FRIENDS,5,100,0,100,0,1,0
8583,FELTCRAFT CUSHION RABBIT,8,739,25,2600,1861,1,50
8584,FELTCRAFT CUSHION BUTTERFLY,4,203,21,2200,1997,1,42
8585,19 DAISY PEGS IN WOOD BOX,4,200,1,200,0,1,2
8586,PAPER CHAIN KIT 50'S CHRISTMAS ,3,244,21,2200,1956,1,42
8587,FELTCRAFT CUSHION BUTTERFLY,10,479,17,1800,1321,1,34
8588,19 DAISY PEGS IN WOOD BOX,1,693,14,1500,807,1,28
8589,ROSE COTTAGE KEEPSAKE BOX ,1,818,17,1800,982,1,34
8590,TOTE BAG I LOVE LONDON,10,265,12,1300,1035,1,24
8591,19 DAISY PEGS IN WOOD BOX,10,100,0,100,0,1,0
8592,TOTE BAG I LOVE LONDON,9,1750,22,2300,550,1,44
8593,FOLDING UMBRELLA PINKWHITE POLKADOT,1,399,4,500,101,1,8
8594,FOLDING UMBRELLA CREAM POLKADOT,1,121,1,200,79,1,2
8595,FOLDING UMBRELLA WHITE/RED POLKADOT,3,950,15,1600,650,1,30
8596,SET 10 LIGHTS NIGHT OWL,9,163,5,600,437,1,10
8597,SMALL POPCORN HOLDER,2,1278,16,1700,422,1,32
8598, SET 2 TEA TOWELS I LOVE LONDON ,2,371,5,600,229,1,10
8599,FOLDING UMBRELLA RED/WHITE POLKADOT,9,517,13,1400,883,1,26
8600,BABUSHKA LIGHTS STRING OF 17,4,1858,25,2600,742,1,50
8601,LUNCH BAG RED RETROSPOT,7,117,17,1800,1683,1,34
8602,S/4 VALENTINE DECOUPAGE HEART BOX,4,381,19,2000,1619,1,38
8603,FOLDING UMBRELLA CREAM POLKADOT,2,1589,18,1900,311,1,36
8604, SET 2 TEA TOWELS I LOVE LONDON ,8,100,0,100,0,1,0
8605,FOLDING UMBRELLA RED/WHITE POLKADOT,3,533,14,1500,967,1,28
8606,SOLDIERS EGG CUP ,3,317,9,1000,683,1,18
8607,S/4 VALENTINE DECOUPAGE HEART BOX,10,354,14,1500,1146,1,28
8608,RED RETROSPOT MINI CASES,3,1685,21,2200,515,1,42
8609,,10,445,22,2300,1855,1,44
8610,67 CAKE CASES VINTAGE CHRISTMAS,10,597,25,2600,2003,1,50
8611,PAPER CHAIN KIT VINTAGE CHRISTMAS,1,710,11,1200,490,1,22
8612,RIBBON REEL CHRISTMAS SOCK BAUBLE,1,837,20,2100,1263,1,40
8613,RIBBON REEL SNOWY VILLAGE,5,230,4,500,270,1,8
8614,RIBBON REEL MAKING SNOWMEN ,1,130,10,1100,970,1,20
8615,SET OF 20 VINTAGE CHRISTMAS NAPKINS,8,585,5,600,15,1,10
8616,TURQUOISE CHRISTMAS TREE ,1,129,20,2100,1971,1,40
8617,RED STAR CARD HOLDER,7,1460,22,2300,840,1,44
8618,WICKER WREATH SMALL,2,1944,21,2200,256,1,42
8619,HEART OF WICKER LARGE,2,205,9,1000,795,1,18
8620,ADVENT CALENDAR GINGHAM SACK,10,135,24,2500,2365,1,48
8621,HEART OF WICKER SMALL,10,1391,17,1800,409,1,34
8622,FELTCRAFT BUTTERFLY HEARTS,10,654,13,1400,746,1,26
8623,PARTY CONE CHRISTMAS DECORATION ,8,147,2,300,153,1,4
8624,VINTAGE HEADS AND TAILS CARD GAME ,3,1663,16,1700,37,1,32
8625,WICKER STAR ,9,1559,25,2600,1041,1,50
8626,VINTAGE SNAP CARDS,7,167,3,400,233,1,6
8627,FELTCRAFT 6 FLOWER FRIENDS,9,523,25,2600,2077,1,50
8628, SET 2 TEA TOWELS I LOVE LONDON ,4,850,9,1000,150,1,18
8629,JAM MAKING SET PRINTED,2,1908,24,2500,592,1,48
8630,BIRD DECORATION RED RETROSPOT,5,262,7,800,538,1,14
8631,CHRISTMAS GINGHAM TREE,9,1081,11,1200,119,1,22
8632,CHRISTMAS GINGHAM STAR,7,1120,13,1400,280,1,26
8633,CHRISTMAS GINGHAM HEART,4,670,10,1100,430,1,20
8634,PACK OF 12 PINK POLKADOT TISSUES,9,237,17,1800,1563,1,34
8635,FELTCRAFT PRINCESS LOLA DOLL,1,100,0,100,0,1,0
8636,PACK OF 12 LONDON TISSUES ,3,126,18,1900,1774,1,36
8637,PURPLE DRAWERKNOB ACRYLIC EDWARDIAN,4,658,6,700,42,1,12
8638,CHILDREN'S APRON DOLLY GIRL ,10,191,1,200,9,1,2
8639,CHILDRENS APRON SPACEBOY DESIGN,1,657,22,2300,1643,1,44
8640,CHRISTMAS LIGHTS 10 SANTAS ,2,647,11,1200,553,1,22
8641,CHRISTMAS LIGHTS 10 REINDEER,4,821,23,2400,1579,1,46
8642,PAPER CHAIN KIT 50'S CHRISTMAS ,9,1275,13,1400,125,1,26
8643,FELTCRAFT CHRISTMAS FAIRY,1,1017,10,1100,83,1,20
8644,PACK OF 72 RETROSPOT CAKE CASES,2,1519,16,1700,181,1,32
8645,PACK OF 60 MUSHROOM CAKE CASES,10,898,9,1000,102,1,18
8646,67 CAKE CASES DOLLY GIRL DESIGN,1,1853,21,2200,347,1,42
8647,PACK OF 60 PINK PAISLEY CAKE CASES,7,729,10,1100,371,1,20
8648,HAND WARMER BABUSHKA DESIGN,6,1924,22,2300,376,1,44
8649,HAND WARMER BIRD DESIGN,7,1897,19,2000,103,1,38
8650,HAND WARMER OWL DESIGN,2,806,20,2100,1294,1,40
8651,HAND WARMER RED RETROSPOT,7,1442,19,2000,558,1,38
8652,SET 12 RETRO WHITE CHALK STICKS,6,1557,23,2400,843,1,46
8653,FELTCRAFT HAIRBAND RED AND BLUE,3,1564,17,1800,236,1,34
8654,FELTCRAFT HAIRBAND PINK AND PURPLE,6,715,23,2400,1685,1,46
8655,FELTCRAFT HAIRBANDS PINK AND WHITE ,10,1335,20,2100,765,1,40
8656,TV DINNER TRAY DOLLY GIRL,5,470,7,800,330,1,14
8657,PLASTERS IN TIN VINTAGE PAISLEY ,8,196,13,1400,1204,1,26
8658,PLASTERS IN TIN SPACEBOY,10,1679,18,1900,221,1,36
8659,PLASTERS IN TIN WOODLAND ANIMALS,2,231,7,800,569,1,14
8660,MAGIC DRAWING SLATE SPACEBOY ,9,2376,23,2400,24,1,46
8661,MAGIC DRAWING SLATE CIRCUS PARADE  ,9,296,23,2400,2104,1,46
8662,MAGIC DRAWING SLATE GO TO THE FAIR ,10,377,3,400,23,1,6
8663,MAGIC DRAWING SLATE DOLLY GIRL ,7,492,24,2500,2008,1,48
8664,CHARLIE + LOLA RED HOT WATER BOTTLE,8,453,15,1600,1147,1,30
8665,HOT WATER BOTTLE BABUSHKA ,10,1601,24,2500,899,1,48
8666,URBAN BLACK RIBBONS ,6,261,18,1900,1639,1,36
8667,FELTCRAFT PRINCESS CHARLOTTE DOLL,7,491,8,900,409,1,16
8668,SET OF 6 T-LIGHTS TOADSTOOLS,3,875,11,1200,325,1,22
8669,ROTATING LEAVES T-LIGHT HOLDER,3,1632,16,1700,68,1,32
8670,RED  HARMONICA IN BOX ,5,194,1,200,6,1,2
8671,CUPCAKE LACE PAPER SET 13,9,372,10,1100,728,1,20
8672,FAMILY PHOTO FRAME CORNICE,9,1771,20,2100,329,1,40
8673,TRIPLE PHOTO FRAME CORNICE ,7,1690,16,1700,10,1,32
8674,WOODEN FRAME ANTIQUE WHITE ,6,698,6,700,2,1,12
8675,WOODEN BOX OF DOMINOES,5,1009,11,1200,191,1,22
8676,TRADITIONAL WOODEN CATCH CUP GAME ,4,2188,23,2400,212,1,46
8677,TRADITIONAL WOODEN SKIPPING ROPE,3,796,22,2300,1504,1,44
8678,S/6 WOODEN SKITTLES IN COTTON BAG,3,279,11,1200,921,1,22
8679,RED METAL BEACH SPADE ,8,1813,24,2500,687,1,48
8680,BOYS VINTAGE TIN SEASIDE BUCKET,9,844,12,1300,456,1,24
8681,GIRLS VINTAGE TIN SEASIDE BUCKET,4,358,3,400,42,1,6
8682,GREY HEART HOT WATER BOTTLE,8,1101,24,2500,1399,1,48
8683,SCOTTIE DOG HOT WATER BOTTLE,2,1819,22,2300,481,1,44
8684,BIRD HOUSE HOT WATER BOTTLE,3,706,10,1100,394,1,20
8685,KINGS CHOICE TEA CADDY ,9,216,4,500,284,1,8
8686,KINGS CHOICE BISCUIT TIN,3,465,11,1200,735,1,22
8687,METAL SIGN EMPIRE TEA,3,789,8,900,111,1,16
8688,HOMEMADE JAM SCENTED CANDLES,1,427,14,1500,1073,1,28
8689,SET OF 6 SOLDIER SKITTLES,9,566,7,800,234,1,14
8690,FAWN BLUE HOT WATER BOTTLE,10,1196,12,1300,104,1,24
8691,HAND WARMER RED RETROSPOT,5,397,6,700,303,1,12
8692,HOT WATER BOTTLE BABUSHKA ,7,106,1,200,94,1,2
8693,WHITE SKULL HOT WATER BOTTLE ,4,571,10,1100,529,1,20
8694,RETROSPOT HEART HOT WATER BOTTLE,8,505,15,1600,1095,1,30
8695,RED WOOLLY HOTTIE WHITE HEART.,9,280,23,2400,2120,1,46
8696,SCOTTIE DOG HOT WATER BOTTLE,2,320,8,900,580,1,16
8697,GREY HEART HOT WATER BOTTLE,8,118,16,1700,1582,1,32
8698,HOT WATER BOTTLE BABUSHKA ,1,608,13,1400,792,1,26
8699,PACK OF 6 BIRDY GIFT TAGS,3,2565,25,2600,35,1,50
8700,CHILLI LIGHTS,4,414,5,600,186,1,10
8701,PIGGY BANK RETROSPOT ,2,1155,24,2500,1345,1,48
8702,CERAMIC STRAWBERRY MONEY BOX,8,244,4,500,256,1,8
8703,CERAMIC STRAWBERRY CAKE MONEY BANK,4,1864,22,2300,436,1,44
8704,CERAMIC CHERRY CAKE MONEY BANK,7,1104,25,2600,1496,1,50
8705,CERAMIC HEART FAIRY CAKE MONEY BANK,9,165,2,300,135,1,4
8706,CERAMIC PIRATE CHEST MONEY BANK,8,1399,23,2400,1001,1,46
8707,DOORSTOP RETROSPOT HEART,6,171,4,500,329,1,8
8708,GINGHAM HEART  DOORSTOP RED,8,1770,18,1900,130,1,36
8709,RETROSPOT BABUSHKA DOORSTOP,6,1509,15,1600,91,1,30
8710,SILK PURSE BABUSHKA RED,8,1710,23,2400,690,1,46
8711,SILK PURSE BABUSHKA PINK,9,257,8,900,643,1,16
8712,FAMILY PHOTO FRAME CORNICE,5,623,23,2400,1777,1,46
8713,SWEETHEART WIRE WALL TIDY,8,1254,17,1800,546,1,34
8714,JAM MAKING SET PRINTED,5,381,7,800,419,1,14
8715,RED RETROSPOT OVEN GLOVE ,3,336,13,1400,1064,1,26
8716,CREAM HEART CARD HOLDER,1,216,11,1200,984,1,22
8717,NAMASTE SWAGAT INCENSE,8,118,1,200,82,1,2
8718,CERAMIC STRAWBERRY DESIGN MUG,3,1072,23,2400,1328,1,46
8719,BLACK HEART CARD HOLDER,10,1977,21,2200,223,1,42
8720,CLASSICAL ROSE SMALL VASE,9,574,12,1300,726,1,24
8721,HYACINTH BULB T-LIGHT CANDLES,6,494,16,1700,1206,1,32
8722,CHRISTMAS CRAFT WHITE FAIRY ,7,281,17,1800,1519,1,34
8723,CHRISTMAS CRAFT LITTLE FRIENDS,4,992,9,1000,8,1,18
8724,COSY HOUR CIGAR BOX MATCHES ,6,324,14,1500,1176,1,28
8725,RED TEA TOWEL CLASSIC DESIGN,1,1086,19,2000,914,1,38
8726,HEART FILIGREE DOVE  SMALL,6,132,3,400,268,1,6
8727,RETROSPOT CHILDRENS APRON,4,803,17,1800,997,1,34
8728,COLOURING PENCILS BROWN TUBE,1,665,24,2500,1835,1,48
8729,11 IVORY DINNER CANDLES SILVER FLOCK,4,145,2,300,155,1,4
8730,HEART FILIGREE DOVE  SMALL,6,163,1,200,37,1,2
8731,ZINC METAL HEART DECORATION,6,348,21,2200,1852,1,42
8732,GREEN FERN NOTEBOOK,4,942,25,2600,1658,1,50
8733,BLUE PAISLEY NOTEBOOK,2,420,25,2600,2180,1,50
8734,CHRYSANTHEMUM NOTEBOOK,3,642,6,700,58,1,12
8735,LARGE CHINESE STYLE SCISSOR,5,1788,18,1900,112,1,36
8736,SMALL CHINESE STYLE SCISSOR,10,135,1,200,65,1,2
8737,S/6 WOODEN SKITTLES IN COTTON BAG,4,1172,13,1400,228,1,26
8738,TRADITIONAL WOODEN SKIPPING ROPE,10,895,18,1900,1005,1,36
8739,SET OF 6 SOLDIER SKITTLES,3,214,2,300,86,1,4
8740,11 TRADITIONAL SPINNING TOPS,2,100,0,100,0,1,0
8741,ROTATING SILVER ANGELS T-LIGHT HLDR,6,434,20,2100,1666,1,40
8742,BLACK LOVE BIRD CANDLE,8,241,2,300,59,1,4
8743,RETROSPOT CHILDRENS APRON,10,1465,17,1800,335,1,34
8744,HANGING GLASS ETCHED TEALIGHT,3,366,9,1000,634,1,18
8745,HANGING GLASS ETCHED TEALIGHT,4,881,15,1600,719,1,30
8746,BLUE NEW BAROQUE CANDLESTICK CANDLE,10,589,8,900,311,1,16
8747,COOKING SET RETROSPOT,10,642,19,2000,1358,1,38
8748,KINGS CHOICE GIANT TUBE MATCHES,5,393,14,1500,1107,1,28
8749,COSY HOUR GIANT TUBE MATCHES,4,891,23,2400,1509,1,46
8750,PLACE SETTING WHITE STAR,8,1036,10,1100,64,1,20
8751,HYACINTH BULB T-LIGHT CANDLES,5,651,9,1000,349,1,18
8752,S/15 SILVER GLASS BAUBLES IN BAG,3,724,7,800,76,1,14
8753,FRENCH WC SIGN BLUE METAL,2,981,11,1200,219,1,22
8754,KINGS CHOICE GIANT TUBE MATCHES,4,577,6,700,123,1,12
8755,79 SWEETHEART FAIRY CAKE CASES,9,1633,16,1700,67,1,32
8756,ASSORTED COLOUR BIRD ORNAMENT,7,100,0,100,0,1,0
8757,FAIRY SOAP SOAP HOLDER,3,182,5,600,418,1,10
8758,GREEN GIANT GARDEN THERMOMETER,9,352,7,800,448,1,14
8759,IVORY GIANT GARDEN THERMOMETER,8,150,15,1600,1450,1,30
8760,BLUE GIANT GARDEN THERMOMETER,8,258,7,800,542,1,14
8761,PACK OF 60 PINK PAISLEY CAKE CASES,3,2473,24,2500,27,1,48
8762,RETROSPOT HEART HOT WATER BOTTLE,7,100,0,100,0,1,0
8763,CHICK GREY HOT WATER BOTTLE,4,100,0,100,0,1,0
8764,VICTORIAN SEWING BOX SMALL ,1,321,22,2300,1979,1,44
8765,VICTORIAN SEWING BOX MEDIUM,2,258,3,400,142,1,6
8766,SET/10 RED POLKADOT PARTY CANDLES,4,1446,19,2000,554,1,38
8767,WASHROOM METAL SIGN,8,239,2,300,61,1,4
8768,BLACK SWEETHEART BRACELET,3,789,7,800,11,1,14
8769,DIAMANTE HAIR GRIP PACK/2 BLACK DIA,7,305,17,1800,1495,1,34
8770,BLACK DIAMANTE EXPANDABLE RING,7,176,12,1300,1124,1,24
8771,DIAMANTE HAIR GRIP PACK/2 RUBY,9,2223,24,2500,277,1,48
8772,DIAMANTE HAIR GRIP PACK/2 MONTANA,1,202,3,400,198,1,6
8773,BLUE SWEETHEART BRACELET,4,100,0,100,0,1,0
8774,PINK SWEETHEART BRACELET,6,505,23,2400,1895,1,46
8775,PURPLE SWEETHEART BRACELET,2,855,15,1600,745,1,30
8776,JUMBO BAG PINK POLKADOT,5,1460,25,2600,1140,1,50
8777,JUMBO BAG RED RETROSPOT,2,801,24,2500,1699,1,48
8778,ASSORTED COLOUR BIRD ORNAMENT,3,1169,13,1400,231,1,26
8779,PAPER CHAIN KIT 50'S CHRISTMAS ,6,553,7,800,247,1,14
8780,RIBBON REEL CHRISTMAS PRESENT ,7,394,6,700,306,1,12
8781,FIRST AID TIN,3,212,2,300,88,1,4
8782,MAKE YOUR OWN MONSOON CARD KIT,9,295,14,1500,1205,1,28
8783,PACK OF 12 HEARTS DESIGN TISSUES ,6,630,8,900,270,1,16
8784,PACK OF 12 RED RETROSPOT TISSUES ,3,132,4,500,368,1,8
8785,SOLDIERS EGG CUP ,3,1607,21,2200,593,1,42
8786,HEART IVORY TRELLIS SMALL,8,940,9,1000,60,1,18
8787,HEART FILIGREE DOVE  SMALL,7,100,0,100,0,1,0
8788,HEART FILIGREE DOVE LARGE,1,571,8,900,329,1,16
8789,PACK 3 BOXES BIRD PANNETONE ,10,567,8,900,333,1,16
8790,PACK 3 BOXES CHRISTMAS PANNETONE,8,1987,20,2100,113,1,40
8791,SMALL POPCORN HOLDER,5,115,10,1100,985,1,20
8792,PACK OF 60 PINK PAISLEY CAKE CASES,1,744,25,2600,1856,1,50
8793,SET OF 6 SOLDIER SKITTLES,8,1868,18,1900,32,1,36
8794,SWIRLY CIRCULAR RUBBERS IN BAG,9,717,22,2300,1583,1,44
8795,VINTAGE PAISLEY STATIONERY SET,4,327,12,1300,973,1,24
8796,PAPER CHAIN KIT VINTAGE CHRISTMAS,5,1908,23,2400,492,1,46
8797,SET/10 BLUE POLKADOT PARTY CANDLES,1,100,0,100,0,1,0
8798,RIBBON REEL SOCKS AND MITTENS,2,107,1,200,93,1,2
8799,67 CAKE CASES VINTAGE CHRISTMAS,7,1909,19,2000,91,1,38
8800,CHRISTMAS METAL TAGS ASSORTED ,6,539,23,2400,1861,1,46
8801,CHRISTMAS TREE T-LIGHT HOLDER,6,798,22,2300,1502,1,44
8802,STAR  T-LIGHT HOLDER ,3,454,7,800,346,1,14
8803,HEART T-LIGHT HOLDER ,5,212,24,2500,2288,1,48
8804,MINI FUNKY DESIGN TAPES,4,100,0,100,0,1,0
8805,SET OF 6 T-LIGHTS SNOWMEN,10,396,16,1700,1304,1,32
8806,STAR WOODEN CHRISTMAS DECORATION,4,1170,25,2600,1430,1,50
8807,WOODEN HEART CHRISTMAS SCANDINAVIAN,9,239,7,800,561,1,14
8808,CHRISTMAS RETROSPOT TREE WOOD,5,1372,16,1700,328,1,32
8809,SET OF 6 T-LIGHTS SANTA,4,155,21,2200,2045,1,42
8810,SET/9 CHRISTMAS T-LIGHTS SCENTED ,3,674,17,1800,1126,1,34
8811,BLUE ROSE FABRIC MIRROR,5,416,18,1900,1484,1,36
8812,THREE CANVAS LUGGAGE TAGS,1,806,17,1800,994,1,34
8813,RETROSPOT PARTY BAG + STICKER SET,3,1271,16,1700,429,1,32
8814,PLASTERS IN TIN VINTAGE PAISLEY ,8,1777,20,2100,323,1,40
8815,RETROSPOT SMALL TUBE MATCHES,9,210,21,2200,1990,1,42
8816,HAND WARMER SCOTTY DOG DESIGN,7,528,22,2300,1772,1,44
8817,3D CHRISTMAS STAMPS STICKERS ,1,636,6,700,64,1,12
8818,HAND WARMER SCOTTY DOG DESIGN,6,1117,24,2500,1383,1,48
8819,HAND WARMER SCOTTY DOG DESIGN,3,735,25,2600,1865,1,50
8820,CLOTHES PEGS RETROSPOT PACK 31,1,982,20,2100,1118,1,40
8821,43 FOIL HEART CAKE CASES,3,457,12,1300,843,1,24
8822,CHRISTMAS METAL TAGS ASSORTED ,6,1019,19,2000,981,1,38
8823,PACK OF 6 SWEETIE GIFT BOXES,6,355,12,1300,945,1,24
8824,PACK OF 72 RETROSPOT CAKE CASES,3,146,2,300,154,1,4
8825,PACK OF 72 RETROSPOT CAKE CASES,8,123,1,200,77,1,2
8826,PACK OF 6 BIRDY GIFT TAGS,2,960,9,1000,40,1,18
8827,SET/10 RED POLKADOT PARTY CANDLES,10,100,0,100,0,1,0
8828,SET/10 PINK POLKADOT PARTY CANDLES,5,658,6,700,42,1,12
8829,SET OF 3 NOTEBOOKS IN PARCEL,10,1050,15,1600,550,1,30
8830,STAR  T-LIGHT HOLDER ,4,200,1,200,0,1,2
8831,CINAMMON SET OF 9 T-LIGHTS,10,198,17,1800,1602,1,34
8832,ORANGE SCENTED SET/9 T-LIGHTS,1,204,5,600,396,1,10
8833,RIBBON REEL STRIPES DESIGN ,4,519,20,2100,1581,1,40
8834,SET OF 2 TINS JARDIN DE PROVENCE,1,185,20,2100,1915,1,40
8835,MAKE YOUR OWN PLAYTIME CARD KIT,5,798,7,800,2,1,14
8836,DINOSAURS  WRITING SET ,6,391,14,1500,1109,1,28
8837,BALLOONS  WRITING SET ,2,1240,22,2300,1060,1,44
8838,SKULLS WRITING SET ,6,512,5,600,88,1,10
8839,VINTAGE PAISLEY STATIONERY SET,5,115,13,1400,1285,1,26
8840,COSY SLIPPER SHOES SMALL  RED ,5,653,9,1000,347,1,18
8841,DOORMAT BLACK FLOCK ,7,1491,16,1700,209,1,32
8842,JUMBO  BAG BAROQUE BLACK WHITE,5,579,21,2200,1621,1,42
8843,JAM MAKING SET WITH JARS,8,1061,20,2100,1039,1,40
8844,ORANGE SCENTED SET/9 T-LIGHTS,2,870,10,1100,230,1,20
8845,CINAMMON SET OF 9 T-LIGHTS,10,1143,20,2100,957,1,40
8846,HAND WARMER SCOTTY DOG DESIGN,5,392,22,2300,1908,1,44
8847,CHRISTMAS DECOUPAGE CANDLE,1,154,4,500,346,1,8
8848,HEART T-LIGHT HOLDER ,2,1639,20,2100,461,1,40
8849,GROW YOUR OWN BASIL IN ENAMEL MUG,9,321,12,1300,979,1,24
8850,OFFICE MUG WARMER POLKADOT,7,528,13,1400,872,1,26
8851,SMALL POPCORN HOLDER,2,1016,12,1300,284,1,24
8852,JUMBO BAG DOLLY GIRL DESIGN,5,226,5,600,374,1,10
8853,JAM MAKING SET WITH JARS,7,185,3,400,215,1,6
8854,JAM MAKING SET PRINTED,1,573,7,800,227,1,14
8855,SMALL GLASS HEART TRINKET POT,2,435,6,700,265,1,12
8856,RED WOOLLY HOTTIE WHITE HEART.,9,895,10,1100,205,1,20
8857,BLACK RECORD COVER FRAME,3,1034,12,1300,266,1,24
8858,"RECORD FRAME 7"" SINGLE SIZE ",7,239,25,2600,2361,1,50
8859,43 PENCILS TUBE RED RETROSPOT,5,2012,22,2300,288,1,44
8860,43 PENCILS TUBE WOODLAND,1,1766,24,2500,734,1,48
8861,SET OF 6 SOLDIER SKITTLES,6,379,15,1600,1221,1,30
8862,ROCKING HORSE RED CHRISTMAS ,7,1264,12,1300,36,1,24
8863,CHRISTMAS GINGHAM HEART,8,201,6,700,499,1,12
8864,CHRISTMAS GINGHAM STAR,4,400,4,500,100,1,8
8865,HAND WARMER UNION JACK,7,1343,15,1600,257,1,30
8866,HAND WARMER RED RETROSPOT,5,2062,22,2300,238,1,44
8867,REGENCY CAKESTAND 3 TIER,8,100,0,100,0,1,0
8868,JUMBO SHOPPER VINTAGE RED PAISLEY,2,678,6,700,22,1,12
8869,RIBBON REEL SNOWY VILLAGE,7,103,2,300,197,1,4
8870,VINTAGE UNION JACK BUNTING,5,1048,10,1100,52,1,20
8871,JAM MAKING SET WITH JARS,2,506,19,2000,1494,1,38
8872,RIBBON REEL STRIPES DESIGN ,4,352,5,600,248,1,10
8873,RETRO LONGBOARD IRONING BOARD COVER,4,432,7,800,368,1,14
8874,3D DOG PICTURE PLAYING CARDS,3,1136,15,1600,464,1,30
8875,RETROSPOT CIGAR BOX MATCHES ,5,676,17,1800,1124,1,34
8876,SET/9 CHRISTMAS T-LIGHTS SCENTED ,9,296,15,1600,1304,1,30
8877,ROTATING SILVER ANGELS T-LIGHT HLDR,3,545,5,600,55,1,10
8878,ROTATING SILVER ANGELS T-LIGHT HLDR,1,2202,22,2300,98,1,44
8879,SAVE THE PLANET COTTON TOTE BAG,1,100,0,100,0,1,0
8880,SET OF 20 VINTAGE CHRISTMAS NAPKINS,6,167,2,300,133,1,4
8881,PAPER BUNTING WHITE LACE,6,1882,22,2300,418,1,44
8882,GENTLEMAN SHIRT REPAIR KIT ,6,857,17,1800,943,1,34
8883,CARD I LOVE LONDON ,10,1373,21,2200,827,1,42
8884,PAPER CHAIN KIT VINTAGE CHRISTMAS,6,464,8,900,436,1,16
8885,MIRRORED WALL ART FOXY,9,1421,18,1900,479,1,36
8886,MIRRORED WALL ART GENTS,2,1352,14,1500,148,1,28
8887,AIRLINE BAG VINTAGE JET SET WHITE,4,1633,18,1900,267,1,36
8888,JAM MAKING SET PRINTED,10,113,3,400,287,1,6
8889,POTTING SHED SOW 'N' GROW SET,10,1718,17,1800,82,1,34
8890,BABUSHKA LIGHTS STRING OF 17,5,1569,22,2300,731,1,44
8891,REX CASH+CARRY JUMBO SHOPPER,10,127,2,300,173,1,4
8892,AIRLINE BAG VINTAGE WORLD CHAMPION ,8,171,2,300,129,1,4
8893,HAND WARMER BIRD DESIGN,10,2283,23,2400,117,1,46
8894,CHRISTMAS CRAFT LITTLE FRIENDS,7,100,0,100,0,1,0
8895,PINK HEARTS PAPER GARLAND,5,480,14,1500,1020,1,28
8896,POTTING SHED SEED ENVELOPES,8,191,13,1400,1209,1,26
8897,HI TEC ALPINE HAND WARMER,4,2113,23,2400,287,1,46
8898,FELTCRAFT CHRISTMAS FAIRY,10,100,0,100,0,1,0
8899,HI TEC ALPINE HAND WARMER,10,425,6,700,275,1,12
8900,ROTATING SILVER ANGELS T-LIGHT HLDR,2,1191,12,1300,109,1,24
8901,10 STRIPEY MICE FELTCRAFT,10,974,25,2600,1626,1,50
8902,FELTCRAFT 6 FLOWER FRIENDS,3,1747,20,2100,353,1,40
8903,CHRISTMAS CRAFT LITTLE FRIENDS,7,470,6,700,230,1,12
8904,VINTAGE UNION JACK CUSHION COVER,9,592,6,700,108,1,12
8905,POLYESTER FILLER PAD 45x45cm,2,185,9,1000,815,1,18
8906,DOLLY GIRL LUNCH BOX,2,770,9,1000,230,1,18
8907,PACK OF 12 LONDON TISSUES ,8,147,8,900,753,1,16
8908,CARD DOLLY GIRL ,2,546,5,600,54,1,10
8909,CARD BILLBOARD FONT,10,1511,18,1900,389,1,36
8910,RAINY LADIES BIRTHDAY CARD,7,429,5,600,171,1,10
8911,GREY HEART HOT WATER BOTTLE,10,1294,16,1700,406,1,32
8912,RED WOOLLY HOTTIE WHITE HEART.,4,739,22,2300,1561,1,44
8913,RED WHITE SCARF  HOT WATER BOTTLE,6,171,4,500,329,1,8
8914, SET 2 TEA TOWELS I LOVE LONDON ,10,1321,20,2100,779,1,40
8915,SET OF 2 TEA TOWELS APPLE AND PEARS,5,1403,18,1900,497,1,36
8916,SET/2 RED RETROSPOT TEA TOWELS ,3,865,10,1100,235,1,20
8917,LOVE BUILDING BLOCK WORD,7,843,18,1900,1057,1,36
8918,HOME BUILDING BLOCK WORD,1,576,5,600,24,1,10
8919,ASSORTED COLOUR BIRD ORNAMENT,1,100,0,100,0,1,0
8920,LANTERN CREAM GAZEBO ,4,1153,13,1400,247,1,26
8921,BLUE BIRDHOUSE DECORATION,5,100,0,100,0,1,0
8922,WHITE HANGING HEART T-LIGHT HOLDER,5,277,3,400,123,1,6
8923,REGENCY CAKESTAND 3 TIER,8,487,21,2200,1713,1,42
8924,ANTIQUE SILVER TEA GLASS ENGRAVED,3,1293,12,1300,7,1,24
8925,AGED GLASS SILVER T-LIGHT HOLDER,2,379,10,1100,721,1,20
8926,JAM MAKING SET WITH JARS,6,505,5,600,95,1,10
8927,HAND WARMER OWL DESIGN,5,243,18,1900,1657,1,36
8928,SET OF 2 WOODEN MARKET CRATES,7,545,23,2400,1855,1,46
8929,SET OF 6 T-LIGHTS TOADSTOOLS,3,354,6,700,346,1,12
8930,HAND WARMER UNION JACK,10,1641,18,1900,259,1,36
8931,HAND WARMER SCOTTY DOG DESIGN,9,1829,20,2100,271,1,40
8932,CLASSIC FRENCH STYLE BASKET NATURAL,2,395,5,600,205,1,10
8933,CRAZY DAISY HEART DECORATION,8,216,2,300,84,1,4
8934,GIN + TONIC DIET METAL SIGN,1,159,3,400,241,1,6
8935,IVORY GIANT GARDEN THERMOMETER,1,994,18,1900,906,1,36
8936,CARD HOLDER GINGHAM HEART,8,1330,14,1500,170,1,28
8937,SMALL STRIPES CHOCOLATE GIFT BAG ,7,1564,25,2600,1036,1,50
8938,S/6 WOODEN SKITTLES IN COTTON BAG,4,1487,15,1600,113,1,30
8939,HAND WARMER RED RETROSPOT,9,1598,20,2100,502,1,40
8940,HAND WARMER UNION JACK,7,1173,16,1700,527,1,32
8941,FRENCH WC SIGN BLUE METAL,1,326,8,900,574,1,16
8942,PINK UNION JACK  LUGGAGE TAG,8,477,8,900,423,1,16
8943,"TRAY, BREAKFAST IN BED",5,225,5,600,375,1,10
8944,PIZZA PLATE IN BOX,7,1000,11,1200,200,1,22
8945,HEART OF WICKER LARGE,2,262,9,1000,738,1,18
8946,PINK HEART DOTS HOT WATER BOTTLE,10,267,5,600,333,1,10
8947,PLACE SETTING WHITE HEART,8,760,9,1000,240,1,18
8948,SET OF 4 NAPKIN CHARMS LEAVES   ,2,281,2,300,19,1,4
8949,SET OF 4 NAPKIN CHARMS STARS   ,8,1318,23,2400,1082,1,46
8950,SET OF 4 NAPKIN CHARMS CUTLERY,8,189,5,600,411,1,10
8951,CARAVAN SQUARE TISSUE BOX,7,1210,20,2100,890,1,40
8952,PLASTERS IN TIN SKULLS,7,264,3,400,136,1,6
8953,PLASTERS IN TIN SPACEBOY,6,169,3,400,231,1,6
8954,BUTTON BOX ,3,384,12,1300,916,1,24
8955,PLASTERS IN TIN VINTAGE PAISLEY ,10,1791,17,1800,9,1,34
8956,19 MESSAGE CARDS WITH ENVELOPES,1,225,2,300,75,1,4
8957,SMALL RED BABUSHKA NOTEBOOK ,4,841,17,1800,959,1,34
8958,CUPCAKE LACE PAPER SET 13,5,1859,21,2200,341,1,42
8959,PACK 3 BOXES CHRISTMAS PANNETONE,4,159,1,200,41,1,2
8960,HERB MARKER MINT,8,600,6,700,100,1,12
8961,HERB MARKER ROSEMARY,3,139,1,200,61,1,2
8962,HERB MARKER BASIL,9,1480,25,2600,1120,1,50
8963,HERB MARKER CHIVES ,4,208,5,600,392,1,10
8964,HERB MARKER PARSLEY,1,196,1,200,4,1,2
8965,HERB MARKER THYME,1,1532,17,1800,268,1,34
8966,WHITE HANGING HEART T-LIGHT HOLDER,5,173,3,400,227,1,6
8967,METAL MERRY CHRISTMAS WREATH,9,399,17,1800,1401,1,34
8968,WHITE CHRISTMAS GARLAND STARS TREES,5,1212,12,1300,88,1,24
8969,RETROSPOT SMALL TUBE MATCHES,6,1482,21,2200,718,1,42
8970,RETROSPOT GIANT TUBE MATCHES,8,448,13,1400,952,1,26
8971,PLACE SETTING WHITE STAR,5,717,12,1300,583,1,24
8972,GROW YOUR OWN BASIL IN ENAMEL MUG,3,1610,18,1900,290,1,36
8973,43 FOIL STAR CAKE CASES ,10,440,20,2100,1660,1,40
8974,43 FOIL HEART CAKE CASES,4,576,6,700,124,1,12
8975,PACK OF 6 SWEETIE GIFT BOXES,1,372,6,700,328,1,12
8976,PACK OF 6 HANDBAG GIFT BOXES,10,1367,14,1500,133,1,28
8977,GARLAND WOODEN HAPPY EASTER,9,105,13,1400,1295,1,26
8978,CALENDAR PAPER CUT DESIGN,4,241,5,600,359,1,10
8979,CALENDAR IN SEASON DESIGN,3,2020,25,2600,580,1,50
8980,SMALL POPCORN HOLDER,6,1044,21,2200,1156,1,42
8981,BLUE PAISLEY TISSUE BOX,4,592,15,1600,1008,1,30
8982,HEART OF WICKER SMALL,1,1825,18,1900,75,1,36
8983,SKULLS SQUARE TISSUE BOX,2,356,4,500,144,1,8
8984,SKULLS SQUARE TISSUE BOX,10,610,9,1000,390,1,18
8985,WHITE HANGING HEART T-LIGHT HOLDER,5,302,5,600,298,1,10
8986,WHITE METAL LANTERN,2,267,3,400,133,1,6
8987,CREAM CUPID HEARTS COAT HANGER,8,426,11,1200,774,1,22
8988,KNITTED UNION FLAG HOT WATER BOTTLE,9,1839,21,2200,361,1,42
8989,RED WOOLLY HOTTIE WHITE HEART.,8,1286,24,2500,1214,1,48
8990,SET 7 BABUSHKA NESTING BOXES,7,114,6,700,586,1,12
8991,GLASS STAR FROSTED T-LIGHT HOLDER,2,1827,25,2600,773,1,50
8992,HAND WARMER UNION JACK,4,1950,22,2300,350,1,44
8993,HAND WARMER RED POLKA DOT,7,419,6,700,281,1,12
8994,ASSORTED COLOUR BIRD ORNAMENT,1,235,2,300,65,1,4
8995,POPPY'S PLAYHOUSE BEDROOM ,7,1515,22,2300,785,1,44
8996,POPPY'S PLAYHOUSE KITCHEN,10,123,5,600,477,1,10
8997,FELTCRAFT PRINCESS CHARLOTTE DOLL,6,1650,18,1900,250,1,36
8998,IVORY KNITTED MUG COSY ,9,2494,24,2500,6,1,48
8999,BOX OF 6 ASSORTED COLOUR TEASPOONS,8,454,17,1800,1346,1,34
9000,BOX OF VINTAGE JIGSAW BLOCKS ,3,1147,20,2100,953,1,40
9001,BOX OF VINTAGE ALPHABET BLOCKS,6,1653,24,2500,847,1,48
9002,HOME BUILDING BLOCK WORD,2,1112,14,1500,388,1,28
9003,LOVE BUILDING BLOCK WORD,10,233,13,1400,1167,1,26
9004,RECIPE BOX WITH METAL HEART,4,554,5,600,46,1,10
9005,DOORMAT NEW ENGLAND,10,264,14,1500,1236,1,28
9006,JAM MAKING SET WITH JARS,8,116,6,700,584,1,12
9007,RED COAT RACK PARIS FASHION,7,1291,14,1500,209,1,28
9008,YELLOW COAT RACK PARIS FASHION,7,110,21,2200,2090,1,42
9009,BLUE COAT RACK PARIS FASHION,3,392,10,1100,708,1,20
9010,BATH BUILDING BLOCK WORD,10,162,5,600,438,1,10
9011,ALARM CLOCK BAKELIKE PINK,6,609,9,1000,391,1,18
9012,ALARM CLOCK BAKELIKE RED ,6,1581,19,2000,419,1,38
9013,ALARM CLOCK BAKELIKE GREEN,3,357,3,400,43,1,6
9014,PANDA AND BUNNIES STICKER SHEET,5,429,7,800,371,1,14
9015,STARS GIFT TAPE ,5,159,24,2500,2341,1,48
9016,INFLATABLE POLITICAL GLOBE ,1,1098,11,1200,102,1,22
9017,VINTAGE HEADS AND TAILS CARD GAME ,6,888,21,2200,1312,1,42
9018,SET/2 RED RETROSPOT TEA TOWELS ,7,208,3,400,192,1,6
9019,ROUND SNACK BOXES SET OF4 WOODLAND ,2,715,15,1600,885,1,30
9020,SPACEBOY LUNCH BOX ,3,106,1,200,94,1,2
9021,LUNCH BOX I LOVE LONDON,1,136,1,200,64,1,2
9022,CIRCUS PARADE LUNCH BOX ,7,1520,16,1700,180,1,32
9023,CHARLOTTE BAG DOLLY GIRL DESIGN,2,678,6,700,22,1,12
9024,RED TOADSTOOL LED NIGHT LIGHT,1,1134,14,1500,366,1,28
9025, SET 2 TEA TOWELS I LOVE LONDON ,5,447,23,2400,1953,1,46
9026,VINTAGE SEASIDE JIGSAW PUZZLES,4,209,7,800,591,1,14
9027,MINI JIGSAW CIRCUS PARADE ,9,602,9,1000,398,1,18
9028,MINI JIGSAW SPACEBOY,9,1968,24,2500,532,1,48
9029,MINI PAINT SET VINTAGE ,2,833,12,1300,467,1,24
9030,POSTAGE,3,100,0,100,0,1,0
9031,PAPER CHAIN KIT 50'S CHRISTMAS ,7,297,3,400,103,1,6
9032,HAND WARMER RED POLKA DOT,1,534,6,700,166,1,12
9033,HAND WARMER UNION JACK,4,544,9,1000,456,1,18
9034,WHITE HANGING HEART T-LIGHT HOLDER,7,394,19,2000,1606,1,38
9035,WHITE METAL LANTERN,2,201,7,800,599,1,14
9036,CREAM CUPID HEARTS COAT HANGER,1,135,8,900,765,1,16
9037,EDWARDIAN PARASOL RED,10,416,12,1300,884,1,24
9038,RETRO COFFEE MUGS ASSORTED,6,244,8,900,656,1,16
9039,SAVE THE PLANET MUG,4,856,23,2400,1544,1,46
9040,VINTAGE BILLBOARD DRINK ME MUG,7,100,0,100,0,1,0
9041,VINTAGE BILLBOARD LOVE/HATE MUG,7,818,24,2500,1682,1,48
9042,WOOD 2 DRAWER CABINET WHITE FINISH,10,784,10,1100,316,1,20
9043,WOOD S/3 CABINET ANT WHITE FINISH,9,100,0,100,0,1,0
9044,WOODEN PICTURE FRAME WHITE FINISH,5,619,15,1600,981,1,30
9045,WOODEN FRAME ANTIQUE WHITE ,2,231,23,2400,2169,1,46
9046,KNITTED UNION FLAG HOT WATER BOTTLE,3,129,3,400,271,1,6
9047,RED WOOLLY HOTTIE WHITE HEART.,5,166,15,1600,1434,1,30
9048,SET 7 BABUSHKA NESTING BOXES,2,1054,11,1200,146,1,22
9049,GLASS STAR FROSTED T-LIGHT HOLDER,6,100,0,100,0,1,0
9050,VICTORIAN SEWING BOX LARGE,7,1273,18,1900,627,1,36
9051,WHITE HANGING HEART T-LIGHT HOLDER,9,100,0,100,0,1,0
9052,WHITE METAL LANTERN,1,479,4,500,21,1,8
9053,CREAM CUPID HEARTS COAT HANGER,5,1353,25,2600,1247,1,50
9054,EDWARDIAN PARASOL RED,2,2258,22,2300,42,1,44
9055,RETRO COFFEE MUGS ASSORTED,8,100,0,100,0,1,0
9056,SAVE THE PLANET MUG,3,303,9,1000,697,1,18
9057,VINTAGE BILLBOARD DRINK ME MUG,2,2178,21,2200,22,1,42
9058,VINTAGE BILLBOARD LOVE/HATE MUG,4,646,21,2200,1554,1,42
9059,WOOD 2 DRAWER CABINET WHITE FINISH,2,310,12,1300,990,1,24
9060,WOOD S/3 CABINET ANT WHITE FINISH,8,1335,21,2200,865,1,42
9061,WOODEN PICTURE FRAME WHITE FINISH,9,189,7,800,611,1,14
9062,WOODEN FRAME ANTIQUE WHITE ,8,1492,20,2100,608,1,40
9063,KNITTED UNION FLAG HOT WATER BOTTLE,5,708,7,800,92,1,14
9064,RED WOOLLY HOTTIE WHITE HEART.,5,1318,13,1400,82,1,26
9065,SET 7 BABUSHKA NESTING BOXES,7,2081,23,2400,319,1,46
9066,GLASS STAR FROSTED T-LIGHT HOLDER,8,226,3,400,174,1,6
9067,HOT WATER BOTTLE TEA AND SYMPATHY,9,668,16,1700,1032,1,32
9068,RED HANGING HEART T-LIGHT HOLDER,10,611,6,700,89,1,12
9069,HAND WARMER RED POLKA DOT,4,1069,23,2400,1331,1,46
9070,HAND WARMER UNION JACK,10,841,12,1300,459,1,24
9071,JUMBO BAG PINK POLKADOT,7,1561,20,2100,539,1,40
9072,JUMBO  BAG BAROQUE BLACK WHITE,2,100,0,100,0,1,0
9073,JUMBO BAG CHARLIE AND LOLA TOYS,8,1539,17,1800,261,1,34
9074,STRAWBERRY CHARLOTTE BAG,2,136,5,600,464,1,10
9075,RED 3 PIECE RETROSPOT CUTLERY SET,4,576,8,900,324,1,16
9076,BLUE 3 PIECE POLKADOT CUTLERY SET,8,100,0,100,0,1,0
9077,SET/6 RED SPOTTY PAPER PLATES,9,419,24,2500,2081,1,48
9078,LUNCH BAG RED RETROSPOT,4,1101,22,2300,1199,1,44
9079,STRAWBERRY LUNCH BOX WITH CUTLERY,1,222,13,1400,1178,1,26
9080,LUNCH BOX WITH CUTLERY RETROSPOT ,10,802,19,2000,1198,1,38
9081,PACK OF 72 RETROSPOT CAKE CASES,2,594,5,600,6,1,10
9082,PACK OF 60 DINOSAUR CAKE CASES,4,1482,17,1800,318,1,34
9083,PACK OF 60 PINK PAISLEY CAKE CASES,9,358,10,1100,742,1,20
9084,68 TEATIME FAIRY CAKE CASES,8,1637,16,1700,63,1,32
9085,TOMATO CHARLIE+LOLA COASTER SET,1,1020,17,1800,780,1,34
9086,CHARLIE & LOLA WASTEPAPER BIN FLORA,5,122,1,200,78,1,2
9087,RED CHARLIE+LOLA PERSONAL DOORSIGN,9,429,8,900,471,1,16
9088,JUMBO STORAGE BAG SUKI,7,1259,19,2000,741,1,38
9089,JUMBO BAG PINK VINTAGE PAISLEY,6,1250,17,1800,550,1,34
9090,JAM MAKING SET PRINTED,1,987,21,2200,1213,1,42
9091,RETROSPOT TEA SET CERAMIC 11 PC ,7,193,1,200,7,1,2
9092,GIRLY PINK TOOL SET,3,461,18,1900,1439,1,36
9093,JUMBO SHOPPER VINTAGE RED PAISLEY,9,817,14,1500,683,1,28
9094,"AIRLINE LOUNGE,METAL SIGN",9,112,6,700,588,1,12
9095,WHITE SPOT RED CERAMIC DRAWER KNOB,4,548,17,1800,1252,1,34
9096,RED DRAWER KNOB ACRYLIC EDWARDIAN,10,539,8,900,361,1,16
9097,CLEAR DRAWER KNOB ACRYLIC EDWARDIAN,9,217,2,300,83,1,4
9098,PHOTO CLIP LINE,10,2072,21,2200,128,1,42
9099,FELT EGG COSY CHICKEN,6,123,1,200,77,1,2
9100,PIGGY BANK RETROSPOT ,4,1979,20,2100,121,1,40
9101,SKULL SHOULDER BAG,2,1671,19,2000,329,1,38
9102,YOU'RE CONFUSING ME METAL SIGN ,3,586,6,700,114,1,12
9103,COOK WITH WINE METAL SIGN ,10,981,24,2500,1519,1,48
9104,GIN + TONIC DIET METAL SIGN,10,942,21,2200,1258,1,42
9105,YELLOW BREAKFAST CUP AND SAUCER,7,857,25,2600,1743,1,50
9106,PINK BREAKFAST CUP AND SAUCER ,4,274,8,900,626,1,16
9107,PAPER CHAIN KIT 50'S CHRISTMAS ,1,100,0,100,0,1,0
9108,PAPER CHAIN KIT RETROSPOT,7,1435,23,2400,965,1,46
9109,SMALL HEART FLOWERS HOOK ,6,1234,12,1300,66,1,24
9110,PHOTO CLIP LINE,10,574,5,600,26,1,10
9111,TEA TIME DES TEA COSY,1,1010,17,1800,790,1,34
9112,FELT EGG COSY WHITE RABBIT ,5,2262,22,2300,38,1,44
9113,ZINC WILLIE WINKIE  CANDLE STICK,3,310,10,1100,790,1,20
9114,CERAMIC CHERRY CAKE MONEY BANK,10,784,13,1400,616,1,26
9115,RETROSPOT LARGE MILK JUG,5,819,15,1600,781,1,30
9116,SET OF 6 FUNKY BEAKERS,7,1028,11,1200,172,1,22
9117,EDWARDIAN PARASOL BLACK,1,2259,25,2600,341,1,50
9118,EDWARDIAN PARASOL NATURAL,6,123,1,200,77,1,2
9119,CERAMIC STRAWBERRY CAKE MONEY BANK,1,183,2,300,117,1,4
9120,BLUE OWL SOFT TOY,7,1332,13,1400,68,1,26
9121,BALLOON ART MAKE YOUR OWN FLOWERS,9,167,5,600,433,1,10
9122,RED TOADSTOOL LED NIGHT LIGHT,4,322,19,2000,1678,1,38
9123,GLASS CLOCHE SMALL,2,293,11,1200,907,1,22
9124,GUMBALL MONOCHROME COAT RACK,8,503,10,1100,597,1,20
9125,DOORMAT FANCY FONT HOME SWEET HOME,10,240,3,400,160,1,6
9126,Discount,8,112,3,400,288,1,6
9127,INFLATABLE POLITICAL GLOBE ,7,1741,24,2500,759,1,48
9128,VINTAGE SNAKES & LADDERS,7,235,25,2600,2365,1,50
9129,CHOCOLATE CALCULATOR,7,467,4,500,33,1,8
9130,JUMBO SHOPPER VINTAGE RED PAISLEY,4,1144,11,1200,56,1,22
9131,RECYCLING BAG RETROSPOT ,5,136,1,200,64,1,2
9132,TOY TIDY PINK POLKADOT,7,109,1,200,91,1,2
9133,ANTIQUE GLASS DRESSING TABLE POT,9,463,20,2100,1637,1,40
9134,ALARM CLOCK BAKELIKE GREEN,6,100,0,100,0,1,0
9135,IVORY GIANT GARDEN THERMOMETER,5,576,18,1900,1324,1,36
9136,11 TIER CAKE TIN GREEN AND CREAM,1,100,2,300,200,1,4
9137,11 TIER CAKE TIN RED AND CREAM,6,905,20,2100,1195,1,40
9138,SET 3 WICKER OVAL BASKETS W LIDS,2,613,25,2600,1987,1,50
9139,SET OF 3 COLOURED  FLYING DUCKS,1,419,4,500,81,1,8
9140,WOOD BLACK BOARD ANT WHITE FINISH,6,115,16,1700,1585,1,32
9141,COLOUR GLASS T-LIGHT HOLDER HANGING,8,722,11,1200,478,1,22
9142,HANGING METAL HEART LANTERN,10,217,16,1700,1483,1,32
9143,HANGING MEDINA LANTERN SMALL,6,133,1,200,67,1,2
9144,NATURAL SLATE HEART CHALKBOARD ,8,100,0,100,0,1,0
9145,HEART OF WICKER SMALL,4,710,13,1400,690,1,26
9146,HEART OF WICKER LARGE,8,225,2,300,75,1,4
9147,WHITE LOVEBIRD LANTERN,4,322,18,1900,1578,1,36
9148,CLASSIC METAL BIRDCAGE PLANT HOLDER,4,271,3,400,129,1,6
9149,CREAM HEART CARD HOLDER,5,1592,25,2600,1008,1,50
9150,ENAMEL FLOWER JUG CREAM,4,251,13,1400,1149,1,26
9151,ENAMEL FIRE BUCKET CREAM,6,893,21,2200,1307,1,42
9152,ENAMEL BREAD BIN CREAM,7,641,10,1100,459,1,20
9153,SET 3 WICKER OVAL BASKETS W LIDS,2,770,7,800,30,1,14
9154,JAM MAKING SET PRINTED,2,1653,21,2200,547,1,42
9155,JAM MAKING SET WITH JARS,10,379,11,1200,821,1,22
9156,JUMBO BAG DOLLY GIRL DESIGN,2,926,10,1100,174,1,20
9157,TRADITIONAL CHRISTMAS RIBBONS,5,1633,16,1700,67,1,32
9158,ORGANISER WOOD ANTIQUE WHITE ,10,116,1,200,84,1,2
9159,LUNCH BAG DOLLY GIRL DESIGN,10,1915,22,2300,385,1,44
9160,WHITE WIRE EGG HOLDER,7,521,9,1000,479,1,18
9161,JUMBO  BAG BAROQUE BLACK WHITE,3,1205,15,1600,395,1,30
9162,JUMBO BAG RED RETROSPOT,5,1925,23,2400,475,1,46
9163,CHILLI LIGHTS,10,892,10,1100,208,1,20
9164,LIGHT GARLAND BUTTERFILES PINK,2,1105,22,2300,1195,1,44
9165,WOODEN OWLS LIGHT GARLAND ,6,275,10,1100,825,1,20
9166,FAIRY TALE COTTAGE NIGHTLIGHT,7,632,7,800,168,1,14
9167,RED TOADSTOOL LED NIGHT LIGHT,9,375,4,500,125,1,8
9168,HOME BUILDING BLOCK WORD,2,1478,20,2100,622,1,40
9169,LOVE BUILDING BLOCK WORD,6,231,11,1200,969,1,22
9170,DOORMAT FANCY FONT HOME SWEET HOME,2,141,3,400,259,1,6
9171,HOME SMALL WOOD LETTERS,4,903,11,1200,297,1,22
9172,GINGHAM HEART  DOORSTOP RED,2,2459,24,2500,41,1,48
9173,FIVE HEART HANGING DECORATION,2,2393,25,2600,207,1,50
9174,HANGING METAL HEART LANTERN,1,452,9,1000,548,1,18
9175,ASSORTED BOTTLE TOP  MAGNETS ,3,429,6,700,271,1,12
9176,FRIDGE MAGNETS US DINER ASSORTED,10,828,9,1000,172,1,18
9177,HOMEMADE JAM SCENTED CANDLES,5,143,2,300,157,1,4
9178,FRIDGE MAGNETS LES ENFANTS ASSORTED,10,1046,13,1400,354,1,26
9179,ROSE CARAVAN DOORSTOP,4,100,0,100,0,1,0
9180,HEART OF WICKER SMALL,1,1608,18,1900,292,1,36
9181,13 HOOK HANGER MAGIC TOADSTOOL,3,406,7,800,394,1,14
9182,CHRISTMAS LIGHTS 10 REINDEER,10,283,3,400,117,1,6
9183,VINTAGE UNION JACK CUSHION COVER,3,199,2,300,101,1,4
9184,VINTAGE HEADS AND TAILS CARD GAME ,1,563,25,2600,2037,1,50
9185,SET OF 3 COLOURED  FLYING DUCKS,1,2515,25,2600,85,1,50
9186,SET OF 3 GOLD FLYING DUCKS,1,388,18,1900,1512,1,36
9187,RED RETROSPOT UMBRELLA,4,232,10,1100,868,1,20
9188,BLACK/BLUE POLKADOT UMBRELLA,8,1939,21,2200,261,1,42
9189,RED DINER WALL CLOCK,3,110,21,2200,2090,1,42
9190,ALARM CLOCK BAKELIKE GREEN,9,352,5,600,248,1,10
9191,ALARM CLOCK BAKELIKE RED ,1,1460,14,1500,40,1,28
9192,BLUE DINER WALL CLOCK,3,240,11,1200,960,1,22
9193,IVORY DINER WALL CLOCK,2,1444,21,2200,756,1,42
9194,LARGE HEART MEASURING SPOONS,2,132,1,200,68,1,2
9195,SMALL HEART MEASURING SPOONS,7,636,21,2200,1564,1,42
9196,CHRISTMAS LIGHTS 10 REINDEER,9,929,22,2300,1371,1,44
9197,JAM MAKING SET WITH JARS,10,923,12,1300,377,1,24
9198,JAM MAKING SET PRINTED,5,133,1,200,67,1,2
9199,JAM JAR WITH PINK LID,5,974,20,2100,1126,1,40
9200,JAM JAR WITH GREEN LID,4,559,9,1000,441,1,18
9201,ROSE COTTAGE KEEPSAKE BOX ,3,154,3,400,246,1,6
9202,HANGING HEART ZINC T-LIGHT HOLDER,4,1553,21,2200,647,1,42
9203,PAPER CHAIN KIT VINTAGE CHRISTMAS,1,774,22,2300,1526,1,44
9204,DISCO BALL CHRISTMAS DECORATION,4,296,19,2000,1704,1,38
9205,WHITE HANGING HEART T-LIGHT HOLDER,3,256,22,2300,2044,1,44
9206,SMALL POPCORN HOLDER,4,329,14,1500,1171,1,28
9207,LARGE POPCORN HOLDER ,8,942,20,2100,1158,1,40
9208,RETROSPOT LARGE MILK JUG,9,1791,24,2500,709,1,48
9209,SET/20 RED RETROSPOT PAPER NAPKINS ,9,183,1,200,17,1,2
9210,SET/6 RED SPOTTY PAPER PLATES,8,1175,19,2000,825,1,38
9211,SET/6 RED SPOTTY PAPER CUPS,9,194,1,200,6,1,2
9212,POLKADOT RAIN HAT ,5,128,11,1200,1072,1,22
9213,DELUXE SEWING KIT ,4,1081,17,1800,719,1,34
9214,RETROSPOT HEART HOT WATER BOTTLE,7,166,7,800,634,1,14
9215,KNITTED UNION FLAG HOT WATER BOTTLE,8,243,5,600,357,1,10
9216,ENGLISH ROSE HOT WATER BOTTLE,8,468,19,2000,1532,1,38
9217,PHOTO CUBE,8,175,14,1500,1325,1,28
9218,HOMEMADE JAM SCENTED CANDLES,9,174,4,500,326,1,8
9219,JUMBO BAG RED RETROSPOT,10,505,18,1900,1395,1,36
9220,PLASTERS IN TIN CIRCUS PARADE ,9,399,3,400,1,1,6
9221,PACK OF 12 PINK PAISLEY TISSUES ,4,123,2,300,177,1,4
9222,PACK OF 12 BLUE PAISLEY TISSUES ,5,1616,20,2100,484,1,40
9223,PACK OF 12 RED RETROSPOT TISSUES ,7,414,7,800,386,1,14
9224,CHICK GREY HOT WATER BOTTLE,10,1045,12,1300,255,1,24
9225,PLASTERS IN TIN VINTAGE PAISLEY ,9,472,18,1900,1428,1,36
9226,PLASTERS IN TIN SKULLS,5,112,11,1200,1088,1,22
9227,11 STRIPEY MICE FELTCRAFT,2,287,20,2100,1813,1,40
9228,SET OF 6 SOLDIER SKITTLES,9,1695,18,1900,205,1,36
9229,TRADITIONAL WOODEN SKIPPING ROPE,3,566,13,1400,834,1,26
9230,WOODEN BOX OF DOMINOES,9,1236,23,2400,1164,1,46
9231,RUSTIC  SEVENTEEN DRAWER SIDEBOARD,4,357,9,1000,643,1,18
9232,PARTY CONES CARNIVAL ASSORTED,2,2159,24,2500,341,1,48
9233,PARTY CONES CANDY ASSORTED,10,1351,14,1500,149,1,28
9234,PICNIC BASKET WICKER SMALL,8,141,3,400,259,1,6
9235,ASSORTED COLOUR BIRD ORNAMENT,10,932,17,1800,868,1,34
9236,STAR DECORATION PAINTED ZINC ,1,151,2,300,149,1,4
9237,RETROSPOT LAMP,9,373,6,700,327,1,12
9238,"FANCY FONT BIRTHDAY CARD, ",8,686,7,800,114,1,14
9239,HAND WARMER UNION JACK,6,732,22,2300,1568,1,44
9240,HAND WARMER SCOTTY DOG DESIGN,7,1333,23,2400,1067,1,46
9241,HAND WARMER OWL DESIGN,5,183,1,200,17,1,2
9242,HAND WARMER RED RETROSPOT,3,789,7,800,11,1,14
9243,RETROSPOT HEART HOT WATER BOTTLE,8,1541,20,2100,559,1,40
9244,DOG BOWL CHASING BALL DESIGN,4,1631,21,2200,569,1,42
9245,CLOTHES PEGS RETROSPOT PACK 32,10,1283,19,2000,717,1,38
9246,HAND OVER THE CHOCOLATE   SIGN ,7,503,22,2300,1797,1,44
9247,WHITE HANGING HEART T-LIGHT HOLDER,2,1758,22,2300,542,1,44
9248,TRAVEL SEWING KIT,3,424,13,1400,976,1,26
9249,BLACK HEART CARD HOLDER,1,380,5,600,220,1,10
9250,ASSORTED COLOUR BIRD ORNAMENT,3,237,12,1300,1063,1,24
9251,PACK OF 60 PINK PAISLEY CAKE CASES,6,397,7,800,403,1,14
9252,68 TEATIME FAIRY CAKE CASES,4,1527,18,1900,373,1,36
9253,PACK OF 72 RETROSPOT CAKE CASES,9,608,17,1800,1192,1,34
9254,CHICK GREY HOT WATER BOTTLE,3,140,7,800,660,1,14
9255,SMALL GLASS HEART TRINKET POT,2,382,3,400,18,1,6
9256,ALARM CLOCK BAKELIKE IVORY,9,843,21,2200,1357,1,42
9257,ALARM CLOCK BAKELIKE RED ,1,1563,15,1600,37,1,30
9258,ALARM CLOCK BAKELIKE ORANGE,10,117,2,300,183,1,4
9259,ALARM CLOCK BAKELIKE GREEN,1,1038,17,1800,762,1,34
9260,HOT WATER BOTTLE TEA AND SYMPATHY,2,104,1,200,96,1,2
9261,HAND WARMER BIRD DESIGN,3,151,2,300,149,1,4
9262,HAND WARMER SCOTTY DOG DESIGN,5,1185,21,2200,1015,1,42
9263,WHITE HANGING HEART T-LIGHT HOLDER,10,163,1,200,37,1,2
9264,WHITE METAL LANTERN,1,733,13,1400,667,1,26
9265,CREAM CUPID HEARTS COAT HANGER,6,197,4,500,303,1,8
9266,EDWARDIAN PARASOL BLACK,6,743,9,1000,257,1,18
9267,EDWARDIAN PARASOL RED,9,1011,19,2000,989,1,38
9268,RETRO COFFEE MUGS ASSORTED,2,145,1,200,55,1,2
9269,SAVE THE PLANET MUG,10,210,2,300,90,1,4
9270,VINTAGE BILLBOARD DRINK ME MUG,1,248,5,600,352,1,10
9271,VINTAGE BILLBOARD LOVE/HATE MUG,7,1299,17,1800,501,1,34
9272,WOOD 2 DRAWER CABINET WHITE FINISH,1,324,17,1800,1476,1,34
9273,WOOD S/3 CABINET ANT WHITE FINISH,3,287,6,700,413,1,12
9274,WOODEN PICTURE FRAME WHITE FINISH,4,464,10,1100,636,1,20
9275,WOODEN FRAME ANTIQUE WHITE ,5,132,22,2300,2168,1,44
9276,KNITTED UNION FLAG HOT WATER BOTTLE,10,1287,21,2200,913,1,42
9277,RED WOOLLY HOTTIE WHITE HEART.,3,133,2,300,167,1,4
9278,SET 7 BABUSHKA NESTING BOXES,5,100,0,100,0,1,0
9279,IVORY EMBROIDERED QUILT ,1,864,24,2500,1636,1,48
9280,GLASS STAR FROSTED T-LIGHT HOLDER,4,846,24,2500,1654,1,48
9281,SET OF 3 BLACK FLYING DUCKS,4,231,19,2000,1769,1,38
9282,SET OF 3 COLOURED  FLYING DUCKS,6,133,1,200,67,1,2
9283,PACK OF 12 RED RETROSPOT TISSUES ,1,175,4,500,325,1,8
9284,RED RETROSPOT MUG,3,132,6,700,568,1,12
9285,BABUSHKA LIGHTS STRING OF 18,2,150,2,300,150,1,4
9286,PIGGY BANK RETROSPOT ,10,473,20,2100,1627,1,40
9287,SET 7 BABUSHKA NESTING BOXES,5,650,12,1300,650,1,24
9288,DOORMAT FAIRY CAKE,1,1408,25,2600,1192,1,50
9289,HAND WARMER RED RETROSPOT,4,961,10,1100,139,1,20
9290,HAND WARMER SCOTTY DOG DESIGN,8,1441,25,2600,1159,1,50
9291,HAND WARMER OWL DESIGN,7,347,3,400,53,1,6
9292,STRAWBERRY CERAMIC TRINKET BOX,4,745,9,1000,255,1,18
9293,PINK DOUGHNUT TRINKET POT ,4,505,6,700,195,1,12
9294,SILK PURSE BABUSHKA PINK,3,308,15,1600,1292,1,30
9295,HOT WATER BOTTLE TEA AND SYMPATHY,4,427,6,700,273,1,12
9296,HOT WATER BOTTLE I AM SO POORLY,5,153,12,1300,1147,1,24
9297,CHOCOLATE HOT WATER BOTTLE,6,868,22,2300,1432,1,44
9298,WHITE SKULL HOT WATER BOTTLE ,2,537,12,1300,763,1,24
9299,SCOTTIE DOG HOT WATER BOTTLE,2,166,5,600,434,1,10
9300,HAND WARMER RED POLKA DOT,9,264,15,1600,1336,1,30
9301,HAND WARMER UNION JACK,5,415,18,1900,1485,1,36
9302,HOMEMADE JAM SCENTED CANDLES,1,766,19,2000,1234,1,38
9303,BIRD HOUSE HOT WATER BOTTLE,8,293,2,300,7,1,4
9304,BOUDOIR SQUARE TISSUE BOX,4,1351,25,2600,1249,1,50
9305,SKULLS SQUARE TISSUE BOX,10,807,14,1500,693,1,28
9306,PHOTO FRAME CORNICE,6,120,11,1200,1080,1,22
9307,SILK PURSE BABUSHKA RED,7,250,2,300,50,1,4
9308,PICTURE DOMINOES,8,170,1,200,30,1,2
9309,S/6 SEW ON CROCHET FLOWERS,9,146,23,2400,2254,1,46
9310,SCANDINAVIAN REDS RIBBONS,2,322,24,2500,2178,1,48
9311,BALLOONS  WRITING SET ,9,2071,20,2100,29,1,40
9312,JAM MAKING SET PRINTED,1,113,3,400,287,1,6
9313,LAVENDER INCENSE IN TIN,10,1285,14,1500,215,1,28
9314,TV DINNER TRAY VINTAGE PAISLEY,5,100,0,100,0,1,0
9315,SET OF 4 ENGLISH ROSE PLACEMATS,1,1560,19,2000,440,1,38
9316,SET OF 4 ENGLISH ROSE COASTERS,7,405,4,500,95,1,8
9317,TRIPLE PHOTO FRAME CORNICE ,7,132,5,600,468,1,10
9318,FAMILY PHOTO FRAME CORNICE,2,871,8,900,29,1,16
9319,MIRRORED DISCO BALL ,7,329,3,400,71,1,6
9320,DISCO BALL ROTATOR BATTERY OPERATED,8,313,8,900,587,1,16
9321,SILVER LOOKING MIRROR,9,520,8,900,380,1,16
9322,LADIES & GENTLEMEN METAL SIGN,2,125,4,500,375,1,8
9323,METAL SIGN HER DINNER IS SERVED ,6,1075,22,2300,1225,1,44
9324,YOU'RE CONFUSING ME METAL SIGN ,2,177,6,700,523,1,12
9325,DOORMAT TOPIARY,8,1707,25,2600,893,1,50
9326,BATHROOM METAL SIGN,2,193,9,1000,807,1,18
9327,KITCHEN METAL SIGN,1,268,2,300,32,1,4
9328,TOILET METAL SIGN,4,275,10,1100,825,1,20
9329,METAL SIGN TAKE IT OR LEAVE IT ,3,269,2,300,31,1,4
9330,I'M ON HOLIDAY METAL SIGN,4,507,8,900,393,1,16
9331,GROW YOUR OWN BASIL IN ENAMEL MUG,8,282,11,1200,918,1,22
9332,SET/10 PINK POLKADOT PARTY CANDLES,3,881,19,2000,1119,1,38
9333,SET 20 NAPKINS FAIRY CAKES DESIGN ,5,132,4,500,368,1,8
9334,68 TEATIME FAIRY CAKE CASES,7,131,3,400,269,1,6
9335,SET OF 6 T-LIGHTS SNOWMEN,6,1429,14,1500,71,1,28
9336,SET OF 6 T-LIGHTS SANTA,10,385,6,700,315,1,12
9337,SET OF 9 HEART SHAPED BALLOONS,8,770,12,1300,530,1,24
9338,SANDWICH BATH SPONGE,6,971,9,1000,29,1,18
9339,APPLE BATH SPONGE,4,505,5,600,95,1,10
9340,STRAWBERRY BATH SPONGE ,9,144,10,1100,956,1,20
9341,BLACK PIRATE TREASURE CHEST,4,238,4,500,262,1,8
9342,STAR PORTABLE TABLE LIGHT ,10,689,9,1000,311,1,18
9343,SNOWFLAKE PORTABLE TABLE LIGHT ,8,1162,13,1400,238,1,26
9344,PINK OVAL JEWELLED MIRROR,9,1422,23,2400,978,1,46
9345,RETROSPOT CIGAR BOX MATCHES ,9,179,2,300,121,1,4
9346,COSY HOUR GIANT TUBE MATCHES,4,912,14,1500,588,1,28
9347,JAZZ HEARTS PURSE NOTEBOOK,9,1577,21,2200,623,1,42
9348,LUNCH BAG DOLLY GIRL DESIGN,3,100,0,100,0,1,0
9349,WHITE HANGING HEART T-LIGHT HOLDER,2,277,3,400,123,1,6
9350,CANDLEHOLDER PINK HANGING HEART,10,243,3,400,157,1,6
9351,WOOD 2 DRAWER CABINET WHITE FINISH,6,713,11,1200,487,1,22
9352,ASSORTED COLOUR MINI CASES,8,191,9,1000,809,1,18
9353,LUNCH BAG RED RETROSPOT,4,755,12,1300,545,1,24
9354,LUNCH BAG SPACEBOY DESIGN ,1,1597,21,2200,603,1,42
9355,LUNCH BAG WOODLAND,5,1469,19,2000,531,1,38
9356,LUNCH BAG PINK POLKADOT,4,312,11,1200,888,1,22
9357,GUMBALL COAT RACK,5,598,10,1100,502,1,20
9358,BLUE NEW BAROQUE CANDLESTICK CANDLE,5,915,15,1600,685,1,30
9359,PINK NEW BAROQUECANDLESTICK CANDLE,6,1900,22,2300,400,1,44
9360,FAIRY CAKE FLANNEL ASSORTED COLOUR,4,1045,12,1300,255,1,24
9361,BREAD BIN DINER STYLE PINK,7,450,13,1400,950,1,26
9362,JUMBO BAG CHARLIE AND LOLA TOYS,6,462,21,2200,1738,1,42
9363,TEA TIME TABLE CLOTH,5,595,10,1100,505,1,20
9364,ENGLISH ROSE HOT WATER BOTTLE,10,343,4,500,157,1,8
9365,ENAMEL FIRE BUCKET CREAM,1,272,18,1900,1628,1,36
9366,PICNIC BASKET WICKER SMALL,7,191,1,200,9,1,2
9367,PAPER CHAIN KIT 50'S CHRISTMAS ,2,259,3,400,141,1,6
9368,PAPER CHAIN KIT VINTAGE CHRISTMAS,1,319,23,2400,2081,1,46
9369,HOT WATER BOTTLE BABUSHKA ,3,350,8,900,550,1,16
9370,HAND WARMER BIRD DESIGN,3,1100,15,1600,500,1,30
9371,POSTAGE,9,1548,21,2200,652,1,42
9372,HEART IVORY TRELLIS SMALL,7,859,9,1000,141,1,18
9373,CLEAR DRAWER KNOB ACRYLIC EDWARDIAN,8,1943,21,2200,257,1,42
9374,PINK DRAWER KNOB ACRYLIC EDWARDIAN,7,2410,24,2500,90,1,48
9375,GREEN DRAWER KNOB ACRYLIC EDWARDIAN,1,1982,22,2300,318,1,44
9376,BLUE DRAWER KNOB ACRYLIC EDWARDIAN,5,235,4,500,265,1,8
9377,HEART OF WICKER SMALL,10,1079,18,1900,821,1,36
9378,SMALL POPCORN HOLDER,4,1033,13,1400,367,1,26
9379,SET 6 FOOTBALL CELEBRATION CANDLES,9,489,21,2200,1711,1,42
9380,SET OF 6 GIRLS CELEBRATION CANDLES,9,596,5,600,4,1,10
9381,ROMANTIC PINKS RIBBONS ,5,1139,16,1700,561,1,32
9382,BRIGHT BLUES RIBBONS ,5,906,10,1100,194,1,20
9383,SCANDINAVIAN REDS RIBBONS,2,1811,21,2200,389,1,42
9384,CHOCOLATE BOX RIBBONS ,9,996,9,1000,4,1,18
9385,PARTY INVITES FOOTBALL,10,1551,20,2100,549,1,40
9386,PARTY INVITES JAZZ HEARTS,3,331,10,1100,769,1,20
9387,PARTY INVITES SPACEMAN,2,139,12,1300,1161,1,24
9388,SET OF 3 BUTTERFLY COOKIE CUTTERS,6,1108,17,1800,692,1,34
9389,SET OF 3 HEART COOKIE CUTTERS,8,305,5,600,295,1,10
9390,11 PIECE SPACEBOY COOKIE CUTTER SET,2,1278,15,1600,322,1,30
9391,PACK OF 72 SKULL CAKE CASES,9,670,10,1100,430,1,20
9392,PACK OF 60 SPACEBOY CAKE CASES,4,1156,17,1800,644,1,34
9393,PACK OF 72 RETROSPOT CAKE CASES,10,119,5,600,481,1,10
9394,80 SWEETHEART FAIRY CAKE CASES,10,245,17,1800,1555,1,34
9395,PACK OF 60 DINOSAUR CAKE CASES,3,1704,24,2500,796,1,48
9396,LUNCH BAG SUKI  DESIGN ,9,1376,20,2100,724,1,40
9397,LUNCH BAG CARS BLUE,7,100,0,100,0,1,0
9398,LUNCH BAG  BLACK SKULL.,2,100,0,100,0,1,0
9399,HEART IVORY TRELLIS LARGE,7,575,23,2400,1825,1,46
9400,SET/5 RED RETROSPOT LID GLASS BOWLS,6,248,11,1200,952,1,22
9401,WHITE HANGING HEART T-LIGHT HOLDER,5,1210,16,1700,490,1,32
9402,WHITE METAL LANTERN,8,1365,25,2600,1235,1,50
9403,CREAM CUPID HEARTS COAT HANGER,8,1527,21,2200,673,1,42
9404,EDWARDIAN PARASOL RED,3,855,22,2300,1445,1,44
9405,RETRO COFFEE MUGS ASSORTED,8,417,13,1400,983,1,26
9406,SAVE THE PLANET MUG,3,473,8,900,427,1,16
9407,VINTAGE BILLBOARD DRINK ME MUG,10,1197,20,2100,903,1,40
9408,VINTAGE BILLBOARD LOVE/HATE MUG,3,474,22,2300,1826,1,44
9409,WOOD 2 DRAWER CABINET WHITE FINISH,8,760,14,1500,740,1,28
9410,WOOD S/3 CABINET ANT WHITE FINISH,4,289,3,400,111,1,6
9411,WOODEN PICTURE FRAME WHITE FINISH,8,587,15,1600,1013,1,30
9412,WOODEN FRAME ANTIQUE WHITE ,1,1206,23,2400,1194,1,46
9413,KNITTED UNION FLAG HOT WATER BOTTLE,9,168,4,500,332,1,8
9414,RED WOOLLY HOTTIE WHITE HEART.,3,1203,17,1800,597,1,34
9415,SET 7 BABUSHKA NESTING BOXES,8,1169,14,1500,331,1,28
9416,IVORY EMBROIDERED QUILT ,1,498,24,2500,2002,1,48
9417,GLASS STAR FROSTED T-LIGHT HOLDER,1,366,4,500,134,1,8
9418,HAND WARMER RED POLKA DOT,8,177,1,200,23,1,2
9419,HAND WARMER UNION JACK,10,199,5,600,401,1,10
9420,MAGIC DRAWING SLATE DINOSAUR,9,335,9,1000,665,1,18
9421,MAGIC DRAWING SLATE BAKE A CAKE ,6,1151,18,1900,749,1,36
9422,20 PENCILS TALL TUBE SKULLS,7,398,6,700,302,1,12
9423,CHOCOLATE CALCULATOR,1,898,17,1800,902,1,34
9424,RED  HARMONICA IN BOX ,1,1915,19,2000,85,1,38
9425,BLUE HARMONICA IN BOX ,3,1089,17,1800,711,1,34
9426,SKULLS  WATER TRANSFER TATTOOS ,6,167,1,200,33,1,2
9427,PACK 3 BOXES BIRD PANNETONE ,4,2260,25,2600,340,1,50
9428,HOT WATER BOTTLE TEA AND SYMPATHY,4,358,3,400,42,1,6
9429,RED WOOLLY HOTTIE WHITE HEART.,10,100,0,100,0,1,0
9430,WHITE SKULL HOT WATER BOTTLE ,9,259,14,1500,1241,1,28
9431,11 PIECE SPACEBOY COOKIE CUTTER SET,2,2200,23,2400,200,1,46
9432,SET OF 20 KIDS COOKIE CUTTERS,3,1174,25,2600,1426,1,50
9433,18 COLOUR SPACEBOY PEN,4,445,23,2400,1955,1,46
9434,VICTORIAN GLASS HANGING T-LIGHT,8,632,6,700,68,1,12
9435,SINGLE HEART ZINC T-LIGHT HOLDER,9,666,21,2200,1534,1,42
9436,RED HANGING HEART T-LIGHT HOLDER,4,2437,25,2600,163,1,50
9437,HANGING METAL STAR LANTERN,5,1568,19,2000,432,1,38
9438,SILVER HANGING T-LIGHT HOLDER,8,608,11,1200,592,1,22
9439,DOORMAT RED RETROSPOT,6,263,13,1400,1137,1,26
9440,DOORMAT HEARTS,8,122,1,200,78,1,2
9441,NATURAL SLATE RECTANGLE CHALKBOARD,10,728,13,1400,672,1,26
9442,LOVEBIRD HANGING DECORATION WHITE ,7,146,2,300,154,1,4
9443,ASSORTED COLOUR BIRD ORNAMENT,9,655,20,2100,1445,1,40
9444,HOME BUILDING BLOCK WORD,4,386,5,600,214,1,10
9445,LOVE BUILDING BLOCK WORD,1,953,19,2000,1047,1,38
9446,PHOTO FRAME CORNICE,10,179,5,600,421,1,10
9447,PENS ASSORTED FUNNY FACE,3,100,0,100,0,1,0
9448,CARD CIRCUS PARADE,9,1261,20,2100,839,1,40
9449,WRAP COWBOYS  ,8,600,22,2300,1700,1,44
9450,AIRLINE BAG VINTAGE TOKYO 86,7,1726,24,2500,774,1,48
9451,RED RETROSPOT UMBRELLA,8,571,24,2500,1929,1,48
9452,BLACK/BLUE POLKADOT UMBRELLA,10,975,12,1300,325,1,24
9453,RED 3 PIECE RETROSPOT CUTLERY SET,6,130,2,300,170,1,4
9454,PACK OF 72 RETROSPOT CAKE CASES,9,2150,25,2600,450,1,50
9455,SET OF 72 RETROSPOT PAPER  DOILIES,1,150,7,800,650,1,14
9456,BLUE COAT RACK PARIS FASHION,9,1454,17,1800,346,1,34
9457,PLASTERS IN TIN SKULLS,8,1139,15,1600,461,1,30
9458,SLEEPING CAT ERASERS,3,100,0,100,0,1,0
9459,CARD BIRTHDAY COWBOY,8,115,2,300,185,1,4
9460,PACK 3 BOXES CHRISTMAS PANNETONE,9,757,7,800,43,1,14
9461,ROTATING SILVER ANGELS T-LIGHT HLDR,10,126,7,800,674,1,14
9462,COSY HOUR GIANT TUBE MATCHES,1,1298,17,1800,502,1,34
9463,RIBBON REEL MAKING SNOWMEN ,3,515,8,900,385,1,16
9464,MINI PAINT SET VINTAGE ,8,1871,25,2600,729,1,50
9465,12 TRADITIONAL SPINNING TOPS,6,921,13,1400,479,1,26
9466,SET OF 6 SOLDIER SKITTLES,4,635,8,900,265,1,16
9467,BAG 500g SWIRLY MARBLES,4,618,9,1000,382,1,18
9468,13 STRAND GLASS NECKLACE CRYSTAL,2,1892,25,2600,708,1,50
9469,WHITE SKULL HOT WATER BOTTLE ,9,1937,19,2000,63,1,38
9470,SCOTTIE DOG HOT WATER BOTTLE,8,576,5,600,24,1,10
9471,SQUARECUSHION COVER PINK UNION FLAG,5,363,11,1200,837,1,22
9472,SPACEBOY CHILDRENS EGG CUP,1,260,4,500,240,1,8
9473,CHILDREN'S SPACEBOY MUG,3,268,15,1600,1332,1,30
9474,HAND WARMER SCOTTY DOG DESIGN,7,162,1,200,38,1,2
9475,FELTCRAFT CUSHION OWL,4,546,5,600,54,1,10
9476,BLACK CANDELABRA T-LIGHT HOLDER,2,1199,11,1200,1,1,22
9477,TOY TIDY DOLLY GIRL DESIGN,8,1486,18,1900,414,1,36
9478,SET 12 LAVENDER  BOTANICAL T-LIGHTS,6,197,10,1100,903,1,20
9479,UNION JACK FLAG LUGGAGE TAG,5,128,9,1000,872,1,18
9480,RED HEART LUGGAGE TAG,7,1529,23,2400,871,1,46
9481,RED GLASS TASSLE BAG CHARM,7,314,6,700,386,1,12
9482,CLEAR ACRYLIC FACETED BANGLE,1,108,1,200,92,1,2
9483,13 STRAND GLASS NECKLACE CRYSTAL,1,188,1,200,12,1,2
9484,DOORMAT UNION JACK GUNS AND ROSES,4,498,8,900,402,1,16
9485,VANILLA SCENT CANDLE JEWELLED BOX,9,854,9,1000,146,1,18
9486,FULL ENGLISH BREAKFAST PLATE,10,212,12,1300,1088,1,24
9487,BLACK CANDELABRA T-LIGHT HOLDER,10,1568,17,1800,232,1,34
9488,MAGIC DRAWING SLATE CIRCUS PARADE  ,6,379,4,500,121,1,8
9489,CHRISTMAS HANGING HEART WITH BELL,9,496,14,1500,1004,1,28
9490,CAKE STAND VICTORIAN FILIGREE MED,3,148,1,200,52,1,2
9491,PAISLEY PATTERN  STICKERS,3,709,21,2200,1491,1,42
9492,FLOWERS  STICKERS,3,270,7,800,530,1,14
9493,PINK NEW BAROQUECANDLESTICK CANDLE,3,105,6,700,595,1,12
9494,BLUE NEW BAROQUE CANDLESTICK CANDLE,5,1752,22,2300,548,1,44
9495,JUMBO STORAGE BAG SUKI,1,498,13,1400,902,1,26
9496,BLACK LOVE BIRD CANDLE,3,325,3,400,75,1,6
9497,PARTY TIME PENCIL ERASERS,4,234,11,1200,966,1,22
9498,DISCO BALL CHRISTMAS DECORATION,10,1091,19,2000,909,1,38
9499,PINK B'FLY C/COVER W BOBBLES,2,385,13,1400,1015,1,26
9500,PINK UNION JACK  LUGGAGE TAG,8,100,0,100,0,1,0
9501,14 RIBBONS ELEGANT CHRISTMAS ,10,100,4,500,400,1,8
9502,UNION JACK FLAG LUGGAGE TAG,4,1861,18,1900,39,1,36
9503,AGED GLASS SILVER T-LIGHT HOLDER,9,243,3,400,157,1,6
9504,BOOM BOX SPEAKER GIRLS,3,260,3,400,140,1,6
9505,14 RIBBONS SHIMMERING PINKS ,9,1110,17,1800,690,1,34
9506, SET 2 TEA TOWELS I LOVE LONDON ,2,1043,17,1800,757,1,34
9507,JUMBO BAG OWLS,8,550,14,1500,950,1,28
9508,SANDWICH BATH SPONGE,9,274,25,2600,2326,1,50
9509,OWL DOORSTOP,9,1260,16,1700,440,1,32
9510,13 STRAND GLASS NECKLACE CRYSTAL,2,1262,14,1500,238,1,28
9511,HAND WARMER UNION JACK,10,166,11,1200,1034,1,22
9512,HAND WARMER SCOTTY DOG DESIGN,1,1944,19,2000,56,1,38
9513,LARGE POPCORN HOLDER ,4,605,20,2100,1495,1,40
9514,PAINTED METAL STAR WITH HOLLY BELLS,7,428,11,1200,772,1,22
9515,PAINTED METAL HEART WITH HOLLY BELL,7,1536,21,2200,664,1,42
9516,ANGEL DECORATION STARS ON DRESS,8,506,18,1900,1394,1,36
9517,SMALL POPCORN HOLDER,1,267,6,700,433,1,12
9518,JUMBO BAG RED RETROSPOT,2,100,0,100,0,1,0
9519,JUMBO BAG STRAWBERRY,9,454,6,700,246,1,12
9520,STRAWBERRY SHOPPER BAG,3,328,7,800,472,1,14
9521,STRAWBERRY CHARLOTTE BAG,7,152,1,200,48,1,2
9522, SET 2 TEA TOWELS I LOVE LONDON ,7,298,16,1700,1402,1,32
9523,PACK OF 12 RED RETROSPOT TISSUES ,1,534,5,600,66,1,10
9524,SCOTTIE DOG HOT WATER BOTTLE,7,451,21,2200,1749,1,42
9525,CHOCOLATE HOT WATER BOTTLE,6,1062,22,2300,1238,1,44
9526,LUNCH BAG CARS BLUE,7,263,8,900,637,1,16
9527,LUNCH BAG SPACEBOY DESIGN ,9,296,3,400,104,1,6
9528,ROUND SNACK BOXES SET OF4 WOODLAND ,6,649,13,1400,751,1,26
9529,LUNCH BAG DOLLY GIRL DESIGN,1,1410,24,2500,1090,1,48
9530,LUNCH BAG SUKI  DESIGN ,3,146,10,1100,954,1,20
9531,LUNCH BAG  BLACK SKULL.,6,510,15,1600,1090,1,30
9532,ROUND SNACK BOXES SET OF 4 FRUITS ,9,1993,22,2300,307,1,44
9533,ROUND SNACK BOXES SET OF 4 SKULLS,3,159,1,200,41,1,2
9534,DOLLY GIRL LUNCH BOX,9,223,9,1000,777,1,18
9535,SPACEBOY LUNCH BOX ,3,1509,22,2300,791,1,44
9536,GREEN POLKADOT PLATE ,5,841,8,900,59,1,16
9537,BLUE POLKADOT PLATE ,3,396,6,700,304,1,12
9538,RED RETROSPOT PLATE ,8,729,18,1900,1171,1,36
9539,PINK  POLKADOT PLATE ,9,1656,20,2100,444,1,40
9540,ROUND SNACK BOXES SET OF 4 SKULLS,2,1065,17,1800,735,1,34
9541,FELTCRAFT DOLL MOLLY,8,1482,18,1900,418,1,36
9542,FELTCRAFT CHRISTMAS FAIRY,4,1110,24,2500,1390,1,48
9543,TRAVEL SEWING KIT,2,680,6,700,20,1,12
9544,SET OF 3 NOTEBOOKS IN PARCEL,8,2050,21,2200,150,1,42
9545,RED RETROSPOT TAPE,3,455,9,1000,545,1,18
9546,COSY SLIPPER SHOES SMALL  RED ,3,1692,17,1800,108,1,34
9547,14 RIBBONS RUSTIC CHARM,4,192,5,600,408,1,10
9548,SCANDINAVIAN REDS RIBBONS,6,155,11,1200,1045,1,22
9549,JAM MAKING SET PRINTED,1,864,12,1300,436,1,24
9550,20 DAISY PEGS IN WOOD BOX,1,1092,22,2300,1208,1,44
9551,HOT WATER BOTTLE BABUSHKA ,10,334,11,1200,866,1,22
9552,FELTCRAFT PRINCESS CHARLOTTE DOLL,1,1394,14,1500,106,1,28
9553,FELTCRAFT CHRISTMAS FAIRY,1,131,8,900,769,1,16
9554,FELTCRAFT PRINCESS CHARLOTTE DOLL,3,612,15,1600,988,1,30
9555,14 RIBBONS RUSTIC CHARM,6,270,6,700,430,1,12
9556,COSY SLIPPER SHOES SMALL  RED ,3,2010,22,2300,290,1,44
9557,SCANDINAVIAN REDS RIBBONS,4,888,10,1100,212,1,20
9558,13 HOOK HANGER RED MAGIC TOADSTOOL,1,789,8,900,111,1,16
9559,CHRISTMAS CRAFT TREE TOP ANGEL,7,720,20,2100,1380,1,40
9560,CHRISTMAS CRAFT LITTLE FRIENDS,8,501,6,700,199,1,12
9561,13 HOOK HANGER RED MAGIC TOADSTOOL,8,950,10,1100,150,1,20
9562,14 RIBBONS RUSTIC CHARM,2,201,8,900,699,1,16
9563,20 DAISY PEGS IN WOOD BOX,6,190,3,400,210,1,6
9564,SET OF 3 NOTEBOOKS IN PARCEL,1,155,4,500,345,1,8
9565,13 HOOK HANGER MAGIC TOADSTOOL,5,187,9,1000,813,1,18
9566,SCANDINAVIAN REDS RIBBONS,9,184,1,200,16,1,2
9567,RED TOADSTOOL LED NIGHT LIGHT,10,2030,21,2200,170,1,42
9568,13 HOOK HANGER RED MAGIC TOADSTOOL,3,1940,19,2000,60,1,38
9569,COSY SLIPPER SHOES SMALL GREEN,7,216,13,1400,1184,1,26
9570,COSY SLIPPER SHOES SMALL  RED ,6,833,14,1500,667,1,28
9571,FELTCRAFT DOLL ROSIE,8,110,9,1000,890,1,18
9572,FELTCRAFT DOLL MOLLY,5,564,6,700,136,1,12
9573,FELTCRAFT DOLL EMILY,10,1594,24,2500,906,1,48
9574,FELTCRAFT PRINCESS CHARLOTTE DOLL,6,763,20,2100,1337,1,40
9575,FELTCRAFT PRINCESS OLIVIA DOLL,8,299,9,1000,701,1,18
9576,REX CASH+CARRY JUMBO SHOPPER,8,107,14,1500,1393,1,28
9577,FELTCRAFT DOLL MOLLY,10,100,0,100,0,1,0
9578,FELTCRAFT CUSHION OWL,4,1438,22,2300,862,1,44
9579,CHRISTMAS CRAFT TREE TOP ANGEL,4,1394,16,1700,306,1,32
9580,CHRISTMAS CRAFT LITTLE FRIENDS,3,1938,25,2600,662,1,50
9581,FELTCRAFT CUSHION RABBIT,5,813,13,1400,587,1,26
9582,FELTCRAFT CUSHION BUTTERFLY,8,2009,25,2600,591,1,50
9583,20 DAISY PEGS IN WOOD BOX,2,672,12,1300,628,1,24
9584,PAPER CHAIN KIT 50'S CHRISTMAS ,7,1125,21,2200,1075,1,42
9585,FELTCRAFT CUSHION BUTTERFLY,7,445,14,1500,1055,1,28
9586,20 DAISY PEGS IN WOOD BOX,4,1382,22,2300,918,1,44
9587,ROSE COTTAGE KEEPSAKE BOX ,3,1756,24,2500,744,1,48
9588,TOTE BAG I LOVE LONDON,6,2261,23,2400,139,1,46
9589,20 DAISY PEGS IN WOOD BOX,3,483,4,500,17,1,8
9590,TOTE BAG I LOVE LONDON,2,1889,18,1900,11,1,36
9591,FOLDING UMBRELLA PINKWHITE POLKADOT,6,577,16,1700,1123,1,32
9592,FOLDING UMBRELLA CREAM POLKADOT,6,1164,11,1200,36,1,22
9593,FOLDING UMBRELLA WHITE/RED POLKADOT,8,1257,16,1700,443,1,32
9594,SET 10 LIGHTS NIGHT OWL,4,182,9,1000,818,1,18
9595,SMALL POPCORN HOLDER,10,1308,13,1400,92,1,26
9596, SET 2 TEA TOWELS I LOVE LONDON ,5,688,13,1400,712,1,26
9597,FOLDING UMBRELLA RED/WHITE POLKADOT,10,211,16,1700,1489,1,32
9598,BABUSHKA LIGHTS STRING OF 18,4,1572,25,2600,1028,1,50
9599,LUNCH BAG RED RETROSPOT,9,245,2,300,55,1,4
9600,S/4 VALENTINE DECOUPAGE HEART BOX,4,1315,13,1400,85,1,26
9601,FOLDING UMBRELLA CREAM POLKADOT,4,1730,18,1900,170,1,36
9602, SET 2 TEA TOWELS I LOVE LONDON ,3,192,1,200,8,1,2
9603,FOLDING UMBRELLA RED/WHITE POLKADOT,5,1979,21,2200,221,1,42
9604,SOLDIERS EGG CUP ,7,554,24,2500,1946,1,48
9605,S/4 VALENTINE DECOUPAGE HEART BOX,8,712,21,2200,1488,1,42
9606,RED RETROSPOT MINI CASES,10,536,11,1200,664,1,22
9607,,7,214,10,1100,886,1,20
9608,68 CAKE CASES VINTAGE CHRISTMAS,5,180,10,1100,920,1,20
9609,PAPER CHAIN KIT VINTAGE CHRISTMAS,4,2038,23,2400,362,1,46
9610,RIBBON REEL CHRISTMAS SOCK BAUBLE,4,183,6,700,517,1,12
9611,RIBBON REEL SNOWY VILLAGE,1,1947,20,2100,153,1,40
9612,RIBBON REEL MAKING SNOWMEN ,8,714,13,1400,686,1,26
9613,SET OF 20 VINTAGE CHRISTMAS NAPKINS,5,1926,25,2600,674,1,50
9614,TURQUOISE CHRISTMAS TREE ,3,541,23,2400,1859,1,46
9615,RED STAR CARD HOLDER,10,1688,18,1900,212,1,36
9616,WICKER WREATH SMALL,8,107,1,200,93,1,2
9617,HEART OF WICKER LARGE,3,174,1,200,26,1,2
9618,ADVENT CALENDAR GINGHAM SACK,9,2005,24,2500,495,1,48
9619,HEART OF WICKER SMALL,9,1436,23,2400,964,1,46
9620,FELTCRAFT BUTTERFLY HEARTS,3,1869,25,2600,731,1,50
9621,PARTY CONE CHRISTMAS DECORATION ,6,127,1,200,73,1,2
9622,VINTAGE HEADS AND TAILS CARD GAME ,2,512,16,1700,1188,1,32
9623,WICKER STAR ,3,1509,16,1700,191,1,32
9624,VINTAGE SNAP CARDS,4,100,0,100,0,1,0
9625,FELTCRAFT 6 FLOWER FRIENDS,2,100,0,100,0,1,0
9626, SET 2 TEA TOWELS I LOVE LONDON ,9,1134,15,1600,466,1,30
9627,JAM MAKING SET PRINTED,2,682,8,900,218,1,16
9628,BIRD DECORATION RED RETROSPOT,6,266,22,2300,2034,1,44
9629,CHRISTMAS GINGHAM TREE,3,362,13,1400,1038,1,26
9630,CHRISTMAS GINGHAM STAR,8,2490,25,2600,110,1,50
9631,CHRISTMAS GINGHAM HEART,6,647,13,1400,753,1,26
9632,PACK OF 12 PINK POLKADOT TISSUES,5,1127,16,1700,573,1,32
9633,FELTCRAFT PRINCESS LOLA DOLL,3,183,2,300,117,1,4
9634,PACK OF 12 LONDON TISSUES ,4,520,25,2600,2080,1,50
9635,PURPLE DRAWERKNOB ACRYLIC EDWARDIAN,3,1573,22,2300,727,1,44
9636,CHILDREN'S APRON DOLLY GIRL ,2,152,1,200,48,1,2
9637,CHILDRENS APRON SPACEBOY DESIGN,10,2053,24,2500,447,1,48
9638,CHRISTMAS LIGHTS 10 SANTAS ,5,1209,16,1700,491,1,32
9639,CHRISTMAS LIGHTS 10 REINDEER,6,543,6,700,157,1,12
9640,PAPER CHAIN KIT 50'S CHRISTMAS ,3,1866,22,2300,434,1,44
9641,FELTCRAFT CHRISTMAS FAIRY,7,371,7,800,429,1,14
9642,PACK OF 72 RETROSPOT CAKE CASES,2,120,1,200,80,1,2
9643,PACK OF 60 MUSHROOM CAKE CASES,2,360,11,1200,840,1,22
9644,68 CAKE CASES DOLLY GIRL DESIGN,5,359,6,700,341,1,12
9645,PACK OF 60 PINK PAISLEY CAKE CASES,10,1235,13,1400,165,1,26
9646,HAND WARMER BABUSHKA DESIGN,4,629,6,700,71,1,12
9647,HAND WARMER BIRD DESIGN,5,378,4,500,122,1,8
9648,HAND WARMER OWL DESIGN,4,661,23,2400,1739,1,46
9649,HAND WARMER RED RETROSPOT,10,1428,15,1600,172,1,30
9650,SET 12 RETRO WHITE CHALK STICKS,7,1098,16,1700,602,1,32
9651,FELTCRAFT HAIRBAND RED AND BLUE,4,254,15,1600,1346,1,30
9652,FELTCRAFT HAIRBAND PINK AND PURPLE,2,681,8,900,219,1,16
9653,FELTCRAFT HAIRBANDS PINK AND WHITE ,8,1783,17,1800,17,1,34
9654,TV DINNER TRAY DOLLY GIRL,8,2230,23,2400,170,1,46
9655,PLASTERS IN TIN VINTAGE PAISLEY ,7,1398,20,2100,702,1,40
9656,PLASTERS IN TIN SPACEBOY,4,884,18,1900,1016,1,36
9657,PLASTERS IN TIN WOODLAND ANIMALS,4,635,25,2600,1965,1,50
9658,MAGIC DRAWING SLATE SPACEBOY ,1,245,25,2600,2355,1,50
9659,MAGIC DRAWING SLATE CIRCUS PARADE  ,6,293,6,700,407,1,12
9660,MAGIC DRAWING SLATE GO TO THE FAIR ,7,1785,23,2400,615,1,46
9661,MAGIC DRAWING SLATE DOLLY GIRL ,5,589,18,1900,1311,1,36
9662,CHARLIE + LOLA RED HOT WATER BOTTLE,1,268,9,1000,732,1,18
9663,HOT WATER BOTTLE BABUSHKA ,5,1519,15,1600,81,1,30
9664,URBAN BLACK RIBBONS ,6,704,20,2100,1396,1,40
9665,FELTCRAFT PRINCESS CHARLOTTE DOLL,2,682,6,700,18,1,12
9666,SET OF 6 T-LIGHTS TOADSTOOLS,3,942,13,1400,458,1,26
9667,ROTATING LEAVES T-LIGHT HOLDER,9,1244,21,2200,956,1,42
9668,RED  HARMONICA IN BOX ,2,1138,13,1400,262,1,26
9669,CUPCAKE LACE PAPER SET 14,4,2289,22,2300,11,1,44
9670,FAMILY PHOTO FRAME CORNICE,10,544,22,2300,1756,1,44
9671,TRIPLE PHOTO FRAME CORNICE ,2,560,13,1400,840,1,26
9672,WOODEN FRAME ANTIQUE WHITE ,4,1403,23,2400,997,1,46
9673,WOODEN BOX OF DOMINOES,6,213,3,400,187,1,6
9674,TRADITIONAL WOODEN CATCH CUP GAME ,4,2030,20,2100,70,1,40
9675,TRADITIONAL WOODEN SKIPPING ROPE,5,160,4,500,340,1,8
9676,S/6 WOODEN SKITTLES IN COTTON BAG,5,381,5,600,219,1,10
9677,RED METAL BEACH SPADE ,8,350,10,1100,750,1,20
9678,BOYS VINTAGE TIN SEASIDE BUCKET,4,204,2,300,96,1,4
9679,GIRLS VINTAGE TIN SEASIDE BUCKET,3,959,9,1000,41,1,18
9680,GREY HEART HOT WATER BOTTLE,2,1021,11,1200,179,1,22
9681,SCOTTIE DOG HOT WATER BOTTLE,6,211,19,2000,1789,1,38
9682,BIRD HOUSE HOT WATER BOTTLE,5,126,1,200,74,1,2
9683,KINGS CHOICE TEA CADDY ,5,139,6,700,561,1,12
9684,KINGS CHOICE BISCUIT TIN,5,360,4,500,140,1,8
9685,METAL SIGN EMPIRE TEA,2,1830,19,2000,170,1,38
9686,HOMEMADE JAM SCENTED CANDLES,2,1033,25,2600,1567,1,50
9687,SET OF 6 SOLDIER SKITTLES,2,642,19,2000,1358,1,38
9688,FAWN BLUE HOT WATER BOTTLE,1,160,2,300,140,1,4
9689,HAND WARMER RED RETROSPOT,9,827,23,2400,1573,1,46
9690,HOT WATER BOTTLE BABUSHKA ,6,771,23,2400,1629,1,46
9691,WHITE SKULL HOT WATER BOTTLE ,10,162,1,200,38,1,2
9692,RETROSPOT HEART HOT WATER BOTTLE,5,701,7,800,99,1,14
9693,RED WOOLLY HOTTIE WHITE HEART.,2,218,4,500,282,1,8
9694,SCOTTIE DOG HOT WATER BOTTLE,8,591,8,900,309,1,16
9695,GREY HEART HOT WATER BOTTLE,1,828,11,1200,372,1,22
9696,HOT WATER BOTTLE BABUSHKA ,2,247,2,300,53,1,4
9697,PACK OF 6 BIRDY GIFT TAGS,3,1134,18,1900,766,1,36
9698,CHILLI LIGHTS,4,347,8,900,553,1,16
9699,PIGGY BANK RETROSPOT ,6,1511,15,1600,89,1,30
9700,CERAMIC STRAWBERRY MONEY BOX,1,100,0,100,0,1,0
9701,CERAMIC STRAWBERRY CAKE MONEY BANK,1,936,9,1000,64,1,18
9702,CERAMIC CHERRY CAKE MONEY BANK,5,597,21,2200,1603,1,42
9703,CERAMIC HEART FAIRY CAKE MONEY BANK,2,275,8,900,625,1,16
9704,CERAMIC PIRATE CHEST MONEY BANK,6,228,3,400,172,1,6
9705,DOORSTOP RETROSPOT HEART,6,430,7,800,370,1,14
9706,GINGHAM HEART  DOORSTOP RED,3,312,18,1900,1588,1,36
9707,RETROSPOT BABUSHKA DOORSTOP,5,188,1,200,12,1,2
9708,SILK PURSE BABUSHKA RED,1,100,1,200,100,1,2
9709,SILK PURSE BABUSHKA PINK,7,100,0,100,0,1,0
9710,FAMILY PHOTO FRAME CORNICE,9,541,13,1400,859,1,26
9711,SWEETHEART WIRE WALL TIDY,7,700,20,2100,1400,1,40
9712,JAM MAKING SET PRINTED,1,1526,21,2200,674,1,42
9713,RED RETROSPOT OVEN GLOVE ,10,354,15,1600,1246,1,30
9714,CREAM HEART CARD HOLDER,4,459,19,2000,1541,1,38
9715,NAMASTE SWAGAT INCENSE,6,1207,25,2600,1393,1,50
9716,CERAMIC STRAWBERRY DESIGN MUG,4,1553,19,2000,447,1,38
9717,BLACK HEART CARD HOLDER,3,100,0,100,0,1,0
9718,CLASSICAL ROSE SMALL VASE,5,1627,17,1800,173,1,34
9719,HYACINTH BULB T-LIGHT CANDLES,10,821,19,2000,1179,1,38
9720,CHRISTMAS CRAFT WHITE FAIRY ,2,730,9,1000,270,1,18
9721,CHRISTMAS CRAFT LITTLE FRIENDS,10,120,11,1200,1080,1,22
9722,COSY HOUR CIGAR BOX MATCHES ,2,617,7,800,183,1,14
9723,RED TEA TOWEL CLASSIC DESIGN,3,524,19,2000,1476,1,38
9724,HEART FILIGREE DOVE  SMALL,7,542,23,2400,1858,1,46
9725,RETROSPOT CHILDRENS APRON,6,100,0,100,0,1,0
9726,COLOURING PENCILS BROWN TUBE,5,331,5,600,269,1,10
9727,12 IVORY DINNER CANDLES SILVER FLOCK,4,100,0,100,0,1,0
9728,HEART FILIGREE DOVE  SMALL,2,250,20,2100,1850,1,40
9729,ZINC METAL HEART DECORATION,8,982,10,1100,118,1,20
9730,GREEN FERN NOTEBOOK,4,1249,24,2500,1251,1,48
9731,BLUE PAISLEY NOTEBOOK,7,533,19,2000,1467,1,38
9732,CHRYSANTHEMUM NOTEBOOK,6,167,12,1300,1133,1,24
9733,LARGE CHINESE STYLE SCISSOR,7,177,1,200,23,1,2
9734,SMALL CHINESE STYLE SCISSOR,6,135,6,700,565,1,12
9735,S/6 WOODEN SKITTLES IN COTTON BAG,4,628,7,800,172,1,14
9736,TRADITIONAL WOODEN SKIPPING ROPE,1,1211,15,1600,389,1,30
9737,SET OF 6 SOLDIER SKITTLES,4,235,3,400,165,1,6
9738,12 TRADITIONAL SPINNING TOPS,8,1403,16,1700,297,1,32
9739,ROTATING SILVER ANGELS T-LIGHT HLDR,8,2201,25,2600,399,1,50
9740,BLACK LOVE BIRD CANDLE,6,1434,18,1900,466,1,36
9741,RETROSPOT CHILDRENS APRON,7,106,1,200,94,1,2
9742,HANGING GLASS ETCHED TEALIGHT,6,279,6,700,421,1,12
9743,HANGING GLASS ETCHED TEALIGHT,10,456,8,900,444,1,16
9744,BLUE NEW BAROQUE CANDLESTICK CANDLE,10,575,6,700,125,1,12
9745,COOKING SET RETROSPOT,3,813,19,2000,1187,1,38
9746,KINGS CHOICE GIANT TUBE MATCHES,9,100,0,100,0,1,0
9747,COSY HOUR GIANT TUBE MATCHES,2,231,22,2300,2069,1,44
9748,PLACE SETTING WHITE STAR,4,156,13,1400,1244,1,26
9749,HYACINTH BULB T-LIGHT CANDLES,3,948,12,1300,352,1,24
9750,S/15 SILVER GLASS BAUBLES IN BAG,10,107,2,300,193,1,4
9751,FRENCH WC SIGN BLUE METAL,4,181,6,700,519,1,12
9752,KINGS CHOICE GIANT TUBE MATCHES,8,640,25,2600,1960,1,50
9753,80 SWEETHEART FAIRY CAKE CASES,8,310,6,700,390,1,12
9754,ASSORTED COLOUR BIRD ORNAMENT,4,759,22,2300,1541,1,44
9755,FAIRY SOAP SOAP HOLDER,4,1264,18,1900,636,1,36
9756,GREEN GIANT GARDEN THERMOMETER,1,246,15,1600,1354,1,30
9757,IVORY GIANT GARDEN THERMOMETER,4,100,0,100,0,1,0
9758,BLUE GIANT GARDEN THERMOMETER,1,1293,14,1500,207,1,28
9759,PACK OF 60 PINK PAISLEY CAKE CASES,4,569,5,600,31,1,10
9760,RETROSPOT HEART HOT WATER BOTTLE,4,1859,22,2300,441,1,44
9761,CHICK GREY HOT WATER BOTTLE,7,1773,24,2500,727,1,48
9762,VICTORIAN SEWING BOX SMALL ,7,100,0,100,0,1,0
9763,VICTORIAN SEWING BOX MEDIUM,10,142,2,300,158,1,4
9764,SET/10 RED POLKADOT PARTY CANDLES,6,404,21,2200,1796,1,42
9765,WASHROOM METAL SIGN,2,2098,24,2500,402,1,48
9766,BLACK SWEETHEART BRACELET,2,444,8,900,456,1,16
9767,DIAMANTE HAIR GRIP PACK/2 BLACK DIA,5,843,25,2600,1757,1,50
9768,BLACK DIAMANTE EXPANDABLE RING,6,2063,23,2400,337,1,46
9769,DIAMANTE HAIR GRIP PACK/2 RUBY,9,822,19,2000,1178,1,38
9770,DIAMANTE HAIR GRIP PACK/2 MONTANA,10,611,14,1500,889,1,28
9771,BLUE SWEETHEART BRACELET,10,1518,18,1900,382,1,36
9772,PINK SWEETHEART BRACELET,8,384,5,600,216,1,10
9773,PURPLE SWEETHEART BRACELET,6,1078,18,1900,822,1,36
9774,JUMBO BAG PINK POLKADOT,1,614,25,2600,1986,1,50
9775,JUMBO BAG RED RETROSPOT,10,321,5,600,279,1,10
9776,ASSORTED COLOUR BIRD ORNAMENT,10,729,10,1100,371,1,20
9777,PAPER CHAIN KIT 50'S CHRISTMAS ,2,784,20,2100,1316,1,40
9778,RIBBON REEL CHRISTMAS PRESENT ,6,621,7,800,179,1,14
9779,FIRST AID TIN,2,302,22,2300,1998,1,44
9780,MAKE YOUR OWN MONSOON CARD KIT,9,783,20,2100,1317,1,40
9781,PACK OF 12 HEARTS DESIGN TISSUES ,5,702,18,1900,1198,1,36
9782,PACK OF 12 RED RETROSPOT TISSUES ,1,196,3,400,204,1,6
9783,SOLDIERS EGG CUP ,1,234,8,900,666,1,16
9784,HEART IVORY TRELLIS SMALL,1,2182,23,2400,218,1,46
9785,HEART FILIGREE DOVE  SMALL,8,1270,15,1600,330,1,30
9786,HEART FILIGREE DOVE LARGE,3,1136,17,1800,664,1,34
9787,PACK 3 BOXES BIRD PANNETONE ,7,927,25,2600,1673,1,50
9788,PACK 3 BOXES CHRISTMAS PANNETONE,9,1462,17,1800,338,1,34
9789,SMALL POPCORN HOLDER,7,143,10,1100,957,1,20
9790,PACK OF 60 PINK PAISLEY CAKE CASES,5,1280,23,2400,1120,1,46
9791,SET OF 6 SOLDIER SKITTLES,8,768,17,1800,1032,1,34
9792,SWIRLY CIRCULAR RUBBERS IN BAG,10,472,15,1600,1128,1,30
9793,VINTAGE PAISLEY STATIONERY SET,1,155,8,900,745,1,16
9794,PAPER CHAIN KIT VINTAGE CHRISTMAS,7,164,6,700,536,1,12
9795,SET/10 BLUE POLKADOT PARTY CANDLES,10,281,24,2500,2219,1,48
9796,RIBBON REEL SOCKS AND MITTENS,8,2025,25,2600,575,1,50
9797,68 CAKE CASES VINTAGE CHRISTMAS,9,437,6,700,263,1,12
9798,CHRISTMAS METAL TAGS ASSORTED ,3,590,14,1500,910,1,28
9799,CHRISTMAS TREE T-LIGHT HOLDER,3,100,0,100,0,1,0
9800,STAR  T-LIGHT HOLDER ,9,1555,20,2100,545,1,40
9801,HEART T-LIGHT HOLDER ,3,107,7,800,693,1,14
9802,MINI FUNKY DESIGN TAPES,10,691,10,1100,409,1,20
9803,SET OF 6 T-LIGHTS SNOWMEN,7,596,9,1000,404,1,18
9804,STAR WOODEN CHRISTMAS DECORATION,5,1571,19,2000,429,1,38
9805,WOODEN HEART CHRISTMAS SCANDINAVIAN,4,834,9,1000,166,1,18
9806,CHRISTMAS RETROSPOT TREE WOOD,5,100,0,100,0,1,0
9807,SET OF 6 T-LIGHTS SANTA,7,1155,23,2400,1245,1,46
9808,SET/9 CHRISTMAS T-LIGHTS SCENTED ,8,218,18,1900,1682,1,36
9809,BLUE ROSE FABRIC MIRROR,6,905,25,2600,1695,1,50
9810,THREE CANVAS LUGGAGE TAGS,9,2294,22,2300,6,1,44
9811,RETROSPOT PARTY BAG + STICKER SET,5,100,0,100,0,1,0
9812,PLASTERS IN TIN VINTAGE PAISLEY ,1,135,20,2100,1965,1,40
9813,RETROSPOT SMALL TUBE MATCHES,4,922,9,1000,78,1,18
9814,HAND WARMER SCOTTY DOG DESIGN,2,704,11,1200,496,1,22
9815,3D CHRISTMAS STAMPS STICKERS ,7,146,7,800,654,1,14
9816,HAND WARMER SCOTTY DOG DESIGN,7,345,7,800,455,1,14
9817,HAND WARMER SCOTTY DOG DESIGN,5,380,12,1300,920,1,24
9818,CLOTHES PEGS RETROSPOT PACK 32,6,815,12,1300,485,1,24
9819,44 FOIL HEART CAKE CASES,9,985,23,2400,1415,1,46
9820,CHRISTMAS METAL TAGS ASSORTED ,2,1127,21,2200,1073,1,42
9821,PACK OF 6 SWEETIE GIFT BOXES,8,977,20,2100,1123,1,40
9822,PACK OF 72 RETROSPOT CAKE CASES,4,622,8,900,278,1,16
9823,PACK OF 72 RETROSPOT CAKE CASES,2,1749,22,2300,551,1,44
9824,PACK OF 6 BIRDY GIFT TAGS,2,559,11,1200,641,1,22
9825,SET/10 RED POLKADOT PARTY CANDLES,10,226,3,400,174,1,6
9826,SET/10 PINK POLKADOT PARTY CANDLES,10,729,7,800,71,1,14
9827,SET OF 3 NOTEBOOKS IN PARCEL,9,376,12,1300,924,1,24
9828,STAR  T-LIGHT HOLDER ,3,955,14,1500,545,1,28
9829,CINAMMON SET OF 9 T-LIGHTS,7,908,15,1600,692,1,30
9830,ORANGE SCENTED SET/9 T-LIGHTS,1,100,0,100,0,1,0
9831,RIBBON REEL STRIPES DESIGN ,4,1266,21,2200,934,1,42
9832,SET OF 2 TINS JARDIN DE PROVENCE,2,383,13,1400,1017,1,26
9833,MAKE YOUR OWN PLAYTIME CARD KIT,7,176,5,600,424,1,10
9834,DINOSAURS  WRITING SET ,10,1361,13,1400,39,1,26
9835,BALLOONS  WRITING SET ,8,177,7,800,623,1,14
9836,SKULLS WRITING SET ,1,114,1,200,86,1,2
9837,VINTAGE PAISLEY STATIONERY SET,2,100,0,100,0,1,0
9838,COSY SLIPPER SHOES SMALL  RED ,4,376,10,1100,724,1,20
9839,DOORMAT BLACK FLOCK ,9,1205,15,1600,395,1,30
9840,JUMBO  BAG BAROQUE BLACK WHITE,1,1501,16,1700,199,1,32
9841,JAM MAKING SET WITH JARS,2,141,15,1600,1459,1,30
9842,ORANGE SCENTED SET/9 T-LIGHTS,5,586,6,700,114,1,12
9843,CINAMMON SET OF 9 T-LIGHTS,3,177,22,2300,2123,1,44
9844,HAND WARMER SCOTTY DOG DESIGN,10,1079,12,1300,221,1,24
9845,CHRISTMAS DECOUPAGE CANDLE,1,312,4,500,188,1,8
9846,HEART T-LIGHT HOLDER ,1,501,12,1300,799,1,24
9847,GROW YOUR OWN BASIL IN ENAMEL MUG,7,491,5,600,109,1,10
9848,OFFICE MUG WARMER POLKADOT,4,2103,25,2600,497,1,50
9849,SMALL POPCORN HOLDER,4,529,8,900,371,1,16
9850,JUMBO BAG DOLLY GIRL DESIGN,9,624,10,1100,476,1,20
9851,JAM MAKING SET WITH JARS,7,1768,23,2400,632,1,46
9852,JAM MAKING SET PRINTED,10,262,20,2100,1838,1,40
9853,SMALL GLASS HEART TRINKET POT,3,954,11,1200,246,1,22
9854,RED WOOLLY HOTTIE WHITE HEART.,2,100,0,100,0,1,0
9855,BLACK RECORD COVER FRAME,8,1446,22,2300,854,1,44
9856,"RECORD FRAME 7"" SINGLE SIZE ",5,1303,14,1500,197,1,28
9857,44 PENCILS TUBE RED RETROSPOT,4,1832,19,2000,168,1,38
9858,44 PENCILS TUBE WOODLAND,9,139,1,200,61,1,2
9859,SET OF 6 SOLDIER SKITTLES,9,720,19,2000,1280,1,38
9860,ROCKING HORSE RED CHRISTMAS ,4,456,17,1800,1344,1,34
9861,CHRISTMAS GINGHAM HEART,5,808,12,1300,492,1,24
9862,CHRISTMAS GINGHAM STAR,7,2544,25,2600,56,1,50
9863,HAND WARMER UNION JACK,4,890,12,1300,410,1,24
9864,HAND WARMER RED RETROSPOT,2,319,5,600,281,1,10
9865,REGENCY CAKESTAND 3 TIER,8,1431,17,1800,369,1,34
9866,JUMBO SHOPPER VINTAGE RED PAISLEY,1,997,11,1200,203,1,22
9867,RIBBON REEL SNOWY VILLAGE,3,982,10,1100,118,1,20
9868,VINTAGE UNION JACK BUNTING,9,185,1,200,15,1,2
9869,JAM MAKING SET WITH JARS,9,286,2,300,14,1,4
9870,RIBBON REEL STRIPES DESIGN ,7,941,20,2100,1159,1,40
9871,RETRO LONGBOARD IRONING BOARD COVER,4,676,12,1300,624,1,24
9872,3D DOG PICTURE PLAYING CARDS,1,435,9,1000,565,1,18
9873,RETROSPOT CIGAR BOX MATCHES ,2,194,1,200,6,1,2
9874,SET/9 CHRISTMAS T-LIGHTS SCENTED ,2,164,2,300,136,1,4
9875,ROTATING SILVER ANGELS T-LIGHT HLDR,2,521,7,800,279,1,14
9876,ROTATING SILVER ANGELS T-LIGHT HLDR,9,616,9,1000,384,1,18
9877,SAVE THE PLANET COTTON TOTE BAG,3,1218,24,2500,1282,1,48
9878,SET OF 20 VINTAGE CHRISTMAS NAPKINS,7,191,1,200,9,1,2
9879,PAPER BUNTING WHITE LACE,2,2114,22,2300,186,1,44
9880,GENTLEMAN SHIRT REPAIR KIT ,8,1578,15,1600,22,1,30
9881,CARD I LOVE LONDON ,2,485,7,800,315,1,14
9882,PAPER CHAIN KIT VINTAGE CHRISTMAS,8,1147,17,1800,653,1,34
9883,MIRRORED WALL ART FOXY,3,796,11,1200,404,1,22
9884,MIRRORED WALL ART GENTS,2,230,6,700,470,1,12
9885,AIRLINE BAG VINTAGE JET SET WHITE,8,203,2,300,97,1,4
9886,JAM MAKING SET PRINTED,7,302,3,400,98,1,6
9887,POTTING SHED SOW 'N' GROW SET,1,157,19,2000,1843,1,38
9888,BABUSHKA LIGHTS STRING OF 18,5,299,4,500,201,1,8
9889,REX CASH+CARRY JUMBO SHOPPER,10,801,15,1600,799,1,30
9890,AIRLINE BAG VINTAGE WORLD CHAMPION ,10,100,0,100,0,1,0
9891,HAND WARMER BIRD DESIGN,2,517,15,1600,1083,1,30
9892,CHRISTMAS CRAFT LITTLE FRIENDS,5,245,11,1200,955,1,22
9893,PINK HEARTS PAPER GARLAND,2,612,9,1000,388,1,18
9894,POTTING SHED SEED ENVELOPES,7,522,8,900,378,1,16
9895,HI TEC ALPINE HAND WARMER,4,568,5,600,32,1,10
9896,FELTCRAFT CHRISTMAS FAIRY,5,147,1,200,53,1,2
9897,HI TEC ALPINE HAND WARMER,4,325,9,1000,675,1,18
9898,ROTATING SILVER ANGELS T-LIGHT HLDR,2,1669,20,2100,431,1,40
9899,11 STRIPEY MICE FELTCRAFT,5,1031,21,2200,1169,1,42
9900,FELTCRAFT 6 FLOWER FRIENDS,7,2070,22,2300,230,1,44
9901,CHRISTMAS CRAFT LITTLE FRIENDS,6,569,19,2000,1431,1,38
9902,VINTAGE UNION JACK CUSHION COVER,3,264,3,400,136,1,6
9903,POLYESTER FILLER PAD 45x45cm,10,462,20,2100,1638,1,40
9904,DOLLY GIRL LUNCH BOX,1,405,9,1000,595,1,18
9905,PACK OF 12 LONDON TISSUES ,6,853,18,1900,1047,1,36
9906,CARD DOLLY GIRL ,3,1979,20,2100,121,1,40
9907,CARD BILLBOARD FONT,10,754,8,900,146,1,16
9908,RAINY LADIES BIRTHDAY CARD,10,1672,24,2500,828,1,48
9909,GREY HEART HOT WATER BOTTLE,9,126,18,1900,1774,1,36
9910,RED WOOLLY HOTTIE WHITE HEART.,5,530,22,2300,1770,1,44
9911,RED WHITE SCARF  HOT WATER BOTTLE,8,269,4,500,231,1,8
9912, SET 2 TEA TOWELS I LOVE LONDON ,8,1358,17,1800,442,1,34
9913,SET OF 2 TEA TOWELS APPLE AND PEARS,10,221,7,800,579,1,14
9914,SET/2 RED RETROSPOT TEA TOWELS ,1,1042,25,2600,1558,1,50
9915,LOVE BUILDING BLOCK WORD,4,288,8,900,612,1,16
9916,HOME BUILDING BLOCK WORD,9,144,1,200,56,1,2
9917,ASSORTED COLOUR BIRD ORNAMENT,4,1067,21,2200,1133,1,42
9918,LANTERN CREAM GAZEBO ,3,208,14,1500,1292,1,28
9919,BLUE BIRDHOUSE DECORATION,7,100,0,100,0,1,0
9920,WHITE HANGING HEART T-LIGHT HOLDER,6,939,10,1100,161,1,20
9921,REGENCY CAKESTAND 3 TIER,4,197,3,400,203,1,6
9922,ANTIQUE SILVER TEA GLASS ENGRAVED,10,486,7,800,314,1,14
9923,AGED GLASS SILVER T-LIGHT HOLDER,7,1042,15,1600,558,1,30
9924,JAM MAKING SET WITH JARS,4,179,1,200,21,1,2
9925,HAND WARMER OWL DESIGN,2,569,13,1400,831,1,26
9926,SET OF 2 WOODEN MARKET CRATES,2,2423,25,2600,177,1,50
9927,SET OF 6 T-LIGHTS TOADSTOOLS,3,196,17,1800,1604,1,34
9928,HAND WARMER UNION JACK,9,101,19,2000,1899,1,38
9929,HAND WARMER SCOTTY DOG DESIGN,5,786,8,900,114,1,16
9930,CLASSIC FRENCH STYLE BASKET NATURAL,6,359,16,1700,1341,1,32
9931,CRAZY DAISY HEART DECORATION,10,754,15,1600,846,1,30
9932,GIN + TONIC DIET METAL SIGN,6,320,12,1300,980,1,24
9933,IVORY GIANT GARDEN THERMOMETER,9,541,13,1400,859,1,26
9934,CARD HOLDER GINGHAM HEART,10,1869,21,2200,331,1,42
9935,SMALL STRIPES CHOCOLATE GIFT BAG ,10,1394,13,1400,6,1,26
9936,S/6 WOODEN SKITTLES IN COTTON BAG,10,749,14,1500,751,1,28
9937,HAND WARMER RED RETROSPOT,1,1657,18,1900,243,1,36
9938,HAND WARMER UNION JACK,1,527,16,1700,1173,1,32
9939,FRENCH WC SIGN BLUE METAL,9,418,4,500,82,1,8
9940,PINK UNION JACK  LUGGAGE TAG,4,1669,17,1800,131,1,34
9941,"TRAY, BREAKFAST IN BED",3,618,12,1300,682,1,24
9942,PIZZA PLATE IN BOX,8,1456,14,1500,44,1,28
9943,HEART OF WICKER LARGE,5,332,18,1900,1568,1,36
9944,PINK HEART DOTS HOT WATER BOTTLE,2,350,21,2200,1850,1,42
9945,PLACE SETTING WHITE HEART,7,765,16,1700,935,1,32
9946,SET OF 4 NAPKIN CHARMS LEAVES   ,2,132,24,2500,2368,1,48
9947,SET OF 4 NAPKIN CHARMS STARS   ,9,485,4,500,15,1,8
9948,SET OF 4 NAPKIN CHARMS CUTLERY,10,317,11,1200,883,1,22
9949,CARAVAN SQUARE TISSUE BOX,3,947,15,1600,653,1,30
9950,PLASTERS IN TIN SKULLS,8,1725,25,2600,875,1,50
9951,PLASTERS IN TIN SPACEBOY,4,325,9,1000,675,1,18
9952,BUTTON BOX ,10,2592,25,2600,8,1,50
9953,PLASTERS IN TIN VINTAGE PAISLEY ,10,619,6,700,81,1,12
9954,20 MESSAGE CARDS WITH ENVELOPES,8,761,24,2500,1739,1,48
9955,SMALL RED BABUSHKA NOTEBOOK ,1,100,0,100,0,1,0
9956,CUPCAKE LACE PAPER SET 14,9,178,1,200,22,1,2
9957,PACK 3 BOXES CHRISTMAS PANNETONE,2,957,21,2200,1243,1,42
9958,HERB MARKER MINT,10,861,22,2300,1439,1,44
9959,HERB MARKER ROSEMARY,9,1696,23,2400,704,1,46
9960,HERB MARKER BASIL,4,607,6,700,93,1,12
9961,HERB MARKER CHIVES ,4,1015,24,2500,1485,1,48
9962,HERB MARKER PARSLEY,8,104,1,200,96,1,2
9963,HERB MARKER THYME,2,629,15,1600,971,1,30
9964,WHITE HANGING HEART T-LIGHT HOLDER,8,266,6,700,434,1,12
9965,METAL MERRY CHRISTMAS WREATH,3,1358,13,1400,42,1,26
9966,WHITE CHRISTMAS GARLAND STARS TREES,10,951,13,1400,449,1,26
9967,RETROSPOT SMALL TUBE MATCHES,10,1341,14,1500,159,1,28
9968,RETROSPOT GIANT TUBE MATCHES,3,831,11,1200,369,1,22
9969,PLACE SETTING WHITE STAR,5,139,1,200,61,1,2
9970,GROW YOUR OWN BASIL IN ENAMEL MUG,2,1431,23,2400,969,1,46
9971,44 FOIL STAR CAKE CASES ,9,1209,24,2500,1291,1,48
9972,44 FOIL HEART CAKE CASES,4,305,21,2200,1895,1,42
9973,PACK OF 6 SWEETIE GIFT BOXES,5,952,16,1700,748,1,32
9974,PACK OF 6 HANDBAG GIFT BOXES,6,100,0,100,0,1,0
9975,GARLAND WOODEN HAPPY EASTER,4,339,8,900,561,1,16
9976,CALENDAR PAPER CUT DESIGN,1,2137,22,2300,163,1,44
9977,CALENDAR IN SEASON DESIGN,6,1034,18,1900,866,1,36
9978,SMALL POPCORN HOLDER,4,201,5,600,399,1,10
9979,BLUE PAISLEY TISSUE BOX,10,2234,24,2500,266,1,48
9980,HEART OF WICKER SMALL,10,1188,12,1300,112,1,24
9981,SKULLS SQUARE TISSUE BOX,6,706,7,800,94,1,14
9982,SKULLS SQUARE TISSUE BOX,4,188,2,300,112,1,4
9983,WHITE HANGING HEART T-LIGHT HOLDER,8,367,20,2100,1733,1,40
9984,WHITE METAL LANTERN,4,138,3,400,262,1,6
9985,CREAM CUPID HEARTS COAT HANGER,5,987,14,1500,513,1,28
9986,KNITTED UNION FLAG HOT WATER BOTTLE,1,107,20,2100,1993,1,40
9987,RED WOOLLY HOTTIE WHITE HEART.,4,1253,22,2300,1047,1,44
9988,SET 7 BABUSHKA NESTING BOXES,9,1165,14,1500,335,1,28
9989,GLASS STAR FROSTED T-LIGHT HOLDER,6,1516,20,2100,584,1,40
9990,HAND WARMER UNION JACK,9,218,14,1500,1282,1,28
9991,HAND WARMER RED POLKA DOT,8,1729,25,2600,871,1,50
9992,ASSORTED COLOUR BIRD ORNAMENT,1,134,2,300,166,1,4
9993,POPPY'S PLAYHOUSE BEDROOM ,1,100,0,100,0,1,0
9994,POPPY'S PLAYHOUSE KITCHEN,7,514,23,2400,1886,1,46
9995,FELTCRAFT PRINCESS CHARLOTTE DOLL,6,730,22,2300,1570,1,44
9996,IVORY KNITTED MUG COSY ,6,564,12,1300,736,1,24
9997,BOX OF 6 ASSORTED COLOUR TEASPOONS,5,306,7,800,494,1,14
9998,BOX OF VINTAGE JIGSAW BLOCKS ,3,177,2,300,123,1,4
9999,BOX OF VINTAGE ALPHABET BLOCKS,7,230,3,400,170,1,6
10000,HOME BUILDING BLOCK WORD,2,684,22,2300,1616,1,44
10001,LOVE BUILDING BLOCK WORD,10,1025,15,1600,575,1,30
10002,RECIPE BOX WITH METAL HEART,1,2010,25,2600,590,1,50
10003,DOORMAT NEW ENGLAND,7,229,14,1500,1271,1,28
10004,JAM MAKING SET WITH JARS,7,706,11,1200,494,1,22
10005,RED COAT RACK PARIS FASHION,2,197,2,300,103,1,4
10006,YELLOW COAT RACK PARIS FASHION,5,574,18,1900,1326,1,36
10007,BLUE COAT RACK PARIS FASHION,2,237,2,300,63,1,4
10008,BATH BUILDING BLOCK WORD,10,1556,15,1600,44,1,30
10009,ALARM CLOCK BAKELIKE PINK,5,1213,23,2400,1187,1,46
10010,ALARM CLOCK BAKELIKE RED ,8,296,4,500,204,1,8
10011,ALARM CLOCK BAKELIKE GREEN,7,1077,12,1300,223,1,24
10012,PANDA AND BUNNIES STICKER SHEET,5,757,17,1800,1043,1,34
10013,STARS GIFT TAPE ,9,409,9,1000,591,1,18
10014,INFLATABLE POLITICAL GLOBE ,5,318,3,400,82,1,6
10015,VINTAGE HEADS AND TAILS CARD GAME ,4,484,9,1000,516,1,18
10016,SET/2 RED RETROSPOT TEA TOWELS ,5,665,9,1000,335,1,18
10017,ROUND SNACK BOXES SET OF4 WOODLAND ,3,477,5,600,123,1,10
10018,SPACEBOY LUNCH BOX ,2,881,14,1500,619,1,28
10019,LUNCH BOX I LOVE LONDON,8,549,5,600,51,1,10
10020,CIRCUS PARADE LUNCH BOX ,9,658,17,1800,1142,1,34
10021,CHARLOTTE BAG DOLLY GIRL DESIGN,4,1422,24,2500,1078,1,48
10022,RED TOADSTOOL LED NIGHT LIGHT,6,1425,23,2400,975,1,46
10023, SET 2 TEA TOWELS I LOVE LONDON ,8,1592,22,2300,708,1,44
10024,VINTAGE SEASIDE JIGSAW PUZZLES,10,459,7,800,341,1,14
10025,MINI JIGSAW CIRCUS PARADE ,2,170,2,300,130,1,4
10026,MINI JIGSAW SPACEBOY,5,1433,22,2300,867,1,44
10027,MINI PAINT SET VINTAGE ,3,635,7,800,165,1,14
10028,POSTAGE,9,400,19,2000,1600,1,38
10029,PAPER CHAIN KIT 50'S CHRISTMAS ,9,146,1,200,54,1,2
10030,HAND WARMER RED POLKA DOT,9,1604,17,1800,196,1,34
10031,HAND WARMER UNION JACK,10,636,11,1200,564,1,22
10032,WHITE HANGING HEART T-LIGHT HOLDER,2,398,7,800,402,1,14
10033,WHITE METAL LANTERN,4,1420,19,2000,580,1,38
10034,CREAM CUPID HEARTS COAT HANGER,4,555,8,900,345,1,16
10035,EDWARDIAN PARASOL RED,1,757,8,900,143,1,16
10036,RETRO COFFEE MUGS ASSORTED,3,458,4,500,42,1,8
10037,SAVE THE PLANET MUG,5,728,22,2300,1572,1,44
10038,VINTAGE BILLBOARD DRINK ME MUG,1,640,12,1300,660,1,24
10039,VINTAGE BILLBOARD LOVE/HATE MUG,7,1282,19,2000,718,1,38
10040,WOOD 2 DRAWER CABINET WHITE FINISH,5,185,7,800,615,1,14
10041,WOOD S/3 CABINET ANT WHITE FINISH,2,314,12,1300,986,1,24
10042,WOODEN PICTURE FRAME WHITE FINISH,4,1124,25,2600,1476,1,50
10043,WOODEN FRAME ANTIQUE WHITE ,2,100,0,100,0,1,0
10044,KNITTED UNION FLAG HOT WATER BOTTLE,1,860,12,1300,440,1,24
10045,RED WOOLLY HOTTIE WHITE HEART.,8,295,2,300,5,1,4
10046,SET 7 BABUSHKA NESTING BOXES,7,448,4,500,52,1,8
10047,GLASS STAR FROSTED T-LIGHT HOLDER,4,868,16,1700,832,1,32
10048,VICTORIAN SEWING BOX LARGE,4,633,6,700,67,1,12
10049,WHITE HANGING HEART T-LIGHT HOLDER,1,165,1,200,35,1,2
10050,WHITE METAL LANTERN,5,198,2,300,102,1,4
10051,CREAM CUPID HEARTS COAT HANGER,10,902,12,1300,398,1,24
10052,EDWARDIAN PARASOL RED,7,260,2,300,40,1,4
10053,RETRO COFFEE MUGS ASSORTED,7,162,1,200,38,1,2
10054,SAVE THE PLANET MUG,6,1536,16,1700,164,1,32
10055,VINTAGE BILLBOARD DRINK ME MUG,8,109,2,300,191,1,4
10056,VINTAGE BILLBOARD LOVE/HATE MUG,1,1348,16,1700,352,1,32
10057,WOOD 2 DRAWER CABINET WHITE FINISH,4,427,6,700,273,1,12
10058,WOOD S/3 CABINET ANT WHITE FINISH,2,690,17,1800,1110,1,34
10059,WOODEN PICTURE FRAME WHITE FINISH,4,100,0,100,0,1,0
10060,WOODEN FRAME ANTIQUE WHITE ,5,280,2,300,20,1,4
10061,KNITTED UNION FLAG HOT WATER BOTTLE,1,795,19,2000,1205,1,38
10062,RED WOOLLY HOTTIE WHITE HEART.,6,1985,21,2200,215,1,42
10063,SET 7 BABUSHKA NESTING BOXES,1,287,3,400,113,1,6
10064,GLASS STAR FROSTED T-LIGHT HOLDER,6,183,4,500,317,1,8
10065,HOT WATER BOTTLE TEA AND SYMPATHY,4,739,21,2200,1461,1,42
10066,RED HANGING HEART T-LIGHT HOLDER,1,528,9,1000,472,1,18
10067,HAND WARMER RED POLKA DOT,6,188,7,800,612,1,14
10068,HAND WARMER UNION JACK,10,265,2,300,35,1,4
10069,JUMBO BAG PINK POLKADOT,3,657,11,1200,543,1,22
10070,JUMBO  BAG BAROQUE BLACK WHITE,7,244,3,400,156,1,6
10071,JUMBO BAG CHARLIE AND LOLA TOYS,2,287,7,800,513,1,14
10072,STRAWBERRY CHARLOTTE BAG,4,2348,25,2600,252,1,50
10073,RED 3 PIECE RETROSPOT CUTLERY SET,2,450,25,2600,2150,1,50
10074,BLUE 3 PIECE POLKADOT CUTLERY SET,4,1110,13,1400,290,1,26
10075,SET/6 RED SPOTTY PAPER PLATES,2,130,4,500,370,1,8
10076,LUNCH BAG RED RETROSPOT,6,209,4,500,291,1,8
10077,STRAWBERRY LUNCH BOX WITH CUTLERY,7,723,24,2500,1777,1,48
10078,LUNCH BOX WITH CUTLERY RETROSPOT ,7,142,6,700,558,1,12
10079,PACK OF 72 RETROSPOT CAKE CASES,1,547,5,600,53,1,10
10080,PACK OF 60 DINOSAUR CAKE CASES,3,447,4,500,53,1,8
10081,PACK OF 60 PINK PAISLEY CAKE CASES,5,568,21,2200,1632,1,42
10082,69 TEATIME FAIRY CAKE CASES,2,1169,19,2000,831,1,38
10083,TOMATO CHARLIE+LOLA COASTER SET,1,809,15,1600,791,1,30
10084,CHARLIE & LOLA WASTEPAPER BIN FLORA,7,121,1,200,79,1,2
10085,RED CHARLIE+LOLA PERSONAL DOORSIGN,6,195,1,200,5,1,2
10086,JUMBO STORAGE BAG SUKI,4,390,11,1200,810,1,22
10087,JUMBO BAG PINK VINTAGE PAISLEY,10,132,9,1000,868,1,18
10088,JAM MAKING SET PRINTED,2,214,2,300,86,1,4
10089,RETROSPOT TEA SET CERAMIC 11 PC ,4,2061,24,2500,439,1,48
10090,GIRLY PINK TOOL SET,6,340,3,400,60,1,6
10091,JUMBO SHOPPER VINTAGE RED PAISLEY,1,896,9,1000,104,1,18
10092,"AIRLINE LOUNGE,METAL SIGN",1,206,17,1800,1594,1,34
10093,WHITE SPOT RED CERAMIC DRAWER KNOB,10,273,2,300,27,1,4
10094,RED DRAWER KNOB ACRYLIC EDWARDIAN,9,638,23,2400,1762,1,46
10095,CLEAR DRAWER KNOB ACRYLIC EDWARDIAN,3,482,5,600,118,1,10
10096,PHOTO CLIP LINE,10,1445,15,1600,155,1,30
10097,FELT EGG COSY CHICKEN,4,618,11,1200,582,1,22
10098,PIGGY BANK RETROSPOT ,1,1409,25,2600,1191,1,50
10099,SKULL SHOULDER BAG,3,101,1,200,99,1,2
10100,YOU'RE CONFUSING ME METAL SIGN ,9,1967,25,2600,633,1,50
10101,COOK WITH WINE METAL SIGN ,6,722,16,1700,978,1,32
10102,GIN + TONIC DIET METAL SIGN,7,292,11,1200,908,1,22
10103,YELLOW BREAKFAST CUP AND SAUCER,6,630,15,1600,970,1,30
10104,PINK BREAKFAST CUP AND SAUCER ,10,1130,24,2500,1370,1,48
10105,PAPER CHAIN KIT 50'S CHRISTMAS ,5,1143,21,2200,1057,1,42
10106,PAPER CHAIN KIT RETROSPOT,7,570,5,600,30,1,10
10107,SMALL HEART FLOWERS HOOK ,5,1280,17,1800,520,1,34
10108,PHOTO CLIP LINE,7,260,12,1300,1040,1,24
10109,TEA TIME DES TEA COSY,1,472,21,2200,1728,1,42
10110,FELT EGG COSY WHITE RABBIT ,5,386,4,500,114,1,8
10111,ZINC WILLIE WINKIE  CANDLE STICK,5,1052,15,1600,548,1,30
10112,CERAMIC CHERRY CAKE MONEY BANK,8,229,24,2500,2271,1,48
10113,RETROSPOT LARGE MILK JUG,6,1280,14,1500,220,1,28
10114,SET OF 6 FUNKY BEAKERS,1,1690,24,2500,810,1,48
10115,EDWARDIAN PARASOL BLACK,1,129,4,500,371,1,8
10116,EDWARDIAN PARASOL NATURAL,6,569,5,600,31,1,10
10117,CERAMIC STRAWBERRY CAKE MONEY BANK,2,645,8,900,255,1,16
10118,BLUE OWL SOFT TOY,1,100,0,100,0,1,0
10119,BALLOON ART MAKE YOUR OWN FLOWERS,7,583,9,1000,417,1,18
10120,RED TOADSTOOL LED NIGHT LIGHT,9,236,10,1100,864,1,20
10121,GLASS CLOCHE SMALL,10,909,21,2200,1291,1,42
10122,GUMBALL MONOCHROME COAT RACK,3,932,19,2000,1068,1,38
10123,DOORMAT FANCY FONT HOME SWEET HOME,7,549,13,1400,851,1,26
10124,Discount,8,1303,22,2300,997,1,44
10125,INFLATABLE POLITICAL GLOBE ,2,519,12,1300,781,1,24
10126,VINTAGE SNAKES & LADDERS,7,861,15,1600,739,1,30
10127,CHOCOLATE CALCULATOR,6,440,17,1800,1360,1,34
10128,JUMBO SHOPPER VINTAGE RED PAISLEY,9,1436,19,2000,564,1,38
10129,RECYCLING BAG RETROSPOT ,6,218,2,300,82,1,4
10130,TOY TIDY PINK POLKADOT,1,197,6,700,503,1,12
10131,ANTIQUE GLASS DRESSING TABLE POT,10,1154,11,1200,46,1,22
10132,ALARM CLOCK BAKELIKE GREEN,3,442,4,500,58,1,8
10133,IVORY GIANT GARDEN THERMOMETER,6,1453,20,2100,647,1,40
10134,12 TIER CAKE TIN GREEN AND CREAM,7,399,7,800,401,1,14
10135,12 TIER CAKE TIN RED AND CREAM,9,598,6,700,102,1,12
10136,SET 3 WICKER OVAL BASKETS W LIDS,8,157,1,200,43,1,2
10137,SET OF 3 COLOURED  FLYING DUCKS,4,1348,17,1800,452,1,34
10138,WOOD BLACK BOARD ANT WHITE FINISH,10,784,7,800,16,1,14
10139,COLOUR GLASS T-LIGHT HOLDER HANGING,6,1486,25,2600,1114,1,50
10140,HANGING METAL HEART LANTERN,4,661,21,2200,1539,1,42
10141,HANGING MEDINA LANTERN SMALL,3,1582,23,2400,818,1,46
10142,NATURAL SLATE HEART CHALKBOARD ,10,947,20,2100,1153,1,40
10143,HEART OF WICKER SMALL,9,202,5,600,398,1,10
10144,HEART OF WICKER LARGE,5,683,10,1100,417,1,20
10145,WHITE LOVEBIRD LANTERN,2,195,8,900,705,1,16
10146,CLASSIC METAL BIRDCAGE PLANT HOLDER,3,1611,18,1900,289,1,36
10147,CREAM HEART CARD HOLDER,2,545,6,700,155,1,12
10148,ENAMEL FLOWER JUG CREAM,3,100,0,100,0,1,0
10149,ENAMEL FIRE BUCKET CREAM,4,1770,21,2200,430,1,42
10150,ENAMEL BREAD BIN CREAM,9,145,1,200,55,1,2
10151,SET 3 WICKER OVAL BASKETS W LIDS,10,137,2,300,163,1,4
10152,JAM MAKING SET PRINTED,10,173,16,1700,1527,1,32
10153,JAM MAKING SET WITH JARS,1,415,13,1400,985,1,26
10154,JUMBO BAG DOLLY GIRL DESIGN,9,221,10,1100,879,1,20
10155,TRADITIONAL CHRISTMAS RIBBONS,2,345,14,1500,1155,1,28
10156,ORGANISER WOOD ANTIQUE WHITE ,1,760,17,1800,1040,1,34
10157,LUNCH BAG DOLLY GIRL DESIGN,8,348,6,700,352,1,12
10158,WHITE WIRE EGG HOLDER,3,1095,10,1100,5,1,20
10159,JUMBO  BAG BAROQUE BLACK WHITE,2,1980,20,2100,120,1,40
10160,JUMBO BAG RED RETROSPOT,9,406,17,1800,1394,1,34
10161,CHILLI LIGHTS,1,591,7,800,209,1,14
10162,LIGHT GARLAND BUTTERFILES PINK,6,964,15,1600,636,1,30
10163,WOODEN OWLS LIGHT GARLAND ,8,708,10,1100,392,1,20
10164,FAIRY TALE COTTAGE NIGHTLIGHT,3,346,4,500,154,1,8
10165,RED TOADSTOOL LED NIGHT LIGHT,2,1014,23,2400,1386,1,46
10166,HOME BUILDING BLOCK WORD,3,178,11,1200,1022,1,22
10167,LOVE BUILDING BLOCK WORD,1,303,18,1900,1597,1,36
10168,DOORMAT FANCY FONT HOME SWEET HOME,5,932,10,1100,168,1,20
10169,HOME SMALL WOOD LETTERS,6,279,20,2100,1821,1,40
10170,GINGHAM HEART  DOORSTOP RED,9,100,0,100,0,1,0
10171,FIVE HEART HANGING DECORATION,8,670,24,2500,1830,1,48
10172,HANGING METAL HEART LANTERN,9,957,17,1800,843,1,34
10173,ASSORTED BOTTLE TOP  MAGNETS ,2,531,5,600,69,1,10
10174,FRIDGE MAGNETS US DINER ASSORTED,9,141,1,200,59,1,2
10175,HOMEMADE JAM SCENTED CANDLES,8,732,7,800,68,1,14
10176,FRIDGE MAGNETS LES ENFANTS ASSORTED,7,220,6,700,480,1,12
10177,ROSE CARAVAN DOORSTOP,8,193,6,700,507,1,12
10178,HEART OF WICKER SMALL,7,1918,20,2100,182,1,40
10179,14 HOOK HANGER MAGIC TOADSTOOL,9,1062,24,2500,1438,1,48
10180,CHRISTMAS LIGHTS 10 REINDEER,9,108,1,200,92,1,2
10181,VINTAGE UNION JACK CUSHION COVER,4,1205,15,1600,395,1,30
10182,VINTAGE HEADS AND TAILS CARD GAME ,3,316,16,1700,1384,1,32
10183,SET OF 3 COLOURED  FLYING DUCKS,3,382,11,1200,818,1,22
10184,SET OF 3 GOLD FLYING DUCKS,2,628,24,2500,1872,1,48
10185,RED RETROSPOT UMBRELLA,4,252,8,900,648,1,16
10186,BLACK/BLUE POLKADOT UMBRELLA,7,1487,15,1600,113,1,30
10187,RED DINER WALL CLOCK,7,273,5,600,327,1,10
10188,ALARM CLOCK BAKELIKE GREEN,4,181,15,1600,1419,1,30
10189,ALARM CLOCK BAKELIKE RED ,9,904,13,1400,496,1,26
10190,BLUE DINER WALL CLOCK,4,151,25,2600,2449,1,50
10191,IVORY DINER WALL CLOCK,4,107,8,900,793,1,16
10192,LARGE HEART MEASURING SPOONS,2,100,0,100,0,1,0
10193,SMALL HEART MEASURING SPOONS,9,100,0,100,0,1,0
10194,CHRISTMAS LIGHTS 10 REINDEER,9,225,12,1300,1075,1,24
10195,JAM MAKING SET WITH JARS,2,393,3,400,7,1,6
10196,JAM MAKING SET PRINTED,9,123,1,200,77,1,2
10197,JAM JAR WITH PINK LID,8,216,3,400,184,1,6
10198,JAM JAR WITH GREEN LID,10,646,8,900,254,1,16
10199,ROSE COTTAGE KEEPSAKE BOX ,10,1276,12,1300,24,1,24
10200,HANGING HEART ZINC T-LIGHT HOLDER,2,547,12,1300,753,1,24
10201,PAPER CHAIN KIT VINTAGE CHRISTMAS,8,135,3,400,265,1,6
10202,DISCO BALL CHRISTMAS DECORATION,3,1312,16,1700,388,1,32
10203,WHITE HANGING HEART T-LIGHT HOLDER,2,328,3,400,72,1,6
10204,SMALL POPCORN HOLDER,7,746,20,2100,1354,1,40
10205,LARGE POPCORN HOLDER ,2,699,7,800,101,1,14
10206,RETROSPOT LARGE MILK JUG,6,1033,11,1200,167,1,22
10207,SET/20 RED RETROSPOT PAPER NAPKINS ,4,1112,14,1500,388,1,28
10208,SET/6 RED SPOTTY PAPER PLATES,5,728,24,2500,1772,1,48
10209,SET/6 RED SPOTTY PAPER CUPS,6,1927,20,2100,173,1,40
10210,POLKADOT RAIN HAT ,8,489,23,2400,1911,1,46
10211,DELUXE SEWING KIT ,5,175,1,200,25,1,2
10212,RETROSPOT HEART HOT WATER BOTTLE,8,768,18,1900,1132,1,36
10213,KNITTED UNION FLAG HOT WATER BOTTLE,9,2129,21,2200,71,1,42
10214,ENGLISH ROSE HOT WATER BOTTLE,4,1307,15,1600,293,1,30
10215,PHOTO CUBE,1,1209,25,2600,1391,1,50
10216,HOMEMADE JAM SCENTED CANDLES,1,225,2,300,75,1,4
10217,JUMBO BAG RED RETROSPOT,9,443,9,1000,557,1,18
10218,PLASTERS IN TIN CIRCUS PARADE ,8,1829,20,2100,271,1,40
10219,PACK OF 12 PINK PAISLEY TISSUES ,8,129,5,600,471,1,10
10220,PACK OF 12 BLUE PAISLEY TISSUES ,6,484,11,1200,716,1,22
10221,PACK OF 12 RED RETROSPOT TISSUES ,7,962,21,2200,1238,1,42
10222,CHICK GREY HOT WATER BOTTLE,1,188,4,500,312,1,8
10223,PLASTERS IN TIN VINTAGE PAISLEY ,8,763,16,1700,937,1,32
10224,PLASTERS IN TIN SKULLS,9,190,9,1000,810,1,18
10225,12 STRIPEY MICE FELTCRAFT,8,556,24,2500,1944,1,48
10226,SET OF 6 SOLDIER SKITTLES,8,100,0,100,0,1,0
10227,TRADITIONAL WOODEN SKIPPING ROPE,5,1181,12,1300,119,1,24
10228,WOODEN BOX OF DOMINOES,1,1791,24,2500,709,1,48
10229,RUSTIC  SEVENTEEN DRAWER SIDEBOARD,7,161,17,1800,1639,1,34
10230,PARTY CONES CARNIVAL ASSORTED,2,829,13,1400,571,1,26
10231,PARTY CONES CANDY ASSORTED,1,882,14,1500,618,1,28
10232,PICNIC BASKET WICKER SMALL,1,1291,25,2600,1309,1,50
10233,ASSORTED COLOUR BIRD ORNAMENT,2,181,2,300,119,1,4
10234,STAR DECORATION PAINTED ZINC ,3,322,6,700,378,1,12
10235,RETROSPOT LAMP,8,704,7,800,96,1,14
10236,"FANCY FONT BIRTHDAY CARD, ",7,262,5,600,338,1,10
10237,HAND WARMER UNION JACK,5,789,23,2400,1611,1,46
10238,HAND WARMER SCOTTY DOG DESIGN,7,927,13,1400,473,1,26
10239,HAND WARMER OWL DESIGN,2,2176,25,2600,424,1,50
10240,HAND WARMER RED RETROSPOT,8,2154,24,2500,346,1,48
10241,RETROSPOT HEART HOT WATER BOTTLE,5,1430,17,1800,370,1,34
10242,DOG BOWL CHASING BALL DESIGN,6,233,7,800,567,1,14
10243,CLOTHES PEGS RETROSPOT PACK 33,4,1116,22,2300,1184,1,44
10244,HAND OVER THE CHOCOLATE   SIGN ,1,285,4,500,215,1,8
10245,WHITE HANGING HEART T-LIGHT HOLDER,1,409,4,500,91,1,8
10246,TRAVEL SEWING KIT,8,432,22,2300,1868,1,44
10247,BLACK HEART CARD HOLDER,2,411,9,1000,589,1,18
10248,ASSORTED COLOUR BIRD ORNAMENT,9,273,9,1000,727,1,18
10249,PACK OF 60 PINK PAISLEY CAKE CASES,9,433,22,2300,1867,1,44
10250,69 TEATIME FAIRY CAKE CASES,6,337,5,600,263,1,10
10251,PACK OF 72 RETROSPOT CAKE CASES,7,1481,18,1900,419,1,36
10252,CHICK GREY HOT WATER BOTTLE,5,424,13,1400,976,1,26
10253,SMALL GLASS HEART TRINKET POT,1,579,5,600,21,1,10
10254,ALARM CLOCK BAKELIKE IVORY,4,142,3,400,258,1,6
10255,ALARM CLOCK BAKELIKE RED ,2,1159,23,2400,1241,1,46
10256,ALARM CLOCK BAKELIKE ORANGE,1,416,21,2200,1784,1,42
10257,ALARM CLOCK BAKELIKE GREEN,8,823,16,1700,877,1,32
10258,HOT WATER BOTTLE TEA AND SYMPATHY,7,184,6,700,516,1,12
10259,HAND WARMER BIRD DESIGN,1,1529,18,1900,371,1,36
10260,HAND WARMER SCOTTY DOG DESIGN,1,515,19,2000,1485,1,38
10261,WHITE HANGING HEART T-LIGHT HOLDER,7,224,3,400,176,1,6
10262,WHITE METAL LANTERN,8,402,4,500,98,1,8
10263,CREAM CUPID HEARTS COAT HANGER,6,742,8,900,158,1,16
10264,EDWARDIAN PARASOL BLACK,4,683,23,2400,1717,1,46
10265,EDWARDIAN PARASOL RED,3,471,5,600,129,1,10
10266,RETRO COFFEE MUGS ASSORTED,2,1750,22,2300,550,1,44
10267,SAVE THE PLANET MUG,8,553,6,700,147,1,12
10268,VINTAGE BILLBOARD DRINK ME MUG,5,1000,9,1000,0,1,18
10269,VINTAGE BILLBOARD LOVE/HATE MUG,9,1827,20,2100,273,1,40
10270,WOOD 2 DRAWER CABINET WHITE FINISH,9,449,8,900,451,1,16
10271,WOOD S/3 CABINET ANT WHITE FINISH,2,748,9,1000,252,1,18
10272,WOODEN PICTURE FRAME WHITE FINISH,1,236,2,300,64,1,4
10273,WOODEN FRAME ANTIQUE WHITE ,7,132,1,200,68,1,2
10274,KNITTED UNION FLAG HOT WATER BOTTLE,10,650,14,1500,850,1,28
10275,RED WOOLLY HOTTIE WHITE HEART.,4,631,23,2400,1769,1,46
10276,SET 7 BABUSHKA NESTING BOXES,4,464,6,700,236,1,12
10277,IVORY EMBROIDERED QUILT ,9,100,0,100,0,1,0
10278,GLASS STAR FROSTED T-LIGHT HOLDER,5,456,5,600,144,1,10
10279,SET OF 3 BLACK FLYING DUCKS,5,678,6,700,22,1,12
10280,SET OF 3 COLOURED  FLYING DUCKS,1,183,14,1500,1317,1,28
10281,PACK OF 12 RED RETROSPOT TISSUES ,6,545,11,1200,655,1,22
10282,RED RETROSPOT MUG,4,831,10,1100,269,1,20
10283,BABUSHKA LIGHTS STRING OF 19,5,339,10,1100,761,1,20
10284,PIGGY BANK RETROSPOT ,2,134,3,400,266,1,6
10285,SET 7 BABUSHKA NESTING BOXES,6,100,0,100,0,1,0
10286,DOORMAT FAIRY CAKE,9,2482,25,2600,118,1,50
10287,HAND WARMER RED RETROSPOT,9,1646,24,2500,854,1,48
10288,HAND WARMER SCOTTY DOG DESIGN,1,120,11,1200,1080,1,22
10289,HAND WARMER OWL DESIGN,5,324,8,900,576,1,16
10290,STRAWBERRY CERAMIC TRINKET BOX,5,1408,18,1900,492,1,36
10291,PINK DOUGHNUT TRINKET POT ,8,189,4,500,311,1,8
10292,SILK PURSE BABUSHKA PINK,9,1413,23,2400,987,1,46
10293,HOT WATER BOTTLE TEA AND SYMPATHY,10,334,3,400,66,1,6
10294,HOT WATER BOTTLE I AM SO POORLY,9,541,23,2400,1859,1,46
10295,CHOCOLATE HOT WATER BOTTLE,9,557,8,900,343,1,16
10296,WHITE SKULL HOT WATER BOTTLE ,9,279,24,2500,2221,1,48
10297,SCOTTIE DOG HOT WATER BOTTLE,10,567,7,800,233,1,14
10298,HAND WARMER RED POLKA DOT,8,1086,15,1600,514,1,30
10299,HAND WARMER UNION JACK,2,380,9,1000,620,1,18
10300,HOMEMADE JAM SCENTED CANDLES,1,822,21,2200,1378,1,42
10301,BIRD HOUSE HOT WATER BOTTLE,6,805,20,2100,1295,1,40
10302,BOUDOIR SQUARE TISSUE BOX,6,911,21,2200,1289,1,42
10303,SKULLS SQUARE TISSUE BOX,3,1165,20,2100,935,1,40
10304,PHOTO FRAME CORNICE,5,213,3,400,187,1,6
10305,SILK PURSE BABUSHKA RED,2,430,10,1100,670,1,20
10306,PICTURE DOMINOES,8,100,0,100,0,1,0
10307,S/6 SEW ON CROCHET FLOWERS,7,610,11,1200,590,1,22
10308,SCANDINAVIAN REDS RIBBONS,5,234,2,300,66,1,4
10309,BALLOONS  WRITING SET ,10,477,17,1800,1323,1,34
10310,JAM MAKING SET PRINTED,2,1299,18,1900,601,1,36
10311,LAVENDER INCENSE IN TIN,3,1410,15,1600,190,1,30
10312,TV DINNER TRAY VINTAGE PAISLEY,7,419,20,2100,1681,1,40
10313,SET OF 4 ENGLISH ROSE PLACEMATS,6,393,22,2300,1907,1,44
10314,SET OF 4 ENGLISH ROSE COASTERS,3,1520,17,1800,280,1,34
10315,TRIPLE PHOTO FRAME CORNICE ,7,282,18,1900,1618,1,36
10316,FAMILY PHOTO FRAME CORNICE,4,534,20,2100,1566,1,40
10317,MIRRORED DISCO BALL ,6,330,8,900,570,1,16
10318,DISCO BALL ROTATOR BATTERY OPERATED,1,1379,23,2400,1021,1,46
10319,SILVER LOOKING MIRROR,5,476,5,600,124,1,10
10320,LADIES & GENTLEMEN METAL SIGN,1,700,22,2300,1600,1,44
10321,METAL SIGN HER DINNER IS SERVED ,6,1372,15,1600,228,1,30
10322,YOU'RE CONFUSING ME METAL SIGN ,1,630,8,900,270,1,16
10323,DOORMAT TOPIARY,6,1847,19,2000,153,1,38
10324,BATHROOM METAL SIGN,8,487,5,600,113,1,10
10325,KITCHEN METAL SIGN,1,262,3,400,138,1,6
10326,TOILET METAL SIGN,3,1528,19,2000,472,1,38
10327,METAL SIGN TAKE IT OR LEAVE IT ,1,276,19,2000,1724,1,38
10328,I'M ON HOLIDAY METAL SIGN,10,2488,25,2600,112,1,50
10329,GROW YOUR OWN BASIL IN ENAMEL MUG,6,913,10,1100,187,1,20
10330,SET/10 PINK POLKADOT PARTY CANDLES,5,221,4,500,279,1,8
10331,SET 20 NAPKINS FAIRY CAKES DESIGN ,3,1190,17,1800,610,1,34
10332,69 TEATIME FAIRY CAKE CASES,1,1057,22,2300,1243,1,44
10333,SET OF 6 T-LIGHTS SNOWMEN,1,593,8,900,307,1,16
10334,SET OF 6 T-LIGHTS SANTA,3,196,9,1000,804,1,18
10335,SET OF 9 HEART SHAPED BALLOONS,3,1541,17,1800,259,1,34
10336,SANDWICH BATH SPONGE,6,1174,13,1400,226,1,26
10337,APPLE BATH SPONGE,1,137,1,200,63,1,2
10338,STRAWBERRY BATH SPONGE ,4,757,16,1700,943,1,32
10339,BLACK PIRATE TREASURE CHEST,4,2401,25,2600,199,1,50
10340,STAR PORTABLE TABLE LIGHT ,4,173,25,2600,2427,1,50
10341,SNOWFLAKE PORTABLE TABLE LIGHT ,4,924,21,2200,1276,1,42
10342,PINK OVAL JEWELLED MIRROR,1,703,12,1300,597,1,24
10343,RETROSPOT CIGAR BOX MATCHES ,9,476,11,1200,724,1,22
10344,COSY HOUR GIANT TUBE MATCHES,7,1416,14,1500,84,1,28
10345,JAZZ HEARTS PURSE NOTEBOOK,4,1143,13,1400,257,1,26
10346,LUNCH BAG DOLLY GIRL DESIGN,6,100,0,100,0,1,0
10347,WHITE HANGING HEART T-LIGHT HOLDER,4,1933,23,2400,467,1,46
10348,CANDLEHOLDER PINK HANGING HEART,3,1780,21,2200,420,1,42
10349,WOOD 2 DRAWER CABINET WHITE FINISH,1,344,9,1000,656,1,18
10350,ASSORTED COLOUR MINI CASES,4,470,7,800,330,1,14
10351,LUNCH BAG RED RETROSPOT,5,794,8,900,106,1,16
10352,LUNCH BAG SPACEBOY DESIGN ,4,1024,15,1600,576,1,30
10353,LUNCH BAG WOODLAND,2,239,2,300,61,1,4
10354,LUNCH BAG PINK POLKADOT,3,106,15,1600,1494,1,30
10355,GUMBALL COAT RACK,10,946,14,1500,554,1,28
10356,BLUE NEW BAROQUE CANDLESTICK CANDLE,8,330,4,500,170,1,8
10357,PINK NEW BAROQUECANDLESTICK CANDLE,4,693,7,800,107,1,14
10358,FAIRY CAKE FLANNEL ASSORTED COLOUR,1,686,8,900,214,1,16
10359,BREAD BIN DINER STYLE PINK,7,207,3,400,193,1,6
10360,JUMBO BAG CHARLIE AND LOLA TOYS,7,420,7,800,380,1,14
10361,TEA TIME TABLE CLOTH,5,232,2,300,68,1,4
10362,ENGLISH ROSE HOT WATER BOTTLE,9,144,9,1000,856,1,18
10363,ENAMEL FIRE BUCKET CREAM,9,100,0,100,0,1,0
10364,PICNIC BASKET WICKER SMALL,2,453,5,600,147,1,10
10365,PAPER CHAIN KIT 50'S CHRISTMAS ,3,314,5,600,286,1,10
10366,PAPER CHAIN KIT VINTAGE CHRISTMAS,1,196,1,200,4,1,2
10367,HOT WATER BOTTLE BABUSHKA ,10,2038,20,2100,62,1,40
10368,HAND WARMER BIRD DESIGN,9,1076,21,2200,1124,1,42
10369,POSTAGE,5,1299,16,1700,401,1,32
10370,HEART IVORY TRELLIS SMALL,7,1020,12,1300,280,1,24
10371,CLEAR DRAWER KNOB ACRYLIC EDWARDIAN,10,2422,24,2500,78,1,48
10372,PINK DRAWER KNOB ACRYLIC EDWARDIAN,6,546,13,1400,854,1,26
10373,GREEN DRAWER KNOB ACRYLIC EDWARDIAN,7,175,1,200,25,1,2
10374,BLUE DRAWER KNOB ACRYLIC EDWARDIAN,10,594,20,2100,1506,1,40
10375,HEART OF WICKER SMALL,4,1142,24,2500,1358,1,48
10376,SMALL POPCORN HOLDER,10,637,6,700,63,1,12
10377,SET 6 FOOTBALL CELEBRATION CANDLES,2,942,23,2400,1458,1,46
10378,SET OF 6 GIRLS CELEBRATION CANDLES,7,425,10,1100,675,1,20
10379,ROMANTIC PINKS RIBBONS ,1,503,5,600,97,1,10
10380,BRIGHT BLUES RIBBONS ,5,605,11,1200,595,1,22
10381,SCANDINAVIAN REDS RIBBONS,8,1708,25,2600,892,1,50
10382,CHOCOLATE BOX RIBBONS ,1,2353,25,2600,247,1,50
10383,PARTY INVITES FOOTBALL,3,565,7,800,235,1,14
10384,PARTY INVITES JAZZ HEARTS,7,168,6,700,532,1,12
10385,PARTY INVITES SPACEMAN,8,207,9,1000,793,1,18
10386,SET OF 3 BUTTERFLY COOKIE CUTTERS,6,100,0,100,0,1,0
10387,SET OF 3 HEART COOKIE CUTTERS,1,905,10,1100,195,1,20
10388,12 PIECE SPACEBOY COOKIE CUTTER SET,1,273,5,600,327,1,10
10389,PACK OF 72 SKULL CAKE CASES,6,479,9,1000,521,1,18
10390,PACK OF 60 SPACEBOY CAKE CASES,2,364,4,500,136,1,8
10391,PACK OF 72 RETROSPOT CAKE CASES,4,939,10,1100,161,1,20
10392,81 SWEETHEART FAIRY CAKE CASES,10,846,8,900,54,1,16
10393,PACK OF 60 DINOSAUR CAKE CASES,10,306,5,600,294,1,10
10394,LUNCH BAG SUKI  DESIGN ,10,415,4,500,85,1,8
10395,LUNCH BAG CARS BLUE,7,207,3,400,193,1,6
10396,LUNCH BAG  BLACK SKULL.,5,777,10,1100,323,1,20
10397,HEART IVORY TRELLIS LARGE,7,163,8,900,737,1,16
10398,SET/5 RED RETROSPOT LID GLASS BOWLS,5,899,17,1800,901,1,34
10399,WHITE HANGING HEART T-LIGHT HOLDER,9,281,9,1000,719,1,18
10400,WHITE METAL LANTERN,7,169,8,900,731,1,16
10401,CREAM CUPID HEARTS COAT HANGER,3,794,9,1000,206,1,18
10402,EDWARDIAN PARASOL RED,3,981,21,2200,1219,1,42
10403,RETRO COFFEE MUGS ASSORTED,1,422,7,800,378,1,14
10404,SAVE THE PLANET MUG,2,1182,11,1200,18,1,22
10405,VINTAGE BILLBOARD DRINK ME MUG,8,966,23,2400,1434,1,46
10406,VINTAGE BILLBOARD LOVE/HATE MUG,10,303,10,1100,797,1,20
10407,WOOD 2 DRAWER CABINET WHITE FINISH,10,197,3,400,203,1,6
10408,WOOD S/3 CABINET ANT WHITE FINISH,3,580,5,600,20,1,10
10409,WOODEN PICTURE FRAME WHITE FINISH,9,325,8,900,575,1,16
10410,WOODEN FRAME ANTIQUE WHITE ,4,1497,14,1500,3,1,28
10411,KNITTED UNION FLAG HOT WATER BOTTLE,10,1532,17,1800,268,1,34
10412,RED WOOLLY HOTTIE WHITE HEART.,4,102,3,400,298,1,6
10413,SET 7 BABUSHKA NESTING BOXES,3,161,1,200,39,1,2
10414,IVORY EMBROIDERED QUILT ,1,916,17,1800,884,1,34
10415,GLASS STAR FROSTED T-LIGHT HOLDER,4,429,25,2600,2171,1,50
10416,HAND WARMER RED POLKA DOT,3,100,0,100,0,1,0
10417,HAND WARMER UNION JACK,9,602,22,2300,1698,1,44
10418,MAGIC DRAWING SLATE DINOSAUR,6,2210,24,2500,290,1,48
10419,MAGIC DRAWING SLATE BAKE A CAKE ,3,1214,15,1600,386,1,30
10420,21 PENCILS TALL TUBE SKULLS,2,190,1,200,10,1,2
10421,CHOCOLATE CALCULATOR,5,161,9,1000,839,1,18
10422,RED  HARMONICA IN BOX ,5,447,12,1300,853,1,24
10423,BLUE HARMONICA IN BOX ,9,297,5,600,303,1,10
10424,SKULLS  WATER TRANSFER TATTOOS ,4,467,6,700,233,1,12
10425,PACK 3 BOXES BIRD PANNETONE ,10,221,2,300,79,1,4
10426,HOT WATER BOTTLE TEA AND SYMPATHY,3,2372,25,2600,228,1,50
10427,RED WOOLLY HOTTIE WHITE HEART.,3,1000,25,2600,1600,1,50
10428,WHITE SKULL HOT WATER BOTTLE ,3,468,7,800,332,1,14
10429,12 PIECE SPACEBOY COOKIE CUTTER SET,6,1528,22,2300,772,1,44
10430,SET OF 20 KIDS COOKIE CUTTERS,1,546,6,700,154,1,12
10431,19 COLOUR SPACEBOY PEN,5,261,22,2300,2039,1,44
10432,VICTORIAN GLASS HANGING T-LIGHT,5,653,19,2000,1347,1,38
10433,SINGLE HEART ZINC T-LIGHT HOLDER,9,1033,12,1300,267,1,24
10434,RED HANGING HEART T-LIGHT HOLDER,4,1059,12,1300,241,1,24
10435,HANGING METAL STAR LANTERN,8,380,19,2000,1620,1,38
10436,SILVER HANGING T-LIGHT HOLDER,1,1648,20,2100,452,1,40
10437,DOORMAT RED RETROSPOT,7,573,8,900,327,1,16
10438,DOORMAT HEARTS,9,1905,24,2500,595,1,48
10439,NATURAL SLATE RECTANGLE CHALKBOARD,4,100,0,100,0,1,0
10440,LOVEBIRD HANGING DECORATION WHITE ,7,750,16,1700,950,1,32
10441,ASSORTED COLOUR BIRD ORNAMENT,4,103,1,200,97,1,2
10442,HOME BUILDING BLOCK WORD,6,1122,22,2300,1178,1,44
10443,LOVE BUILDING BLOCK WORD,2,260,12,1300,1040,1,24
10444,PHOTO FRAME CORNICE,2,964,16,1700,736,1,32
10445,PENS ASSORTED FUNNY FACE,1,953,14,1500,547,1,28
10446,CARD CIRCUS PARADE,1,495,5,600,105,1,10
10447,WRAP COWBOYS  ,7,1365,19,2000,635,1,38
10448,AIRLINE BAG VINTAGE TOKYO 87,1,1055,20,2100,1045,1,40
10449,RED RETROSPOT UMBRELLA,2,653,14,1500,847,1,28
10450,BLACK/BLUE POLKADOT UMBRELLA,10,289,14,1500,1211,1,28
10451,RED 3 PIECE RETROSPOT CUTLERY SET,9,998,12,1300,302,1,24
10452,PACK OF 72 RETROSPOT CAKE CASES,4,524,6,700,176,1,12
10453,SET OF 72 RETROSPOT PAPER  DOILIES,3,340,10,1100,760,1,20
10454,BLUE COAT RACK PARIS FASHION,7,247,4,500,253,1,8
10455,PLASTERS IN TIN SKULLS,6,1748,22,2300,552,1,44
10456,SLEEPING CAT ERASERS,10,484,14,1500,1016,1,28
10457,CARD BIRTHDAY COWBOY,7,1024,14,1500,476,1,28
10458,PACK 3 BOXES CHRISTMAS PANNETONE,10,453,4,500,47,1,8
10459,ROTATING SILVER ANGELS T-LIGHT HLDR,4,121,13,1400,1279,1,26
10460,COSY HOUR GIANT TUBE MATCHES,1,205,4,500,295,1,8
10461,RIBBON REEL MAKING SNOWMEN ,7,773,18,1900,1127,1,36
10462,MINI PAINT SET VINTAGE ,5,568,13,1400,832,1,26
10463,13 TRADITIONAL SPINNING TOPS,9,436,13,1400,964,1,26
10464,SET OF 6 SOLDIER SKITTLES,3,1574,18,1900,326,1,36
10465,BAG 500g SWIRLY MARBLES,1,251,20,2100,1849,1,40
10466,14 STRAND GLASS NECKLACE CRYSTAL,2,251,2,300,49,1,4
10467,WHITE SKULL HOT WATER BOTTLE ,8,238,2,300,62,1,4
10468,SCOTTIE DOG HOT WATER BOTTLE,8,237,2,300,63,1,4
10469,SQUARECUSHION COVER PINK UNION FLAG,5,392,7,800,408,1,14
10470,SPACEBOY CHILDRENS EGG CUP,1,263,4,500,237,1,8
10471,CHILDREN'S SPACEBOY MUG,6,791,9,1000,209,1,18
10472,HAND WARMER SCOTTY DOG DESIGN,9,594,7,800,206,1,14
10473,FELTCRAFT CUSHION OWL,10,1139,11,1200,61,1,22
10474,BLACK CANDELABRA T-LIGHT HOLDER,1,2013,22,2300,287,1,44
10475,TOY TIDY DOLLY GIRL DESIGN,9,502,5,600,98,1,10
10476,SET 12 LAVENDER  BOTANICAL T-LIGHTS,3,649,7,800,151,1,14
10477,UNION JACK FLAG LUGGAGE TAG,2,1937,21,2200,263,1,42
10478,RED HEART LUGGAGE TAG,7,970,10,1100,130,1,20
10479,RED GLASS TASSLE BAG CHARM,7,572,5,600,28,1,10
10480,CLEAR ACRYLIC FACETED BANGLE,6,229,3,400,171,1,6
10481,14 STRAND GLASS NECKLACE CRYSTAL,5,711,13,1400,689,1,26
10482,DOORMAT UNION JACK GUNS AND ROSES,6,492,15,1600,1108,1,30
10483,VANILLA SCENT CANDLE JEWELLED BOX,3,301,14,1500,1199,1,28
10484,FULL ENGLISH BREAKFAST PLATE,2,296,3,400,104,1,6
10485,BLACK CANDELABRA T-LIGHT HOLDER,8,1210,15,1600,390,1,30
10486,MAGIC DRAWING SLATE CIRCUS PARADE  ,6,426,5,600,174,1,10
10487,CHRISTMAS HANGING HEART WITH BELL,1,1395,25,2600,1205,1,50
10488,CAKE STAND VICTORIAN FILIGREE MED,9,485,11,1200,715,1,22
10489,PAISLEY PATTERN  STICKERS,3,1367,13,1400,33,1,26
10490,FLOWERS  STICKERS,8,306,16,1700,1394,1,32
10491,PINK NEW BAROQUECANDLESTICK CANDLE,5,1011,15,1600,589,1,30
10492,BLUE NEW BAROQUE CANDLESTICK CANDLE,9,594,18,1900,1306,1,36
10493,JUMBO STORAGE BAG SUKI,10,357,24,2500,2143,1,48
10494,BLACK LOVE BIRD CANDLE,1,1267,21,2200,933,1,42
10495,PARTY TIME PENCIL ERASERS,1,766,10,1100,334,1,20
10496,DISCO BALL CHRISTMAS DECORATION,8,367,5,600,233,1,10
10497,PINK B'FLY C/COVER W BOBBLES,8,2439,24,2500,61,1,48
10498,PINK UNION JACK  LUGGAGE TAG,9,337,15,1600,1263,1,30
10499,15 RIBBONS ELEGANT CHRISTMAS ,4,592,15,1600,1008,1,30
10500,UNION JACK FLAG LUGGAGE TAG,10,1708,21,2200,492,1,42
10501,AGED GLASS SILVER T-LIGHT HOLDER,6,321,5,600,279,1,10
10502,BOOM BOX SPEAKER GIRLS,4,1513,15,1600,87,1,30
10503,15 RIBBONS SHIMMERING PINKS ,10,1121,13,1400,279,1,26
10504, SET 2 TEA TOWELS I LOVE LONDON ,7,316,5,600,284,1,10
10505,JUMBO BAG OWLS,2,1520,21,2200,680,1,42
10506,SANDWICH BATH SPONGE,3,611,16,1700,1089,1,32
10507,OWL DOORSTOP,8,1025,11,1200,175,1,22
10508,14 STRAND GLASS NECKLACE CRYSTAL,3,241,10,1100,859,1,20
10509,HAND WARMER UNION JACK,1,331,4,500,169,1,8
10510,HAND WARMER SCOTTY DOG DESIGN,4,778,12,1300,522,1,24
10511,LARGE POPCORN HOLDER ,3,884,24,2500,1616,1,48
10512,PAINTED METAL STAR WITH HOLLY BELLS,7,258,10,1100,842,1,20
10513,PAINTED METAL HEART WITH HOLLY BELL,4,1669,19,2000,331,1,38
10514,ANGEL DECORATION STARS ON DRESS,3,123,3,400,277,1,6
10515,SMALL POPCORN HOLDER,8,1271,17,1800,529,1,34
10516,JUMBO BAG RED RETROSPOT,4,1179,17,1800,621,1,34
10517,JUMBO BAG STRAWBERRY,2,861,14,1500,639,1,28
10518,STRAWBERRY SHOPPER BAG,3,548,12,1300,752,1,24
10519,STRAWBERRY CHARLOTTE BAG,5,100,0,100,0,1,0
10520, SET 2 TEA TOWELS I LOVE LONDON ,6,1244,13,1400,156,1,26
10521,PACK OF 12 RED RETROSPOT TISSUES ,3,298,10,1100,802,1,20
10522,SCOTTIE DOG HOT WATER BOTTLE,5,1408,16,1700,292,1,32
10523,CHOCOLATE HOT WATER BOTTLE,4,241,4,500,259,1,8
10524,LUNCH BAG CARS BLUE,1,2076,25,2600,524,1,50
10525,LUNCH BAG SPACEBOY DESIGN ,7,1552,17,1800,248,1,34
10526,ROUND SNACK BOXES SET OF4 WOODLAND ,1,1009,16,1700,691,1,32
10527,LUNCH BAG DOLLY GIRL DESIGN,2,1417,23,2400,983,1,46
10528,LUNCH BAG SUKI  DESIGN ,3,676,6,700,24,1,12
10529,LUNCH BAG  BLACK SKULL.,7,1963,22,2300,337,1,44
10530,ROUND SNACK BOXES SET OF 4 FRUITS ,4,2150,25,2600,450,1,50
10531,ROUND SNACK BOXES SET OF 4 SKULLS,9,584,13,1400,816,1,26
10532,DOLLY GIRL LUNCH BOX,4,263,7,800,537,1,14
10533,SPACEBOY LUNCH BOX ,2,277,7,800,523,1,14
10534,GREEN POLKADOT PLATE ,1,396,9,1000,604,1,18
10535,BLUE POLKADOT PLATE ,6,1335,19,2000,665,1,38
10536,RED RETROSPOT PLATE ,3,125,1,200,75,1,2
10537,PINK  POLKADOT PLATE ,9,238,10,1100,862,1,20
10538,ROUND SNACK BOXES SET OF 4 SKULLS,2,1381,13,1400,19,1,26
10539,FELTCRAFT DOLL MOLLY,5,2158,21,2200,42,1,42
10540,FELTCRAFT CHRISTMAS FAIRY,6,503,9,1000,497,1,18
10541,TRAVEL SEWING KIT,4,916,25,2600,1684,1,50
10542,SET OF 3 NOTEBOOKS IN PARCEL,6,1831,18,1900,69,1,36
10543,RED RETROSPOT TAPE,3,435,19,2000,1565,1,38
10544,COSY SLIPPER SHOES SMALL  RED ,7,1916,22,2300,384,1,44
10545,15 RIBBONS RUSTIC CHARM,10,110,2,300,190,1,4
10546,SCANDINAVIAN REDS RIBBONS,4,528,11,1200,672,1,22
10547,JAM MAKING SET PRINTED,8,799,14,1500,701,1,28
10548,21 DAISY PEGS IN WOOD BOX,4,212,11,1200,988,1,22
10549,HOT WATER BOTTLE BABUSHKA ,8,1151,21,2200,1049,1,42
10550,FELTCRAFT PRINCESS CHARLOTTE DOLL,5,111,1,200,89,1,2
10551,FELTCRAFT CHRISTMAS FAIRY,3,1915,25,2600,685,1,50
10552,FELTCRAFT PRINCESS CHARLOTTE DOLL,9,957,9,1000,43,1,18
10553,15 RIBBONS RUSTIC CHARM,5,230,13,1400,1170,1,26
10554,COSY SLIPPER SHOES SMALL  RED ,2,511,22,2300,1789,1,44
10555,SCANDINAVIAN REDS RIBBONS,7,158,2,300,142,1,4
10556,14 HOOK HANGER RED MAGIC TOADSTOOL,10,197,4,500,303,1,8
10557,CHRISTMAS CRAFT TREE TOP ANGEL,6,319,4,500,181,1,8
10558,CHRISTMAS CRAFT LITTLE FRIENDS,4,2134,21,2200,66,1,42
10559,14 HOOK HANGER RED MAGIC TOADSTOOL,2,1507,20,2100,593,1,40
10560,15 RIBBONS RUSTIC CHARM,8,1211,14,1500,289,1,28
10561,21 DAISY PEGS IN WOOD BOX,1,1749,24,2500,751,1,48
10562,SET OF 3 NOTEBOOKS IN PARCEL,6,589,10,1100,511,1,20
10563,14 HOOK HANGER MAGIC TOADSTOOL,2,432,7,800,368,1,14
10564,SCANDINAVIAN REDS RIBBONS,5,136,1,200,64,1,2
10565,RED TOADSTOOL LED NIGHT LIGHT,5,1036,10,1100,64,1,20
10566,14 HOOK HANGER RED MAGIC TOADSTOOL,7,313,8,900,587,1,16
10567,COSY SLIPPER SHOES SMALL GREEN,6,310,4,500,190,1,8
10568,COSY SLIPPER SHOES SMALL  RED ,8,361,9,1000,639,1,18
10569,FELTCRAFT DOLL ROSIE,6,1977,24,2500,523,1,48
10570,FELTCRAFT DOLL MOLLY,3,1293,12,1300,7,1,24
10571,FELTCRAFT DOLL EMILY,7,825,14,1500,675,1,28
10572,FELTCRAFT PRINCESS CHARLOTTE DOLL,8,953,14,1500,547,1,28
10573,FELTCRAFT PRINCESS OLIVIA DOLL,7,461,11,1200,739,1,22
10574,REX CASH+CARRY JUMBO SHOPPER,9,181,4,500,319,1,8
10575,FELTCRAFT DOLL MOLLY,6,604,6,700,96,1,12
10576,FELTCRAFT CUSHION OWL,7,1337,14,1500,163,1,28
10577,CHRISTMAS CRAFT TREE TOP ANGEL,4,1289,13,1400,111,1,26
10578,CHRISTMAS CRAFT LITTLE FRIENDS,9,1007,13,1400,393,1,26
10579,FELTCRAFT CUSHION RABBIT,3,416,9,1000,584,1,18
10580,FELTCRAFT CUSHION BUTTERFLY,7,1013,16,1700,687,1,32
10581,21 DAISY PEGS IN WOOD BOX,10,794,15,1600,806,1,30
10582,PAPER CHAIN KIT 50'S CHRISTMAS ,9,841,8,900,59,1,16
10583,FELTCRAFT CUSHION BUTTERFLY,2,1303,13,1400,97,1,26
10584,21 DAISY PEGS IN WOOD BOX,3,152,6,700,548,1,12
10585,ROSE COTTAGE KEEPSAKE BOX ,1,807,20,2100,1293,1,40
10586,TOTE BAG I LOVE LONDON,10,163,21,2200,2037,1,42
10587,21 DAISY PEGS IN WOOD BOX,1,1920,23,2400,480,1,46
10588,TOTE BAG I LOVE LONDON,4,100,19,2000,1900,1,38
10589,FOLDING UMBRELLA PINKWHITE POLKADOT,5,1879,21,2200,321,1,42
10590,FOLDING UMBRELLA CREAM POLKADOT,7,1841,19,2000,159,1,38
10591,FOLDING UMBRELLA WHITE/RED POLKADOT,1,680,12,1300,620,1,24
10592,SET 10 LIGHTS NIGHT OWL,1,161,2,300,139,1,4
10593,SMALL POPCORN HOLDER,7,321,8,900,579,1,16
10594, SET 2 TEA TOWELS I LOVE LONDON ,9,202,18,1900,1698,1,36
10595,FOLDING UMBRELLA RED/WHITE POLKADOT,1,167,1,200,33,1,2
10596,BABUSHKA LIGHTS STRING OF 19,5,1816,22,2300,484,1,44
10597,LUNCH BAG RED RETROSPOT,4,399,15,1600,1201,1,30
10598,S/4 VALENTINE DECOUPAGE HEART BOX,4,1497,21,2200,703,1,42
10599,FOLDING UMBRELLA CREAM POLKADOT,8,591,6,700,109,1,12
10600, SET 2 TEA TOWELS I LOVE LONDON ,5,500,11,1200,700,1,22
10601,FOLDING UMBRELLA RED/WHITE POLKADOT,1,151,1,200,49,1,2
10602,SOLDIERS EGG CUP ,5,179,12,1300,1121,1,24
10603,S/4 VALENTINE DECOUPAGE HEART BOX,9,1097,14,1500,403,1,28
10604,RED RETROSPOT MINI CASES,4,399,7,800,401,1,14
10605,,4,164,13,1400,1236,1,26
10606,69 CAKE CASES VINTAGE CHRISTMAS,4,272,4,500,228,1,8
10607,PAPER CHAIN KIT VINTAGE CHRISTMAS,7,233,5,600,367,1,10
10608,RIBBON REEL CHRISTMAS SOCK BAUBLE,7,2026,20,2100,74,1,40
10609,RIBBON REEL SNOWY VILLAGE,10,610,17,1800,1190,1,34
10610,RIBBON REEL MAKING SNOWMEN ,3,1245,16,1700,455,1,32
10611,SET OF 20 VINTAGE CHRISTMAS NAPKINS,1,1172,11,1200,28,1,22
10612,TURQUOISE CHRISTMAS TREE ,1,756,21,2200,1444,1,42
10613,RED STAR CARD HOLDER,7,1156,16,1700,544,1,32
10614,WICKER WREATH SMALL,9,100,18,1900,1800,1,36
10615,HEART OF WICKER LARGE,4,571,5,600,29,1,10
10616,ADVENT CALENDAR GINGHAM SACK,8,538,18,1900,1362,1,36
10617,HEART OF WICKER SMALL,7,109,19,2000,1891,1,38
10618,FELTCRAFT BUTTERFLY HEARTS,4,686,9,1000,314,1,18
10619,PARTY CONE CHRISTMAS DECORATION ,6,105,3,400,295,1,6
10620,VINTAGE HEADS AND TAILS CARD GAME ,10,274,9,1000,726,1,18
10621,WICKER STAR ,5,1755,22,2300,545,1,44
10622,VINTAGE SNAP CARDS,6,1083,25,2600,1517,1,50
10623,FELTCRAFT 6 FLOWER FRIENDS,2,147,3,400,253,1,6
10624, SET 2 TEA TOWELS I LOVE LONDON ,4,697,18,1900,1203,1,36
10625,JAM MAKING SET PRINTED,5,1274,21,2200,926,1,42
10626,BIRD DECORATION RED RETROSPOT,1,100,0,100,0,1,0
10627,CHRISTMAS GINGHAM TREE,3,588,23,2400,1812,1,46
10628,CHRISTMAS GINGHAM STAR,6,2337,23,2400,63,1,46
10629,CHRISTMAS GINGHAM HEART,6,1411,20,2100,689,1,40
10630,PACK OF 12 PINK POLKADOT TISSUES,4,144,6,700,556,1,12
10631,FELTCRAFT PRINCESS LOLA DOLL,4,217,7,800,583,1,14
10632,PACK OF 12 LONDON TISSUES ,1,829,11,1200,371,1,22
10633,PURPLE DRAWERKNOB ACRYLIC EDWARDIAN,8,682,23,2400,1718,1,46
10634,CHILDREN'S APRON DOLLY GIRL ,4,346,4,500,154,1,8
10635,CHILDRENS APRON SPACEBOY DESIGN,6,117,15,1600,1483,1,30
10636,CHRISTMAS LIGHTS 10 SANTAS ,8,217,2,300,83,1,4
10637,CHRISTMAS LIGHTS 10 REINDEER,6,100,0,100,0,1,0
10638,PAPER CHAIN KIT 50'S CHRISTMAS ,9,526,7,800,274,1,14
10639,FELTCRAFT CHRISTMAS FAIRY,1,1020,25,2600,1580,1,50
10640,PACK OF 72 RETROSPOT CAKE CASES,8,1813,20,2100,287,1,40
10641,PACK OF 60 MUSHROOM CAKE CASES,3,1408,15,1600,192,1,30
10642,69 CAKE CASES DOLLY GIRL DESIGN,4,116,9,1000,884,1,18
10643,PACK OF 60 PINK PAISLEY CAKE CASES,5,1073,15,1600,527,1,30
10644,HAND WARMER BABUSHKA DESIGN,1,252,19,2000,1748,1,38
10645,HAND WARMER BIRD DESIGN,2,118,14,1500,1382,1,28
10646,HAND WARMER OWL DESIGN,4,1452,17,1800,348,1,34
10647,HAND WARMER RED RETROSPOT,7,494,20,2100,1606,1,40
10648,SET 12 RETRO WHITE CHALK STICKS,6,193,4,500,307,1,8
10649,FELTCRAFT HAIRBAND RED AND BLUE,1,709,19,2000,1291,1,38
10650,FELTCRAFT HAIRBAND PINK AND PURPLE,4,100,0,100,0,1,0
10651,FELTCRAFT HAIRBANDS PINK AND WHITE ,2,376,3,400,24,1,6
10652,TV DINNER TRAY DOLLY GIRL,3,807,12,1300,493,1,24
10653,PLASTERS IN TIN VINTAGE PAISLEY ,5,127,1,200,73,1,2
10654,PLASTERS IN TIN SPACEBOY,3,142,1,200,58,1,2
10655,PLASTERS IN TIN WOODLAND ANIMALS,7,2133,22,2300,167,1,44
10656,MAGIC DRAWING SLATE SPACEBOY ,4,871,19,2000,1129,1,38
10657,MAGIC DRAWING SLATE CIRCUS PARADE  ,6,136,8,900,764,1,16
10658,MAGIC DRAWING SLATE GO TO THE FAIR ,2,788,7,800,12,1,14
10659,MAGIC DRAWING SLATE DOLLY GIRL ,2,160,2,300,140,1,4
10660,CHARLIE + LOLA RED HOT WATER BOTTLE,3,897,14,1500,603,1,28
10661,HOT WATER BOTTLE BABUSHKA ,5,364,3,400,36,1,6
10662,URBAN BLACK RIBBONS ,7,315,3,400,85,1,6
10663,FELTCRAFT PRINCESS CHARLOTTE DOLL,4,100,0,100,0,1,0
10664,SET OF 6 T-LIGHTS TOADSTOOLS,7,829,9,1000,171,1,18
10665,ROTATING LEAVES T-LIGHT HOLDER,9,214,3,400,186,1,6
10666,RED  HARMONICA IN BOX ,8,989,17,1800,811,1,34
10667,CUPCAKE LACE PAPER SET 15,4,1858,19,2000,142,1,38
10668,FAMILY PHOTO FRAME CORNICE,3,329,8,900,571,1,16
10669,TRIPLE PHOTO FRAME CORNICE ,2,100,1,200,100,1,2
10670,WOODEN FRAME ANTIQUE WHITE ,6,598,16,1700,1102,1,32
10671,WOODEN BOX OF DOMINOES,8,2067,25,2600,533,1,50
10672,TRADITIONAL WOODEN CATCH CUP GAME ,1,1097,18,1900,803,1,36
10673,TRADITIONAL WOODEN SKIPPING ROPE,8,1085,12,1300,215,1,24
10674,S/6 WOODEN SKITTLES IN COTTON BAG,10,1192,19,2000,808,1,38
10675,RED METAL BEACH SPADE ,2,1591,17,1800,209,1,34
10676,BOYS VINTAGE TIN SEASIDE BUCKET,8,367,4,500,133,1,8
10677,GIRLS VINTAGE TIN SEASIDE BUCKET,6,167,3,400,233,1,6
10678,GREY HEART HOT WATER BOTTLE,4,1303,13,1400,97,1,26
10679,SCOTTIE DOG HOT WATER BOTTLE,1,232,2,300,68,1,4
10680,BIRD HOUSE HOT WATER BOTTLE,1,187,3,400,213,1,6
10681,KINGS CHOICE TEA CADDY ,8,104,17,1800,1696,1,34
10682,KINGS CHOICE BISCUIT TIN,1,813,20,2100,1287,1,40
10683,METAL SIGN EMPIRE TEA,7,213,2,300,87,1,4
10684,HOMEMADE JAM SCENTED CANDLES,6,601,22,2300,1699,1,44
10685,SET OF 6 SOLDIER SKITTLES,8,180,1,200,20,1,2
10686,FAWN BLUE HOT WATER BOTTLE,6,234,4,500,266,1,8
10687,HAND WARMER RED RETROSPOT,5,1389,16,1700,311,1,32
10688,HOT WATER BOTTLE BABUSHKA ,2,1448,25,2600,1152,1,50
10689,WHITE SKULL HOT WATER BOTTLE ,3,644,19,2000,1356,1,38
10690,RETROSPOT HEART HOT WATER BOTTLE,6,176,4,500,324,1,8
10691,RED WOOLLY HOTTIE WHITE HEART.,1,222,2,300,78,1,4
10692,SCOTTIE DOG HOT WATER BOTTLE,10,116,1,200,84,1,2
10693,GREY HEART HOT WATER BOTTLE,5,1161,13,1400,239,1,26
10694,HOT WATER BOTTLE BABUSHKA ,5,373,3,400,27,1,6
10695,PACK OF 6 BIRDY GIFT TAGS,7,141,8,900,759,1,16
10696,CHILLI LIGHTS,6,2145,24,2500,355,1,48
10697,PIGGY BANK RETROSPOT ,8,100,0,100,0,1,0
10698,CERAMIC STRAWBERRY MONEY BOX,5,966,12,1300,334,1,24
10699,CERAMIC STRAWBERRY CAKE MONEY BANK,10,156,2,300,144,1,4
10700,CERAMIC CHERRY CAKE MONEY BANK,7,166,1,200,34,1,2
10701,CERAMIC HEART FAIRY CAKE MONEY BANK,7,722,9,1000,278,1,18
10702,CERAMIC PIRATE CHEST MONEY BANK,5,591,13,1400,809,1,26
10703,DOORSTOP RETROSPOT HEART,9,451,11,1200,749,1,22
10704,GINGHAM HEART  DOORSTOP RED,4,1518,20,2100,582,1,40
10705,RETROSPOT BABUSHKA DOORSTOP,5,815,8,900,85,1,16
10706,SILK PURSE BABUSHKA RED,6,733,19,2000,1267,1,38
10707,SILK PURSE BABUSHKA PINK,4,1252,15,1600,348,1,30
10708,FAMILY PHOTO FRAME CORNICE,4,1178,11,1200,22,1,22
10709,SWEETHEART WIRE WALL TIDY,8,129,13,1400,1271,1,26
10710,JAM MAKING SET PRINTED,2,100,0,100,0,1,0
10711,RED RETROSPOT OVEN GLOVE ,3,1042,13,1400,358,1,26
10712,CREAM HEART CARD HOLDER,2,1626,24,2500,874,1,48
10713,NAMASTE SWAGAT INCENSE,1,654,18,1900,1246,1,36
10714,CERAMIC STRAWBERRY DESIGN MUG,8,617,6,700,83,1,12
10715,BLACK HEART CARD HOLDER,7,1503,21,2200,697,1,42
10716,CLASSICAL ROSE SMALL VASE,9,287,2,300,13,1,4
10717,HYACINTH BULB T-LIGHT CANDLES,10,862,19,2000,1138,1,38
10718,CHRISTMAS CRAFT WHITE FAIRY ,6,362,9,1000,638,1,18
10719,CHRISTMAS CRAFT LITTLE FRIENDS,7,417,8,900,483,1,16
10720,COSY HOUR CIGAR BOX MATCHES ,9,1441,17,1800,359,1,34
10721,RED TEA TOWEL CLASSIC DESIGN,2,145,8,900,755,1,16
10722,HEART FILIGREE DOVE  SMALL,4,123,4,500,377,1,8
10723,RETROSPOT CHILDRENS APRON,4,1175,12,1300,125,1,24
10724,COLOURING PENCILS BROWN TUBE,5,952,10,1100,148,1,20
10725,13 IVORY DINNER CANDLES SILVER FLOCK,1,100,0,100,0,1,0
10726,HEART FILIGREE DOVE  SMALL,6,1606,17,1800,194,1,34
10727,ZINC METAL HEART DECORATION,5,130,18,1900,1770,1,36
10728,GREEN FERN NOTEBOOK,7,1575,21,2200,625,1,42
10729,BLUE PAISLEY NOTEBOOK,1,301,24,2500,2199,1,48
10730,CHRYSANTHEMUM NOTEBOOK,9,489,9,1000,511,1,18
10731,LARGE CHINESE STYLE SCISSOR,7,2001,21,2200,199,1,42
10732,SMALL CHINESE STYLE SCISSOR,9,1515,17,1800,285,1,34
10733,S/6 WOODEN SKITTLES IN COTTON BAG,9,2080,22,2300,220,1,44
10734,TRADITIONAL WOODEN SKIPPING ROPE,9,106,1,200,94,1,2
10735,SET OF 6 SOLDIER SKITTLES,7,1023,13,1400,377,1,26
10736,13 TRADITIONAL SPINNING TOPS,1,309,5,600,291,1,10
10737,ROTATING SILVER ANGELS T-LIGHT HLDR,2,435,25,2600,2165,1,50
10738,BLACK LOVE BIRD CANDLE,8,157,1,200,43,1,2
10739,RETROSPOT CHILDRENS APRON,3,1863,20,2100,237,1,40
10740,HANGING GLASS ETCHED TEALIGHT,9,2119,22,2300,181,1,44
10741,HANGING GLASS ETCHED TEALIGHT,9,1723,17,1800,77,1,34
10742,BLUE NEW BAROQUE CANDLESTICK CANDLE,4,203,4,500,297,1,8
10743,COOKING SET RETROSPOT,7,399,5,600,201,1,10
10744,KINGS CHOICE GIANT TUBE MATCHES,4,1096,13,1400,304,1,26
10745,COSY HOUR GIANT TUBE MATCHES,9,893,10,1100,207,1,20
10746,PLACE SETTING WHITE STAR,8,1632,19,2000,368,1,38
10747,HYACINTH BULB T-LIGHT CANDLES,2,805,14,1500,695,1,28
10748,S/15 SILVER GLASS BAUBLES IN BAG,4,509,14,1500,991,1,28
10749,FRENCH WC SIGN BLUE METAL,10,199,16,1700,1501,1,32
10750,KINGS CHOICE GIANT TUBE MATCHES,5,191,14,1500,1309,1,28
10751,81 SWEETHEART FAIRY CAKE CASES,2,393,23,2400,2007,1,46
10752,ASSORTED COLOUR BIRD ORNAMENT,2,1210,24,2500,1290,1,48
10753,FAIRY SOAP SOAP HOLDER,4,176,2,300,124,1,4
10754,GREEN GIANT GARDEN THERMOMETER,7,189,11,1200,1011,1,22
10755,IVORY GIANT GARDEN THERMOMETER,1,459,24,2500,2041,1,48
10756,BLUE GIANT GARDEN THERMOMETER,5,624,6,700,76,1,12
10757,PACK OF 60 PINK PAISLEY CAKE CASES,5,191,10,1100,909,1,20
10758,RETROSPOT HEART HOT WATER BOTTLE,2,118,1,200,82,1,2
10759,CHICK GREY HOT WATER BOTTLE,3,458,8,900,442,1,16
10760,VICTORIAN SEWING BOX SMALL ,9,1625,16,1700,75,1,32
10761,VICTORIAN SEWING BOX MEDIUM,9,461,4,500,39,1,8
10762,SET/10 RED POLKADOT PARTY CANDLES,7,660,13,1400,740,1,26
10763,WASHROOM METAL SIGN,9,168,3,400,232,1,6
10764,BLACK SWEETHEART BRACELET,10,1766,17,1800,34,1,34
10765,DIAMANTE HAIR GRIP PACK/2 BLACK DIA,7,1873,22,2300,427,1,44
10766,BLACK DIAMANTE EXPANDABLE RING,10,147,6,700,553,1,12
10767,DIAMANTE HAIR GRIP PACK/2 RUBY,5,518,22,2300,1782,1,44
10768,DIAMANTE HAIR GRIP PACK/2 MONTANA,1,843,8,900,57,1,16
10769,BLUE SWEETHEART BRACELET,2,983,18,1900,917,1,36
10770,PINK SWEETHEART BRACELET,2,937,11,1200,263,1,22
10771,PURPLE SWEETHEART BRACELET,2,310,4,500,190,1,8
10772,JUMBO BAG PINK POLKADOT,10,792,7,800,8,1,14
10773,JUMBO BAG RED RETROSPOT,5,246,2,300,54,1,4
10774,ASSORTED COLOUR BIRD ORNAMENT,7,669,21,2200,1531,1,42
10775,PAPER CHAIN KIT 50'S CHRISTMAS ,3,683,24,2500,1817,1,48
10776,RIBBON REEL CHRISTMAS PRESENT ,4,149,4,500,351,1,8
10777,FIRST AID TIN,7,122,5,600,478,1,10
10778,MAKE YOUR OWN MONSOON CARD KIT,5,545,9,1000,455,1,18
10779,PACK OF 12 HEARTS DESIGN TISSUES ,9,218,5,600,382,1,10
10780,PACK OF 12 RED RETROSPOT TISSUES ,8,402,6,700,298,1,12
10781,SOLDIERS EGG CUP ,9,547,20,2100,1553,1,40
10782,HEART IVORY TRELLIS SMALL,2,242,6,700,458,1,12
10783,HEART FILIGREE DOVE  SMALL,3,408,12,1300,892,1,24
10784,HEART FILIGREE DOVE LARGE,2,920,12,1300,380,1,24
10785,PACK 3 BOXES BIRD PANNETONE ,10,868,22,2300,1432,1,44
10786,PACK 3 BOXES CHRISTMAS PANNETONE,2,1390,21,2200,810,1,42
10787,SMALL POPCORN HOLDER,9,286,18,1900,1614,1,36
10788,PACK OF 60 PINK PAISLEY CAKE CASES,4,776,23,2400,1624,1,46
10789,SET OF 6 SOLDIER SKITTLES,5,514,18,1900,1386,1,36
10790,SWIRLY CIRCULAR RUBBERS IN BAG,5,730,18,1900,1170,1,36
10791,VINTAGE PAISLEY STATIONERY SET,3,783,16,1700,917,1,32
10792,PAPER CHAIN KIT VINTAGE CHRISTMAS,10,682,7,800,118,1,14
10793,SET/10 BLUE POLKADOT PARTY CANDLES,2,1330,14,1500,170,1,28
10794,RIBBON REEL SOCKS AND MITTENS,10,245,18,1900,1655,1,36
10795,69 CAKE CASES VINTAGE CHRISTMAS,3,407,4,500,93,1,8
10796,CHRISTMAS METAL TAGS ASSORTED ,8,142,2,300,158,1,4
10797,CHRISTMAS TREE T-LIGHT HOLDER,7,2029,23,2400,371,1,46
10798,STAR  T-LIGHT HOLDER ,6,591,7,800,209,1,14
10799,HEART T-LIGHT HOLDER ,10,377,8,900,523,1,16
10800,MINI FUNKY DESIGN TAPES,3,1927,24,2500,573,1,48
10801,SET OF 6 T-LIGHTS SNOWMEN,4,435,8,900,465,1,16
10802,STAR WOODEN CHRISTMAS DECORATION,10,941,14,1500,559,1,28
10803,WOODEN HEART CHRISTMAS SCANDINAVIAN,7,108,4,500,392,1,8
10804,CHRISTMAS RETROSPOT TREE WOOD,1,669,6,700,31,1,12
10805,SET OF 6 T-LIGHTS SANTA,3,194,6,700,506,1,12
10806,SET/9 CHRISTMAS T-LIGHTS SCENTED ,4,634,6,700,66,1,12
10807,BLUE ROSE FABRIC MIRROR,6,584,22,2300,1716,1,44
10808,THREE CANVAS LUGGAGE TAGS,10,622,11,1200,578,1,22
10809,RETROSPOT PARTY BAG + STICKER SET,2,231,7,800,569,1,14
10810,PLASTERS IN TIN VINTAGE PAISLEY ,3,348,4,500,152,1,8
10811,RETROSPOT SMALL TUBE MATCHES,2,993,15,1600,607,1,30
10812,HAND WARMER SCOTTY DOG DESIGN,7,2079,24,2500,421,1,48
10813,3D CHRISTMAS STAMPS STICKERS ,2,820,18,1900,1080,1,36
10814,HAND WARMER SCOTTY DOG DESIGN,2,107,1,200,93,1,2
10815,HAND WARMER SCOTTY DOG DESIGN,1,956,21,2200,1244,1,42
10816,CLOTHES PEGS RETROSPOT PACK 33,6,1310,21,2200,890,1,42
10817,45 FOIL HEART CAKE CASES,8,135,22,2300,2165,1,44
10818,CHRISTMAS METAL TAGS ASSORTED ,3,440,9,1000,560,1,18
10819,PACK OF 6 SWEETIE GIFT BOXES,1,476,5,600,124,1,10
10820,PACK OF 72 RETROSPOT CAKE CASES,1,426,8,900,474,1,16
10821,PACK OF 72 RETROSPOT CAKE CASES,10,391,4,500,109,1,8
10822,PACK OF 6 BIRDY GIFT TAGS,6,754,18,1900,1146,1,36
10823,SET/10 RED POLKADOT PARTY CANDLES,9,956,10,1100,144,1,20
10824,SET/10 PINK POLKADOT PARTY CANDLES,10,776,16,1700,924,1,32
10825,SET OF 3 NOTEBOOKS IN PARCEL,8,1178,11,1200,22,1,22
10826,STAR  T-LIGHT HOLDER ,3,135,1,200,65,1,2
10827,CINAMMON SET OF 9 T-LIGHTS,9,380,3,400,20,1,6
10828,ORANGE SCENTED SET/9 T-LIGHTS,2,808,9,1000,192,1,18
10829,RIBBON REEL STRIPES DESIGN ,10,159,20,2100,1941,1,40
10830,SET OF 2 TINS JARDIN DE PROVENCE,7,1916,20,2100,184,1,40
10831,MAKE YOUR OWN PLAYTIME CARD KIT,3,1503,16,1700,197,1,32
10832,DINOSAURS  WRITING SET ,10,841,9,1000,159,1,18
10833,BALLOONS  WRITING SET ,4,734,21,2200,1466,1,42
10834,SKULLS WRITING SET ,5,1547,22,2300,753,1,44
10835,VINTAGE PAISLEY STATIONERY SET,8,311,12,1300,989,1,24
10836,COSY SLIPPER SHOES SMALL  RED ,5,271,2,300,29,1,4
10837,DOORMAT BLACK FLOCK ,4,118,15,1600,1482,1,30
10838,JUMBO  BAG BAROQUE BLACK WHITE,4,1171,16,1700,529,1,32
10839,JAM MAKING SET WITH JARS,2,1452,17,1800,348,1,34
10840,ORANGE SCENTED SET/9 T-LIGHTS,4,1398,15,1600,202,1,30
10841,CINAMMON SET OF 9 T-LIGHTS,7,309,4,500,191,1,8
10842,HAND WARMER SCOTTY DOG DESIGN,6,2207,23,2400,193,1,46
10843,CHRISTMAS DECOUPAGE CANDLE,2,223,4,500,277,1,8
10844,HEART T-LIGHT HOLDER ,6,953,9,1000,47,1,18
10845,GROW YOUR OWN BASIL IN ENAMEL MUG,4,100,0,100,0,1,0
10846,OFFICE MUG WARMER POLKADOT,3,1500,15,1600,100,1,30
10847,SMALL POPCORN HOLDER,8,2003,20,2100,97,1,40
10848,JUMBO BAG DOLLY GIRL DESIGN,5,687,14,1500,813,1,28
10849,JAM MAKING SET WITH JARS,2,100,0,100,0,1,0
10850,JAM MAKING SET PRINTED,8,2125,23,2400,275,1,46
10851,SMALL GLASS HEART TRINKET POT,9,1403,20,2100,697,1,40
10852,RED WOOLLY HOTTIE WHITE HEART.,1,472,11,1200,728,1,22
10853,BLACK RECORD COVER FRAME,8,635,9,1000,365,1,18
10854,"RECORD FRAME 7"" SINGLE SIZE ",5,887,18,1900,1013,1,36
10855,45 PENCILS TUBE RED RETROSPOT,7,893,10,1100,207,1,20
10856,45 PENCILS TUBE WOODLAND,9,341,3,400,59,1,6
10857,SET OF 6 SOLDIER SKITTLES,2,293,8,900,607,1,16
10858,ROCKING HORSE RED CHRISTMAS ,4,376,19,2000,1624,1,38
10859,CHRISTMAS GINGHAM HEART,10,1231,12,1300,69,1,24
10860,CHRISTMAS GINGHAM STAR,8,196,1,200,4,1,2
10861,HAND WARMER UNION JACK,8,625,11,1200,575,1,22
10862,HAND WARMER RED RETROSPOT,6,1490,19,2000,510,1,38
10863,REGENCY CAKESTAND 3 TIER,7,1095,19,2000,905,1,38
10864,JUMBO SHOPPER VINTAGE RED PAISLEY,9,164,3,400,236,1,6
10865,RIBBON REEL SNOWY VILLAGE,3,1781,18,1900,119,1,36
10866,VINTAGE UNION JACK BUNTING,7,576,12,1300,724,1,24
10867,JAM MAKING SET WITH JARS,4,419,5,600,181,1,10
10868,RIBBON REEL STRIPES DESIGN ,6,658,15,1600,942,1,30
10869,RETRO LONGBOARD IRONING BOARD COVER,3,1135,16,1700,565,1,32
10870,3D DOG PICTURE PLAYING CARDS,9,277,15,1600,1323,1,30
10871,RETROSPOT CIGAR BOX MATCHES ,2,149,4,500,351,1,8
10872,SET/9 CHRISTMAS T-LIGHTS SCENTED ,5,737,13,1400,663,1,26
10873,ROTATING SILVER ANGELS T-LIGHT HLDR,4,155,1,200,45,1,2
10874,ROTATING SILVER ANGELS T-LIGHT HLDR,9,101,1,200,99,1,2
10875,SAVE THE PLANET COTTON TOTE BAG,8,565,21,2200,1635,1,42
10876,SET OF 20 VINTAGE CHRISTMAS NAPKINS,8,750,14,1500,750,1,28
10877,PAPER BUNTING WHITE LACE,7,168,6,700,532,1,12
10878,GENTLEMAN SHIRT REPAIR KIT ,3,230,7,800,570,1,14
10879,CARD I LOVE LONDON ,9,179,1,200,21,1,2
10880,PAPER CHAIN KIT VINTAGE CHRISTMAS,7,911,11,1200,289,1,22
10881,MIRRORED WALL ART FOXY,1,734,20,2100,1366,1,40
10882,MIRRORED WALL ART GENTS,10,1232,17,1800,568,1,34
10883,AIRLINE BAG VINTAGE JET SET WHITE,8,1456,23,2400,944,1,46
10884,JAM MAKING SET PRINTED,2,426,21,2200,1774,1,42
10885,POTTING SHED SOW 'N' GROW SET,2,589,16,1700,1111,1,32
10886,BABUSHKA LIGHTS STRING OF 19,5,100,0,100,0,1,0
10887,REX CASH+CARRY JUMBO SHOPPER,8,947,25,2600,1653,1,50
10888,AIRLINE BAG VINTAGE WORLD CHAMPION ,3,175,1,200,25,1,2
10889,HAND WARMER BIRD DESIGN,3,100,0,100,0,1,0
10890,CHRISTMAS CRAFT LITTLE FRIENDS,2,721,7,800,79,1,14
10891,PINK HEARTS PAPER GARLAND,7,147,18,1900,1753,1,36
10892,POTTING SHED SEED ENVELOPES,7,921,10,1100,179,1,20
10893,HI TEC ALPINE HAND WARMER,8,1161,14,1500,339,1,28
10894,FELTCRAFT CHRISTMAS FAIRY,10,869,8,900,31,1,16
10895,HI TEC ALPINE HAND WARMER,5,186,7,800,614,1,14
10896,ROTATING SILVER ANGELS T-LIGHT HLDR,3,636,8,900,264,1,16
10897,12 STRIPEY MICE FELTCRAFT,2,312,5,600,288,1,10
10898,FELTCRAFT 6 FLOWER FRIENDS,7,892,8,900,8,1,16
10899,CHRISTMAS CRAFT LITTLE FRIENDS,10,357,9,1000,643,1,18
10900,VINTAGE UNION JACK CUSHION COVER,5,1566,16,1700,134,1,32
10901,POLYESTER FILLER PAD 45x45cm,9,2177,23,2400,223,1,46
10902,DOLLY GIRL LUNCH BOX,3,168,4,500,332,1,8
10903,PACK OF 12 LONDON TISSUES ,7,641,12,1300,659,1,24
10904,CARD DOLLY GIRL ,6,498,10,1100,602,1,20
10905,CARD BILLBOARD FONT,1,117,1,200,83,1,2
10906,RAINY LADIES BIRTHDAY CARD,3,290,12,1300,1010,1,24
10907,GREY HEART HOT WATER BOTTLE,1,243,4,500,257,1,8
10908,RED WOOLLY HOTTIE WHITE HEART.,10,1321,13,1400,79,1,26
10909,RED WHITE SCARF  HOT WATER BOTTLE,5,2052,22,2300,248,1,44
10910, SET 2 TEA TOWELS I LOVE LONDON ,10,1061,18,1900,839,1,36
10911,SET OF 2 TEA TOWELS APPLE AND PEARS,10,296,6,700,404,1,12
10912,SET/2 RED RETROSPOT TEA TOWELS ,1,570,25,2600,2030,1,50
10913,LOVE BUILDING BLOCK WORD,3,1519,25,2600,1081,1,50
10914,HOME BUILDING BLOCK WORD,7,1744,24,2500,756,1,48
10915,ASSORTED COLOUR BIRD ORNAMENT,4,100,0,100,0,1,0
10916,LANTERN CREAM GAZEBO ,10,1202,17,1800,598,1,34
10917,BLUE BIRDHOUSE DECORATION,1,2007,23,2400,393,1,46
10918,WHITE HANGING HEART T-LIGHT HOLDER,3,383,5,600,217,1,10
10919,REGENCY CAKESTAND 3 TIER,6,1460,19,2000,540,1,38
10920,ANTIQUE SILVER TEA GLASS ENGRAVED,2,329,9,1000,671,1,18
10921,AGED GLASS SILVER T-LIGHT HOLDER,10,1331,19,2000,669,1,38
10922,JAM MAKING SET WITH JARS,2,243,5,600,357,1,10
10923,HAND WARMER OWL DESIGN,10,1200,17,1800,600,1,34
10924,SET OF 2 WOODEN MARKET CRATES,8,177,1,200,23,1,2
10925,SET OF 6 T-LIGHTS TOADSTOOLS,3,161,7,800,639,1,14
10926,HAND WARMER UNION JACK,1,1837,23,2400,563,1,46
10927,HAND WARMER SCOTTY DOG DESIGN,5,769,12,1300,531,1,24
10928,CLASSIC FRENCH STYLE BASKET NATURAL,3,848,10,1100,252,1,20
10929,CRAZY DAISY HEART DECORATION,7,940,11,1200,260,1,22
10930,GIN + TONIC DIET METAL SIGN,9,142,4,500,358,1,8
10931,IVORY GIANT GARDEN THERMOMETER,4,351,4,500,149,1,8
10932,CARD HOLDER GINGHAM HEART,3,331,20,2100,1769,1,40
10933,SMALL STRIPES CHOCOLATE GIFT BAG ,5,132,3,400,268,1,6
10934,S/6 WOODEN SKITTLES IN COTTON BAG,1,186,4,500,314,1,8
10935,HAND WARMER RED RETROSPOT,9,956,25,2600,1644,1,50
10936,HAND WARMER UNION JACK,6,916,10,1100,184,1,20
10937,FRENCH WC SIGN BLUE METAL,8,1783,23,2400,617,1,46
10938,PINK UNION JACK  LUGGAGE TAG,9,497,22,2300,1803,1,44
10939,"TRAY, BREAKFAST IN BED",7,642,11,1200,558,1,22
10940,PIZZA PLATE IN BOX,1,409,5,600,191,1,10
10941,HEART OF WICKER LARGE,10,323,13,1400,1077,1,26
10942,PINK HEART DOTS HOT WATER BOTTLE,7,492,23,2400,1908,1,46
10943,PLACE SETTING WHITE HEART,4,2248,23,2400,152,1,46
10944,SET OF 4 NAPKIN CHARMS LEAVES   ,5,679,14,1500,821,1,28
10945,SET OF 4 NAPKIN CHARMS STARS   ,1,1458,15,1600,142,1,30
10946,SET OF 4 NAPKIN CHARMS CUTLERY,6,519,6,700,181,1,12
10947,CARAVAN SQUARE TISSUE BOX,3,844,24,2500,1656,1,48
10948,PLASTERS IN TIN SKULLS,8,1388,18,1900,512,1,36
10949,PLASTERS IN TIN SPACEBOY,3,764,24,2500,1736,1,48
10950,BUTTON BOX ,10,1339,24,2500,1161,1,48
10951,PLASTERS IN TIN VINTAGE PAISLEY ,5,501,13,1400,899,1,26
10952,21 MESSAGE CARDS WITH ENVELOPES,4,2318,23,2400,82,1,46
10953,SMALL RED BABUSHKA NOTEBOOK ,8,451,10,1100,649,1,20
10954,CUPCAKE LACE PAPER SET 15,3,2024,21,2200,176,1,42
10955,PACK 3 BOXES CHRISTMAS PANNETONE,6,1206,14,1500,294,1,28
10956,HERB MARKER MINT,9,1064,18,1900,836,1,36
10957,HERB MARKER ROSEMARY,9,2380,24,2500,120,1,48
10958,HERB MARKER BASIL,4,1478,16,1700,222,1,32
10959,HERB MARKER CHIVES ,3,532,10,1100,568,1,20
10960,HERB MARKER PARSLEY,10,159,3,400,241,1,6
10961,HERB MARKER THYME,9,1002,17,1800,798,1,34
10962,WHITE HANGING HEART T-LIGHT HOLDER,9,858,18,1900,1042,1,36
10963,METAL MERRY CHRISTMAS WREATH,6,2251,22,2300,49,1,44
10964,WHITE CHRISTMAS GARLAND STARS TREES,9,300,2,300,0,1,4
10965,RETROSPOT SMALL TUBE MATCHES,7,1926,19,2000,74,1,38
10966,RETROSPOT GIANT TUBE MATCHES,6,927,14,1500,573,1,28
10967,PLACE SETTING WHITE STAR,2,726,7,800,74,1,14
10968,GROW YOUR OWN BASIL IN ENAMEL MUG,9,1379,13,1400,21,1,26
10969,45 FOIL STAR CAKE CASES ,2,366,6,700,334,1,12
10970,45 FOIL HEART CAKE CASES,3,347,3,400,53,1,6
10971,PACK OF 6 SWEETIE GIFT BOXES,6,142,25,2600,2458,1,50
10972,PACK OF 6 HANDBAG GIFT BOXES,8,244,11,1200,956,1,22
10973,GARLAND WOODEN HAPPY EASTER,5,1503,23,2400,897,1,46
10974,CALENDAR PAPER CUT DESIGN,5,602,16,1700,1098,1,32
10975,CALENDAR IN SEASON DESIGN,5,1303,16,1700,397,1,32
10976,SMALL POPCORN HOLDER,7,330,9,1000,670,1,18
10977,BLUE PAISLEY TISSUE BOX,3,1785,21,2200,415,1,42
10978,HEART OF WICKER SMALL,2,1028,16,1700,672,1,32
10979,SKULLS SQUARE TISSUE BOX,7,449,8,900,451,1,16
10980,SKULLS SQUARE TISSUE BOX,1,370,13,1400,1030,1,26
10981,WHITE HANGING HEART T-LIGHT HOLDER,9,100,0,100,0,1,0
10982,WHITE METAL LANTERN,3,592,22,2300,1708,1,44
10983,CREAM CUPID HEARTS COAT HANGER,2,252,2,300,48,1,4
10984,KNITTED UNION FLAG HOT WATER BOTTLE,9,471,5,600,129,1,10
10985,RED WOOLLY HOTTIE WHITE HEART.,2,1091,25,2600,1509,1,50
10986,SET 7 BABUSHKA NESTING BOXES,9,274,2,300,26,1,4
10987,GLASS STAR FROSTED T-LIGHT HOLDER,3,100,0,100,0,1,0
10988,HAND WARMER UNION JACK,10,958,13,1400,442,1,26
10989,HAND WARMER RED POLKA DOT,10,183,2,300,117,1,4
10990,ASSORTED COLOUR BIRD ORNAMENT,3,526,14,1500,974,1,28
10991,POPPY'S PLAYHOUSE BEDROOM ,1,854,9,1000,146,1,18
10992,POPPY'S PLAYHOUSE KITCHEN,10,835,15,1600,765,1,30
10993,FELTCRAFT PRINCESS CHARLOTTE DOLL,1,346,10,1100,754,1,20
10994,IVORY KNITTED MUG COSY ,2,2188,21,2200,12,1,42
10995,BOX OF 6 ASSORTED COLOUR TEASPOONS,2,1569,25,2600,1031,1,50
10996,BOX OF VINTAGE JIGSAW BLOCKS ,2,186,6,700,514,1,12
10997,BOX OF VINTAGE ALPHABET BLOCKS,5,826,13,1400,574,1,26
10998,HOME BUILDING BLOCK WORD,3,472,8,900,428,1,16
10999,LOVE BUILDING BLOCK WORD,4,509,12,1300,791,1,24
11000,RECIPE BOX WITH METAL HEART,5,143,2,300,157,1,4
11001,DOORMAT NEW ENGLAND,4,959,18,1900,941,1,36
11002,JAM MAKING SET WITH JARS,3,290,3,400,110,1,6
11003,RED COAT RACK PARIS FASHION,7,1504,15,1600,96,1,30
11004,YELLOW COAT RACK PARIS FASHION,2,995,18,1900,905,1,36
11005,BLUE COAT RACK PARIS FASHION,3,160,2,300,140,1,4