,customerId,description,purchase_by_invoice,purchase_total_amount,purchase_streek,next_streek_purchase_amount,remaining_amount,is_eligible_customer,offer_eligibility
0,12346.0,MEDIUM CERAMIC TOP STORAGE JAR,2,2,1,200,198,0,2.0
1,12347.0,ALARM CLOCK BAKELIKE GREEN,7,481,82,8300,7819,1,164.0
2,12348.0,DOUGHNUT LIP GLOSS ,4,178,15,1600,1422,1,30.0
3,12349.0,DOORMAT RED RETROSPOT,1,605,33,3400,2795,1,66.0
4,12350.0,BATHROOM METAL SIGN ,1,65,8,900,835,0,16.0
5,12352.0,WELCOME  WOODEN BLOCK LETTERS,11,2211,48,4900,2689,1,96.0
6,12353.0,MINI CAKE STAND WITH HANGING CAKES,1,24,1,200,176,0,2.0
7,12354.0,BLUE POLKADOT CUP,1,261,31,3200,2939,1,62.0
8,12355.0,OCEAN SCENT CANDLE IN JEWELLED BOX,1,54,7,800,746,0,14.0
9,12356.0,SET/6 RED SPOTTY PAPER PLATES,3,188,29,3000,2812,1,58.0
10,12357.0,ALARM CLOCK BAKELIKE GREEN,1,438,63,6400,5962,1,126.0
11,12358.0,EDWARDIAN PARASOL PINK,2,157,10,1100,943,1,20.0
12,12359.0,LUNCH BAG VINTAGE LEAF DESIGN,6,2225,115,11600,9375,1,230.0
13,12360.0,SET 7 BABUSHKA NESTING BOXES,3,457,70,7100,6643,1,140.0
14,12361.0,ROUND SNACK BOXES SET OF 4 FRUITS ,1,33,6,700,667,0,12.0
15,12362.0,SET 4 PICNIC CUTLERY CHERRY ,13,1083,116,11700,10617,1,232.0
16,12363.0,DOORMAT RED RETROSPOT,2,53,11,1200,1147,0,12.8
17,12364.0,PACK OF 6 SKULL PAPER CUPS,4,162,43,4400,4238,1,86.0
18,12365.0,SPOTTY PINK DUCK DOORSTOP,3,698,13,1400,702,1,26.0
19,12367.0,LETS GO SHOPPING COTTON TOTE BAG,1,35,6,700,665,0,12.0
20,12370.0,CANDLE PLATE LACE WHITE,4,467,78,7900,7433,1,156.0
21,12371.0,LUNCH BAG  BLACK SKULL.,2,244,34,3500,3256,1,68.0
22,12372.0,WRAP SUKI AND FRIENDS,3,156,26,2700,2544,1,52.0
23,12373.0,WOODLAND CHARLOTTE BAG,1,64,6,700,636,0,12.0
24,12374.0,MONEY BOX CONFECTIONERY DESIGN,1,139,21,2200,2061,0,16.7
25,12375.0,WOODLAND CHARLOTTE BAG,3,119,6,700,581,0,12.0
26,12377.0,BIRTHDAY BANNER TAPE,2,209,35,3600,3391,1,70.0
27,12378.0,WRAP SUKI AND FRIENDS,1,656,95,9600,8944,1,190.0
28,12379.0,GREEN POLKADOT BOWL,3,116,19,2000,1884,0,19.6
29,12380.0,PIG KEYRING WITH LIGHT & SOUND ,5,355,63,6400,6045,1,126.0
30,12381.0,GINGERBREAD MAN COOKIE CUTTER,6,417,51,5200,4783,1,102.0
31,12383.0,12 PENCIL SMALL TUBE WOODLAND,6,309,53,5400,5091,1,106.0
32,12384.0,DOORMAT RED RETROSPOT,3,227,16,1700,1473,1,32.0
33,12386.0,PORCELAIN ROSE LARGE ,2,23,5,600,577,0,10.0
34,12388.0,SET OF 6 TEA TIME BAKING CASES,6,277,46,4700,4423,1,92.0
35,12390.0,WRAP SUKI AND FRIENDS,1,127,17,1800,1673,0,14.2
36,12391.0,DOUGHNUT LIP GLOSS ,1,245,54,5500,5255,1,108.0
37,12393.0,LUNCH BAG  BLACK SKULL.,4,145,35,3600,3455,0,27.499999999999996
38,12394.0,GREEN POLKADOT BOWL,2,91,15,1600,1509,0,13.3
39,12395.0,SMALL PURPLE BABUSHKA NOTEBOOK ,15,629,64,6500,5871,1,128.0
40,12397.0,MINI PLAYING CARDS GYMKHANA,2,436,57,5800,5364,1,114.0
41,12398.0,SET OF 36 DOILIES SPACEBOY DESIGN ,1,169,47,4800,4631,1,94.0
42,12399.0,LUNCH BAG  BLACK SKULL.,4,124,29,3000,2876,0,31.1
43,12401.0,RED RETROSPOT CAKE STAND,1,48,3,400,352,0,6.0
44,12402.0,JUMBO BAG DOLLY GIRL DESIGN,1,36,5,600,564,0,10.0
45,12403.0,CHILDRENS CUTLERY POLKADOT GREEN ,2,53,2,300,247,0,4.0
46,12405.0,PLASTERS IN TIN CIRCUS PARADE ,1,191,27,2800,2609,1,54.0
47,12406.0,MINI PLAYING CARDS GYMKHANA,3,305,53,5400,5095,1,106.0
48,12407.0,BISCUITS SMALL BOWL LIGHT BLUE,5,251,40,4100,3849,1,80.0
49,12408.0,LUNCH BAG VINTAGE LEAF DESIGN,9,353,54,5500,5147,1,108.0
50,12409.0,LANTERN CREAM GAZEBO ,7,402,57,5800,5398,1,114.0
51,12410.0,ASSORTED COLOUR MINI CASES,3,176,14,1500,1324,1,28.0
52,12412.0,JAM MAKING SET PRINTED,3,165,32,3300,3135,1,64.0
53,12413.0,SET/6 RED SPOTTY PAPER PLATES,5,210,20,2100,1890,1,40.0
54,12414.0,PARTY METAL SIGN ,3,154,9,1000,846,1,18.0
55,12415.0,LUNCH BAG VINTAGE LEAF DESIGN,26,2499,214,21500,19001,1,428.0
56,12417.0,CANDLE PLATE LACE WHITE,12,1074,91,9200,8126,1,182.0
57,12418.0,PICTURE DOMINOES,1,121,19,2000,1879,0,16.6
58,12420.0,STORAGE TIN VINTAGE DOILY ,1,136,15,1600,1464,0,15.700000000000001
59,12421.0,BANQUET BIRTHDAY  CARD  ,5,204,23,2400,2196,1,46.0
60,12422.0,LUNCH BAG  BLACK SKULL.,3,127,21,2200,2073,0,17.8
61,12423.0,HOMEMADE JAM SCENTED CANDLES,9,365,62,6300,5935,1,124.0
62,12424.0,HEART SHAPED HOLLY WREATH,2,83,17,1800,1717,0,13.9
63,12425.0,RED RETROSPOT PEG BAG,1,92,16,1700,1608,0,17.0
64,12426.0,SPACEBOY LUNCH BOX ,1,118,16,1700,1582,0,17.1
65,12427.0,CHRISTMAS CRAFT WHITE FAIRY ,5,161,20,2100,1939,1,40.0
66,12428.0,SET OF 16 VINTAGE SKY BLUE CUTLERY,12,1418,144,14500,13082,1,288.0
67,12429.0,SET 7 BABUSHKA NESTING BOXES,4,352,50,5100,4748,1,100.0
68,12430.0,PARTY CHARMS 50 PIECES,1,68,6,700,632,0,12.0
69,12431.0,ALARM CLOCK BAKELIKE GREEN,18,902,101,10200,9298,1,202.0
70,12432.0,BLUE HAPPY BIRTHDAY BUNTING,5,1139,50,5100,3961,1,100.0
71,12433.0,TOXIC AREA  DOOR HANGER ,7,920,165,16600,15680,1,330.0
72,12434.0,PINK VINTAGE SPOT BEAKER,4,198,27,2800,2602,1,54.0
73,12435.0,WOODEN CROQUET GARDEN SET,2,197,20,2100,1903,1,40.0
74,12436.0,PACK OF 60 SPACEBOY CAKE CASES,1,84,9,1000,916,0,18.0
75,12437.0,BLUE HAPPY BIRTHDAY BUNTING,19,809,88,8900,8091,1,176.0
76,12438.0,SET 7 BABUSHKA NESTING BOXES,2,381,42,4300,3919,1,84.0
77,12441.0,BLUE SCANDINAVIAN PAISLEY WRAP,1,40,7,800,760,0,14.0
78,12442.0,SET OF 36 PAISLEY FLOWER DOILIES,1,40,4,500,460,0,8.0
79,12444.0,MIRROR CORNICE,5,1119,83,8400,7281,1,166.0
80,12445.0,POSTAGE,1,31,1,200,169,0,2.0
81,12446.0,WOODEN CROQUET GARDEN SET,1,248,31,3200,2952,1,62.0
82,12447.0,GREEN POLKADOT BOWL,1,92,14,1500,1408,0,11.399999999999999
83,12448.0,RED RETROSPOT PEG BAG,1,130,10,1100,970,0,12.399999999999999
84,12449.0,SET 7 BABUSHKA NESTING BOXES,4,705,89,9000,8295,1,178.0
85,12450.0,LUNCH BAG DOILEY PATTERN ,2,12,4,500,488,0,8.0
86,12451.0,LUNCH BAG  BLACK SKULL.,6,868,134,13500,12632,1,268.0
87,12452.0,CHRISTMAS LIGHTS 10 REINDEER,3,99,12,1300,1201,0,11.799999999999999
88,12453.0,RED RETROSPOT PEG BAG,1,102,24,2500,2398,0,23.199999999999992
89,12454.0,FLOWERS CHANDELIER T-LIGHT HOLDER,2,218,16,1700,1482,1,32.0
90,12455.0,LUNCH BAG VINTAGE LEAF DESIGN,6,285,43,4400,4115,1,86.0
91,12456.0,PIG KEYRING WITH LIGHT & SOUND ,4,461,61,6200,5739,1,122.0
92,12457.0,LUNCH BAG VINTAGE LEAF DESIGN,12,352,40,4100,3748,1,80.0
93,12458.0,FELT EGG COSY WHITE RABBIT ,2,164,20,2100,1936,1,40.0
94,12461.0,DOORMAT RED RETROSPOT,2,149,20,2100,1951,0,18.299999999999997
95,12462.0,RETROSPOT LAMP,4,332,38,3900,3568,1,76.0
96,12463.0,ENVELOPE 50 BLOSSOM IMAGES,7,269,45,4600,4331,1,90.0
97,12464.0,BREAD BIN DINER STYLE RED ,8,343,16,1700,1357,1,32.0
98,12465.0,PLASTERS IN TIN CIRCUS PARADE ,3,138,29,3000,2862,0,26.1
99,12468.0,PLASTERS IN TIN CIRCUS PARADE ,3,139,22,2300,2161,0,20.999999999999996
100,12471.0,SET 7 BABUSHKA NESTING BOXES,49,2266,183,18400,16134,1,366.0
101,12472.0,WRAP SUKI AND FRIENDS,13,970,146,14700,13730,1,292.0
102,12473.0,RIBBON REEL POLKADOTS ,9,2437,86,8700,6263,1,172.0
103,12474.0,WRAP SUKI AND FRIENDS,30,1331,171,17200,15869,1,342.0
104,12475.0,12 PENCIL SMALL TUBE WOODLAND,1,105,21,2200,2095,0,16.499999999999996
105,12476.0,RIBBON REEL POLKADOTS ,20,1306,116,11700,10394,1,232.0
106,12477.0,SET OF 16 VINTAGE SKY BLUE CUTLERY,9,1333,133,13400,12067,1,266.0
107,12478.0,GINGERBREAD MAN COOKIE CUTTER,1,163,16,1700,1537,1,32.0
108,12479.0,PACK OF 6 SKULL PAPER CUPS,3,91,17,1800,1709,0,17.5
109,12480.0,WRAP SUKI AND FRIENDS,4,482,77,7800,7318,1,154.0
110,12481.0,LUNCH BAG VINTAGE LEAF DESIGN,11,741,102,10300,9559,1,204.0
111,12483.0,12 PENCILS TALL TUBE WOODLAND,13,484,45,4600,4116,1,90.0
112,12484.0,LUNCH BAG  BLACK SKULL.,8,1114,128,12900,11786,1,256.0
113,12488.0,WHITE SKULL HOT WATER BOTTLE ,3,205,30,3100,2895,1,60.0
114,12489.0,RETROSPOT TEA SET CERAMIC 11 PC ,1,88,9,1000,912,0,18.0
115,12490.0,LUNCH BAG  BLACK SKULL.,10,659,106,10700,10041,1,212.0
116,12491.0,12 PENCIL SMALL TUBE WOODLAND,1,87,17,1800,1713,0,13.2
117,12492.0,12 PENCIL SMALL TUBE WOODLAND,2,66,10,1100,1034,0,20.0
118,12493.0,LUNCH BAG DOILEY PATTERN ,3,111,14,1500,1389,0,12.8
119,12494.0,PACK OF 6 COCKTAIL PARASOL STRAWS,13,351,38,3900,3549,1,76.0
120,12497.0,WRAP SUKI AND FRIENDS,1,28,8,900,872,0,16.0
121,12498.0,SPOTTY PINK DUCK DOORSTOP,3,96,11,1200,1104,0,13.700000000000003
122,12500.0,BAKING MOULD ROSE WHITE CHOCOLATE,13,381,32,3300,2919,1,64.0
123,12501.0,LUNCH BAG  BLACK SKULL.,2,387,81,8200,7813,1,162.0
124,12502.0,ALARM CLOCK BAKELIKE GREEN,5,944,67,6800,5856,1,134.0
125,12503.0,Manual,1,1126,0,100,1026,0,0.0
126,12504.0,SET/10 BLUE POLKADOT PARTY CANDLES,4,141,7,800,659,0,14.0
127,12505.0,Manual,1,4,0,100,96,0,0.0
128,12506.0,SET OF 36 TEATIME PAPER DOILIES,1,73,11,1200,1127,0,22.0
129,12507.0,12 PENCIL SMALL TUBE WOODLAND,4,106,11,1200,1094,0,22.0
130,12508.0,12 PENCIL SMALL TUBE WOODLAND,2,118,35,3600,3482,0,33.300000000000004
131,12509.0,SET 7 BABUSHKA NESTING BOXES,1,38,4,500,462,0,8.0
132,12510.0,ASSORTED COLOUR MINI CASES,2,140,16,1700,1560,0,14.1
133,12512.0,REX CASH+CARRY JUMBO SHOPPER,2,87,18,1900,1813,0,18.2
134,12513.0,WRAP SUKI AND FRIENDS,2,80,17,1800,1720,0,20.900000000000002
135,12514.0,WELCOME  WOODEN BLOCK LETTERS,1,168,26,2700,2532,1,52.0
136,12515.0,EDWARDIAN PARASOL PINK,1,108,8,900,792,0,16.0
137,12516.0,JUMBO BAG SPACEBOY DESIGN,2,70,15,1600,1530,0,13.5
138,12517.0,12 PENCIL SMALL TUBE WOODLAND,6,671,122,12300,11629,1,244.0
139,12518.0,HAND WARMER UNION JACK,5,351,58,5900,5549,1,116.0
140,12519.0,GREEN POLKADOT BOWL,1,53,7,800,747,0,14.0
141,12520.0,BLUE HAPPY BIRTHDAY BUNTING,6,526,69,7000,6474,1,138.0
142,12521.0,DRAWER KNOB CRACKLE GLAZE BLUE,1,113,22,2300,2187,0,20.7
143,12522.0,36 PENCILS TUBE RED RETROSPOT,2,60,5,600,540,0,10.0
144,12523.0,CAKE STAND WHITE TWO TIER LACE,13,567,64,6500,5933,1,128.0
145,12524.0,LUNCH BAG  BLACK SKULL.,8,420,63,6400,5980,1,126.0
146,12526.0,GINGERBREAD MAN COOKIE CUTTER,3,238,36,3700,3462,1,72.0
147,12527.0,WOODLAND CHARLOTTE BAG,3,52,8,900,848,0,10.5
148,12528.0,PINK FAIRY CAKE CUSHION COVER,8,512,47,4800,4288,1,94.0
149,12530.0,DOORMAT RED RETROSPOT,5,264,36,3700,3436,1,72.0
150,12531.0,GINGERBREAD MAN COOKIE CUTTER,1,64,9,1000,936,0,18.0
151,12532.0,CHRISTMAS METAL TAGS ASSORTED ,1,59,10,1100,1041,0,20.0
152,12534.0,PINK VINTAGE SPOT BEAKER,1,191,36,3700,3509,1,72.0
153,12535.0,RED RETROSPOT PEG BAG,2,151,16,1700,1549,1,32.0
154,12536.0,DOORMAT MERRY CHRISTMAS RED ,5,13255,118,11900,1355,1,236.0
155,12538.0,SET OF 4 KNICK KNACK TINS LONDON ,1,76,12,1300,1224,0,14.7
156,12539.0,CERAMIC BIRDHOUSE CRESTED TIT SMALL,5,2856,129,13000,10144,1,258.0
157,12540.0,WRAP SUKI AND FRIENDS,19,1875,155,15600,13725,1,310.0
158,12541.0,TOY TIDY PINK POLKADOT,3,188,22,2300,2112,1,44.0
159,12544.0,ASSORTED COLOUR MINI CASES,2,82,10,1100,1018,0,20.0
160,12545.0,SET/3 POT PLANT CANDLES,2,201,24,2500,2299,1,48.0
161,12546.0,LETS GO SHOPPING COTTON TOTE BAG,3,221,36,3700,3479,1,72.0
162,12547.0,PACK OF 6 HANDBAG GIFT BOXES,2,63,3,400,337,0,6.0
163,12548.0,SET OF 72 PINK HEART PAPER DOILIES,1,33,2,300,267,0,4.0
164,12550.0,ENVELOPE 50 BLOSSOM IMAGES,1,176,28,2900,2724,1,56.0
165,12551.0,JUMBO BAG SCANDINAVIAN PAISLEY,1,16,6,700,684,0,12.0
166,12552.0,DOORMAT RED RETROSPOT,2,182,11,1200,1018,1,22.0
167,12553.0,12 PENCIL SMALL TUBE WOODLAND,14,617,90,9100,8483,1,180.0
168,12556.0,DECORATIVE WICKER HEART LARGE,2,322,57,5800,5478,1,114.0
169,12557.0,LUNCH BAG  BLACK SKULL.,5,71,23,2400,2329,0,18.0
170,12558.0,TEA PARTY BIRTHDAY CARD,2,27,12,1300,1273,0,11.099999999999998
171,12559.0,BOX OF 24 COCKTAIL PARASOLS,3,87,9,1000,913,0,13.3
172,12560.0,LUNCH BAG VINTAGE LEAF DESIGN,4,315,56,5700,5385,1,112.0
173,12561.0,SET/3 POLKADOT STACKING TINS,1,47,9,1000,953,0,18.0
174,12562.0,SET 7 BABUSHKA NESTING BOXES,7,535,79,8000,7465,1,158.0
175,12564.0,FOLDING UMBRELLA PINKWHITE POLKADOT,1,117,12,1300,1183,0,12.5
176,12565.0,PLASTERS IN TIN CIRCUS PARADE ,2,24,5,600,576,0,10.0
177,12566.0,POSTAGE,2,79,12,1300,1221,0,24.0
178,12567.0,LUNCH BAG VINTAGE LEAF DESIGN,11,1557,165,16600,15043,1,330.0
179,12569.0,STRAWBERRY HONEYCOMB  GARLAND ,35,1061,90,9100,8039,1,180.0
180,12571.0,SET/6 RED SPOTTY PAPER PLATES,2,44,19,2000,1956,0,14.7
181,12572.0,ENVELOPE 50 BLOSSOM IMAGES,3,269,30,3100,2831,1,60.0
182,12573.0,RED RETROSPOT SUGAR JAM BOWL,1,58,15,1600,1542,0,13.1
183,12574.0,RECIPE BOX PANTRY YELLOW DESIGN,1,57,5,600,543,0,10.0
184,12576.0,HERB MARKER PARSLEY,6,214,44,4500,4286,1,88.0
185,12577.0,DOUGHNUT LIP GLOSS ,4,274,76,7700,7426,1,152.0
186,12578.0,GREY HEART HOT WATER BOTTLE,4,372,58,5900,5528,1,116.0
187,12579.0,WRAP ENGLISH ROSE ,3,116,18,1900,1784,0,18.300000000000004
188,12580.0,LUNCH BAG  BLACK SKULL.,1,62,11,1200,1138,0,10.299999999999999
189,12581.0,ZINC BOX SIGN HOME,1,43,7,800,757,0,14.0
190,12582.0,BLUE POLKADOT CUP,2,115,15,1600,1485,0,30.0
191,12583.0,PAPER BUNTING VINTAGE PARTY,18,791,117,11800,11009,1,234.0
192,12584.0,WELCOME  WOODEN BLOCK LETTERS,18,938,58,5900,4962,1,116.0
193,12585.0,60 TEATIME FAIRY CAKE CASES,4,339,45,4600,4261,1,90.0
194,12586.0,RETROSPOT TEA SET CERAMIC 11 PC ,2,54,5,600,546,0,10.0
195,12587.0,POSTAGE,1,46,1,200,154,0,2.0
196,12588.0,CHRISTMAS LIGHTS 10 REINDEER,1,95,6,700,605,0,12.0
197,12589.0,SET OF 6 TEA TIME BAKING CASES,2,157,16,1700,1543,1,32.0
198,12590.0,RED RETROSPOT PEG BAG,3,718,41,4200,3482,1,82.0
199,12591.0,FELT EGG COSY WHITE RABBIT ,1,98,11,1200,1102,0,14.800000000000002
200,12592.0,WOODLAND CHARLOTTE BAG,2,59,13,1400,1341,0,26.0
201,12593.0,LUNCH BAG  BLACK SKULL.,3,55,9,1000,945,0,12.700000000000001
202,12594.0,GINGERBREAD MAN COOKIE CUTTER,11,374,61,6200,5826,1,122.0
203,12596.0,BOX OF 24 COCKTAIL PARASOLS,2,118,15,1600,1482,0,13.3
204,12597.0,ALARM CLOCK BAKELIKE GREEN,5,852,98,9900,9048,1,196.0
205,12598.0,DOUGHNUT LIP GLOSS ,9,376,69,7000,6624,1,138.0
206,12599.0,PACK OF 6 SKULL PAPER CUPS,7,185,36,3700,3515,1,72.0
207,12600.0,BLACK/BLUE POLKADOT UMBRELLA,11,368,39,4000,3632,1,78.0
208,12601.0,JAM MAKING SET PRINTED,6,189,11,1200,1011,1,22.0
209,12602.0,MINI PLAYING CARDS SPACEBOY ,1,23,6,700,677,0,12.0
210,12603.0,POSTAGE,1,28,1,200,172,0,2.0
211,12604.0,PACK OF 72 RETROSPOT CAKE CASES,2,41,8,900,859,0,16.0
212,12605.0,WOODLAND PARTY BAG + STICKER SET,1,5,1,200,195,0,2.0
213,12607.0,BLUE HAPPY BIRTHDAY BUNTING,2,435,89,9000,8565,1,178.0
214,12609.0,RECYCLED ACAPULCO MAT GREEN,3,211,32,3300,3089,1,64.0
215,12610.0,LANTERN CREAM GAZEBO ,7,545,53,5400,4855,1,106.0
216,12611.0,GINGERBREAD MAN COOKIE CUTTER,1,173,31,3200,3027,1,62.0
217,12612.0,ANT COPPER LIME BOUDICCA BRACELET,2,94,14,1500,1406,0,28.0
218,12613.0,BLUE HAPPY BIRTHDAY BUNTING,6,477,74,7500,7023,1,148.0
219,12614.0,WHITE SKULL HOT WATER BOTTLE ,1,112,10,1100,988,0,20.0
220,12615.0,HOMEMADE JAM SCENTED CANDLES,4,324,56,5700,5376,1,112.0
221,12616.0,PICTURE DOMINOES,5,145,19,2000,1855,0,20.0
222,12617.0,REX CASH+CARRY JUMBO SHOPPER,1,79,25,2600,2521,0,22.5
223,12618.0,PRETTY HANGING QUILTED HEARTS,1,73,4,500,427,0,8.0
224,12619.0,SET OF 6 TEA TIME BAKING CASES,13,1030,50,5100,4070,1,100.0
225,12620.0,SMALL PURPLE BABUSHKA NOTEBOOK ,3,197,45,4600,4403,1,90.0
226,12621.0,12 PENCIL SMALL TUBE WOODLAND,23,1373,162,16300,14927,1,324.0
227,12622.0,RETROSPOT TEA SET CERAMIC 11 PC ,1,63,7,800,737,0,14.0
228,12623.0,WOODLAND CHARLOTTE BAG,1,47,12,1300,1253,0,11.6
229,12624.0,LETS GO SHOPPING COTTON TOTE BAG,2,147,23,2400,2253,0,19.8
230,12625.0,LUNCH BAG VINTAGE LEAF DESIGN,3,210,50,5100,4890,1,100.0
231,12626.0,SET OF 4 POLKADOT PLACEMATS ,13,872,129,13000,12128,1,258.0
232,12627.0,LUNCH BAG  BLACK SKULL.,7,675,108,10900,10225,1,216.0
233,12628.0,SET 7 BABUSHKA NESTING BOXES,4,158,20,2100,1942,1,40.0
234,12630.0,"SWISS ROLL TOWEL, CHOCOLATE  SPOTS",2,287,32,3300,3013,1,64.0
235,12631.0,PINK VINTAGE SPOT BEAKER,1,140,14,1500,1360,0,14.600000000000001
236,12633.0,SPOTTY PINK DUCK DOORSTOP,5,327,59,6000,5673,1,118.0
237,12635.0,BISCUIT TIN 50'S CHRISTMAS,2,254,51,5200,4946,1,102.0
238,12637.0,LUNCH BAG  BLACK SKULL.,10,1060,162,16300,15240,1,324.0
239,12638.0,12 PENCIL SMALL TUBE WOODLAND,1,99,19,2000,1901,0,19.300000000000004
240,12639.0,WOODEN CROQUET GARDEN SET,1,108,13,1400,1292,0,13.499999999999998
241,12640.0,JAM MAKING SET PRINTED,3,302,27,2800,2498,1,54.0
242,12641.0,PLASTERS IN TIN CIRCUS PARADE ,1,69,5,600,531,0,10.0
243,12642.0,PACK OF 6 SKULL PAPER CUPS,3,168,25,2600,2432,1,50.0
244,12643.0,PACK OF 72 RETROSPOT CAKE CASES,6,124,10,1100,976,0,11.799999999999997
245,12644.0,SET OF 6 TEA TIME BAKING CASES,1,86,16,1700,1614,0,15.0
246,12645.0,LUNCH BAG VINTAGE LEAF DESIGN,5,192,39,4000,3808,1,78.0
247,12646.0,SET 4 PICNIC CUTLERY CHERRY ,2,107,24,2500,2393,0,22.8
248,12647.0,LUNCH BAG PINK POLKADOT,13,696,63,6400,5704,1,126.0
249,12648.0,GREEN POLKADOT BOWL,1,66,12,1300,1234,0,24.0
250,12649.0,GINGERBREAD MAN COOKIE CUTTER,4,86,16,1700,1614,0,16.60000000000001
251,12650.0,SET 7 BABUSHKA NESTING BOXES,1,38,13,1400,1362,0,10.499999999999998
252,12651.0,RETRO PLASTIC POLKA TRAY,1,20,4,500,480,0,8.0
253,12652.0,WOODEN CROQUET GARDEN SET,2,144,32,3300,3156,0,27.4
254,12653.0,SPACEBOY LUNCH BOX ,2,111,23,2400,2289,0,19.100000000000005
255,12654.0,PLASTERS IN TIN CIRCUS PARADE ,5,167,20,2100,1933,1,40.0
256,12656.0,LUNCH BAG  BLACK SKULL.,8,582,61,6200,5618,1,122.0
257,12657.0,WRAP I LOVE LONDON ,5,284,29,3000,2716,1,58.0
258,12658.0,SET OF 4 POLKADOT PLACEMATS ,1,148,21,2200,2052,0,16.8
259,12659.0,BELLE JARDINIERE CUSHION COVER,1,26,1,200,174,0,2.0
260,12660.0,GINGERBREAD MAN COOKIE CUTTER,1,50,6,700,650,0,12.0
261,12662.0,RECYCLED PENCIL WITH RABBIT ERASER,12,741,105,10600,9859,1,210.0
262,12664.0,BLUE 3 PIECE POLKADOT CUTLERY SET,10,428,17,1800,1372,1,34.0
263,12665.0,POSTAGE,2,21,3,400,379,0,6.0
264,12666.0,ENCHANTED BIRD COATHANGER 5 HOOK,1,8,0,100,92,0,0.0
265,12667.0,FRENCH PAISLEY CUSHION COVER ,1,119,15,1600,1481,0,12.899999999999995
266,12668.0,WHITE SKULL HOT WATER BOTTLE ,6,571,81,8200,7629,1,162.0
267,12669.0,ALARM CLOCK BAKELIKE GREEN,4,2524,52,5300,2776,1,104.0
268,12670.0,GINGERBREAD MAN COOKIE CUTTER,6,300,46,4700,4400,1,92.0
269,12672.0,CERAMIC HEART FAIRY CAKE MONEY BANK,1,37,5,600,563,0,10.0
270,12673.0,"FEATHER PEN,LIGHT PINK",2,122,22,2300,2178,0,21.8
271,12674.0,PACK OF 6 SKULL PAPER CUPS,7,290,46,4700,4410,1,92.0
272,12676.0,BLUE HAPPY BIRTHDAY BUNTING,6,316,22,2300,1984,1,44.0
273,12678.0,ALARM CLOCK BAKELIKE GREEN,13,1084,80,8100,7016,1,160.0
274,12679.0,BLUE POLKADOT CUP,9,215,28,2900,2685,1,56.0
275,12680.0,BUNDLE OF 3 SCHOOL EXERCISE BOOKS  ,4,189,30,3100,2911,1,60.0
276,12681.0,12 PENCIL SMALL TUBE WOODLAND,27,2061,209,21000,18939,1,418.0
277,12682.0,LUNCH BAG VINTAGE LEAF DESIGN,31,1968,189,19000,17032,1,378.0
278,12683.0,SET 7 BABUSHKA NESTING BOXES,20,1018,147,14800,13782,1,294.0
279,12684.0,BUNDLE OF 3 SCHOOL EXERCISE BOOKS  ,7,266,54,5500,5234,1,108.0
280,12685.0,SET OF 36 DOILIES SPACEBOY DESIGN ,6,482,83,8400,7918,1,166.0
281,12686.0,CHARLOTTE BAG DOLLY GIRL DESIGN,1,22,2,300,278,0,4.0
282,12688.0,HEART DECORATION RUSTIC HANGING ,1,705,88,8900,8195,1,176.0
283,12689.0,PAPERWEIGHT SAVE THE PLANET,2,205,40,4100,3895,1,80.0
284,12690.0,LUNCH BAG APPLE DESIGN,1,88,8,900,812,0,16.0
285,12691.0,EASTER TIN BUNNY BOUQUET,6,161,18,1900,1739,1,36.0
286,12693.0,JAM MAKING SET PRINTED,6,225,23,2400,2175,1,46.0
287,12694.0,SKULL AND CROSSBONES  GARLAND ,2,144,18,1900,1756,0,20.899999999999995
288,12695.0,SPOTTY PINK DUCK DOORSTOP,4,129,14,1500,1371,0,13.600000000000001
289,12697.0,SET OF 6 TEA TIME BAKING CASES,5,210,21,2200,1990,1,42.0
290,12700.0,PIG KEYRING WITH LIGHT & SOUND ,6,738,117,11800,11062,1,234.0
291,12701.0,SET OF 6 TEA TIME BAKING CASES,2,163,29,3000,2837,1,58.0
292,12702.0,HOT WATER BOTTLE I AM SO POORLY,1,65,7,800,735,0,14.0
293,12703.0,GREEN POLKADOT BOWL,2,58,11,1200,1142,0,10.1
294,12704.0,ENVELOPE 50 BLOSSOM IMAGES,10,645,42,4300,3655,1,84.0
295,12705.0,WRAP SUKI AND FRIENDS,14,984,142,14300,13316,1,284.0
296,12707.0,WOODEN CROQUET GARDEN SET,1,106,16,1700,1594,0,20.299999999999997
297,12708.0,SET OF 16 VINTAGE SKY BLUE CUTLERY,16,724,79,8000,7276,1,158.0
298,12709.0,BLUE HAPPY BIRTHDAY BUNTING,26,966,104,10500,9534,1,208.0
299,12710.0,LUNCH BAG  BLACK SKULL.,4,227,37,3800,3573,1,74.0
300,12712.0,12 PENCIL SMALL TUBE WOODLAND,17,939,71,7200,6261,1,142.0
301,12713.0,PLASTERS IN TIN CIRCUS PARADE ,1,95,21,2200,2105,0,17.299999999999997
302,12714.0,LUNCH BAG  BLACK SKULL.,5,619,116,11700,11081,1,232.0
303,12715.0,TOY TIDY PINK POLKADOT,1,71,10,1100,1029,0,11.4
304,12716.0,PACK OF 6 SKULL PAPER CUPS,2,183,37,3800,3617,1,74.0
305,12717.0,JAM MAKING SET PRINTED,3,306,30,3100,2794,1,60.0
306,12718.0,CHRISTMAS CRAFT WHITE FAIRY ,1,51,9,1000,949,0,12.3
307,12719.0,PICTURE DOMINOES,3,149,21,2200,2051,0,24.099999999999994
308,12720.0,12 PENCIL SMALL TUBE WOODLAND,29,987,143,14400,13413,1,286.0
309,12721.0,JUMBO BAG RED RETROSPOT,7,509,82,8300,7791,1,164.0
310,12722.0,DRAWER KNOB CRACKLE GLAZE BLUE,6,251,30,3100,2849,1,60.0
311,12723.0,FLOWER VINE RAFFIA FOOD COVER,5,220,32,3300,3080,1,64.0
312,12724.0,LUNCH BAG VINTAGE LEAF DESIGN,4,197,33,3400,3203,1,66.0
313,12725.0,ROSE SCENT CANDLE IN JEWELLED BOX,1,98,14,1500,1402,0,13.400000000000002
314,12726.0,PACK OF 6 SKULL PAPER CUPS,7,261,64,6500,6239,1,128.0
315,12727.0,12 PENCILS SMALL TUBE RED RETROSPOT,9,466,70,7100,6634,1,140.0
316,12728.0,WOODEN CROQUET GARDEN SET,4,214,26,2700,2486,1,52.0
317,12729.0,MR ROBOT SOFT TOY,1,96,13,1400,1304,0,11.9
318,12731.0,LUNCH BAG  BLACK SKULL.,14,930,127,12800,11870,1,254.0
319,12732.0,CHILDRENS CUTLERY DOLLY GIRL ,1,42,5,600,558,0,10.0
320,12733.0,COTTON APRON PANTRY DESIGN,1,74,11,1200,1126,0,12.6
321,12734.0,METAL SIGN CUPCAKE SINGLE HOOK,1,4,1,200,196,0,2.0
322,12735.0,WOODEN CROQUET GARDEN SET,2,232,21,2200,1968,1,42.0
323,12736.0,POSTAGE,1,22,1,200,178,0,2.0
324,12738.0,SWEETHEART CAKESTAND 3 TIER,1,43,6,700,657,0,12.0
325,12739.0,SET OF 6 TEA TIME BAKING CASES,2,152,20,2100,1948,1,40.0
326,12740.0,PACK OF 6 SKULL PAPER CUPS,1,55,15,1600,1545,0,12.5
327,12743.0,LUNCH BAG VINTAGE LEAF DESIGN,2,407,60,6100,5693,1,120.0
328,12744.0,DOORMAT MERRY CHRISTMAS RED ,10,25108,100,10100,15008,1,200.0
329,12747.0,WOODEN CROQUET GARDEN SET,11,449,50,5100,4651,1,100.0
330,12748.0,LUNCH BAG VINTAGE LEAF DESIGN,224,15115,277,27800,12685,1,554.0
331,12749.0,LUNCH BAG VINTAGE LEAF DESIGN,8,1171,107,10800,9629,1,214.0
332,12750.0,WRAP SUKI AND FRIENDS,1,69,9,1000,931,0,18.0
333,12752.0,DOORMAT RED RETROSPOT,1,121,24,2500,2379,0,29.400000000000006
334,12753.0,PAPER BUNTING WHITE LACE,11,536,113,11400,10864,1,226.0
335,12754.0,FELT FARM ANIMAL CHICKEN,5,132,36,3700,3568,0,38.0
336,12755.0,ROSE COTTAGE KEEPSAKE BOX ,4,40,4,500,460,0,8.0
337,12756.0,KIDS RAIN MAC PINK,1,2,2,300,298,0,4.0
338,12757.0,12 PENCIL SMALL TUBE WOODLAND,19,8035,149,15000,6965,1,298.0
339,12758.0,WRAP SUKI AND FRIENDS,2,164,53,5400,5236,1,106.0
340,12759.0,SPACEBOY BIRTHDAY CARD,3,305,52,5300,4995,1,104.0
341,12762.0,GINGERBREAD MAN COOKIE CUTTER,2,188,33,3400,3212,1,66.0
342,12763.0,"FANCY FONT BIRTHDAY CARD, ",2,31,9,1000,969,0,18.0
343,12764.0,GINGERBREAD MAN COOKIE CUTTER,1,242,22,2300,2058,1,44.0
344,12766.0,GRAND CHOCOLATECANDLE,7,951,126,12700,11749,1,252.0
345,12769.0,RECYCLED ACAPULCO MAT GREEN,1,142,17,1800,1658,0,17.4
346,12770.0,PACK OF 20 SPACEBOY NAPKINS,1,31,6,700,669,0,12.0
347,12772.0,12 PENCILS TALL TUBE WOODLAND,1,203,31,3200,2997,1,62.0
348,12775.0,ENVELOPE 50 BLOSSOM IMAGES,6,257,35,3600,3343,1,70.0
349,12778.0,PACK OF 6 SKULL PAPER CUPS,7,193,30,3100,2907,1,60.0
350,12779.0,HEART OF WICKER SMALL,12,586,73,7400,6814,1,146.0
351,12781.0,WOODEN TREE CHRISTMAS SCANDINAVIAN,5,88,17,1800,1712,0,14.9
352,12782.0,60 TEATIME FAIRY CAKE CASES,6,405,59,6000,5595,1,118.0
353,12783.0,WOODEN TREE CHRISTMAS SCANDINAVIAN,8,1649,51,5200,3551,1,102.0
354,12784.0,JUMBO BAG VINTAGE DOILY ,2,165,31,3200,3035,1,62.0
355,12785.0,SET OF 3 NOTEBOOKS IN PARCEL,2,69,7,800,731,0,14.0
356,12787.0,JUMBO BAG VINTAGE DOILY ,3,79,12,1300,1221,0,10.599999999999998
357,12789.0,SUNSET COLOUR CHUNKY KNITTED THROW,1,91,2,300,209,0,4.0
358,12790.0,MINI JIGSAW CIRCUS PARADE ,1,82,9,1000,918,0,18.0
359,12791.0,POSTAGE,1,16,0,100,84,0,0.0
360,12792.0,WOODEN CROQUET GARDEN SET,1,87,10,1100,1013,0,14.400000000000002
361,12793.0,LUNCH BAG RED RETROSPOT,2,93,10,1100,1007,0,15.2
362,12794.0,JAM MAKING SET PRINTED,2,93,23,2400,2307,0,25.3
363,12795.0,WOODEN ADVENT CALENDAR RED,1,107,7,800,693,0,14.0
364,12797.0,BOX OF VINTAGE JIGSAW BLOCKS ,3,75,9,1000,925,0,10.1
365,12798.0,SET 12 KIDS COLOUR  CHALK STICKS,3,8,4,500,492,0,8.0
366,12802.0,TROPICAL PASSPORT COVER ,2,64,16,1700,1636,0,12.8
367,12808.0,RED RETROSPOT PEG BAG,3,113,14,1500,1387,0,13.900000000000002
368,12809.0,PLASTERS IN TIN CIRCUS PARADE ,2,115,14,1500,1385,0,11.9
369,12811.0,TREASURE ISLAND BOOK BOX,3,127,15,1600,1473,0,12.399999999999999
370,12812.0,SET OF 6 TEA TIME BAKING CASES,1,31,7,800,769,0,14.0
371,12814.0,POSTAGE,1,41,1,200,159,0,2.0
372,12815.0,SET OF 16 VINTAGE SKY BLUE CUTLERY,2,253,28,2900,2647,1,56.0
373,12816.0,RECIPE BOX PANTRY YELLOW DESIGN,2,256,14,1500,1244,1,28.0
374,12817.0,POSTAGE,1,48,2,300,252,0,4.0
375,12818.0,SET 12 KIDS COLOUR  CHALK STICKS,2,101,6,700,599,0,12.0
376,12820.0,SET OF 6 TEA TIME BAKING CASES,4,112,25,2600,2488,0,28.799999999999994
377,12821.0,SET 7 BABUSHKA NESTING BOXES,1,14,3,400,386,0,6.0
378,12822.0,LUNCH BAG RED RETROSPOT,3,138,22,2300,2162,0,26.4
379,12823.0,DOORMAT UNION FLAG,5,38,1,200,162,0,2.0
380,12824.0,SET 6 PAPER TABLE LANTERN STARS ,1,63,15,1600,1537,0,10.299999999999999
381,12826.0,WRAP SUKI AND FRIENDS,8,180,44,4500,4320,1,88.0
382,12827.0,POLYESTER FILLER PAD 30CMx30CM,3,71,13,1400,1329,0,15.000000000000002
383,12828.0,SPOTTY PINK DUCK DOORSTOP,6,173,27,2800,2627,1,54.0
384,12829.0,CHEST OF DRAWERS GINGHAM HEART ,3,154,7,800,646,1,14.0
385,12830.0,HEADS AND TAILS SPORTING FUN,7,107,20,2100,1993,0,20.500000000000004
386,12831.0,SET OF 4 NAPKIN CHARMS 3 KEYS ,1,27,4,500,473,0,8.0
387,12832.0,IVORY LOVE BIRD CANDLE,2,79,13,1400,1321,0,12.3
388,12833.0,CANDLE PLATE LACE WHITE,1,130,15,1600,1470,0,13.100000000000003
389,12834.0,6 EGG HOUSE PAINTED WOOD,1,88,9,1000,912,0,18.0
390,12836.0,MIRROR CORNICE,4,750,77,7800,7050,1,154.0
391,12837.0,RETROSPOT TEA SET CERAMIC 11 PC ,1,80,6,700,620,0,12.0
392,12838.0,RIBBON REEL SNOWY VILLAGE,2,285,64,6500,6215,1,128.0
393,12839.0,WRAP SUKI AND FRIENDS,16,609,135,13600,12991,1,270.0
394,12840.0,LUNCH BAG  BLACK SKULL.,6,237,58,5900,5663,1,116.0
395,12841.0,BLUE HAPPY BIRTHDAY BUNTING,26,1045,161,16200,15155,1,322.0
396,12842.0,HERB MARKER PARSLEY,2,147,17,1800,1653,0,19.599999999999998
397,12843.0,BLUE GIANT GARDEN THERMOMETER,9,368,49,5000,4632,1,98.0
398,12844.0,SET OF 6 TEA TIME BAKING CASES,2,136,28,2900,2764,0,22.999999999999993
399,12845.0,GINGERBREAD MAN COOKIE CUTTER,4,75,14,1500,1425,0,12.4
400,12847.0,WOODEN TREE CHRISTMAS SCANDINAVIAN,1,121,42,4300,4179,0,49.400000000000006
401,12849.0,HOT WATER BOTTLE I AM SO POORLY,2,147,21,2200,2053,0,24.500000000000004
402,12851.0,REX CASH+CARRY JUMBO SHOPPER,1,97,26,2700,2603,0,24.5
403,12852.0,SET OF 36 PAISLEY FLOWER DOILIES,2,70,10,1100,1030,0,20.0
404,12853.0,GINGERBREAD MAN COOKIE CUTTER,9,357,48,4900,4543,1,96.0
405,12854.0,DECORATIVE WICKER HEART LARGE,5,340,53,5400,5060,1,106.0
406,12855.0,JAM JAR WITH GREEN LID,1,4,1,200,196,0,2.0
407,12856.0,LUNCH BAG  BLACK SKULL.,8,815,125,12600,11785,1,250.0
408,12857.0,JAM MAKING SET PRINTED,2,190,24,2500,2310,1,48.0
409,12863.0,SWEETHEART CERAMIC TRINKET BOX,2,25,4,500,475,0,8.0
410,12864.0,SANDALWOOD FAN,1,1,1,200,199,0,2.0
411,12865.0,IVORY SWEETHEART WIRE LETTER RACK ,3,296,48,4900,4604,1,96.0
412,12866.0,DOORMAT RED RETROSPOT,1,114,13,1400,1286,0,11.700000000000001
413,12867.0,LUNCH BAG  BLACK SKULL.,10,738,189,19000,18262,1,378.0
414,12868.0,GINGERBREAD MAN COOKIE CUTTER,6,279,50,5100,4821,1,100.0
415,12870.0,LANTERN CREAM GAZEBO ,1,14,1,200,186,0,2.0
416,12871.0,HANGING JAM JAR T-LIGHT HOLDER,2,23,5,600,577,0,10.0
417,12872.0,REX CASH+CARRY JUMBO SHOPPER,2,164,35,3600,3436,1,70.0
418,12873.0,PAPER CHAIN KIT VINTAGE CHRISTMAS,1,16,2,300,284,0,4.0
419,12875.0,ASSORTED LAQUERED INCENSE HOLDERS,2,0,1,200,200,0,2.0
420,12876.0,ENVELOPE 50 BLOSSOM IMAGES,2,191,45,4600,4409,1,90.0
421,12877.0,HOMEMADE JAM SCENTED CANDLES,12,292,76,7700,7408,1,152.0
422,12878.0,RED RETROSPOT PEG BAG,3,98,24,2500,2402,0,25.099999999999998
423,12879.0,CHARLOTTE BAG PINK POLKADOT,4,24,7,800,776,0,14.0
424,12881.0,CAT BOWL VINTAGE CREAM,1,230,5,600,370,1,10.0
425,12882.0,DOORMAT RED RETROSPOT,2,83,7,800,717,0,14.0
426,12883.0,DOORMAT RED RETROSPOT,4,248,22,2300,2052,1,44.0
427,12884.0,JUMBO BAG PEARS,1,111,3,400,289,0,6.0
428,12885.0,SET OF 6 TEA TIME BAKING CASES,4,272,33,3400,3128,1,66.0
429,12886.0,GINGERBREAD MAN COOKIE CUTTER,3,322,46,4700,4378,1,92.0
430,12888.0,HEART SHAPE WIRELESS DOORBELL,4,41,3,400,359,0,6.0
431,12890.0,RIBBON REEL POLKADOTS ,1,148,40,4100,3952,0,43.10000000000001
432,12891.0,RED RETROSPOT WRAP ,3,1,1,200,199,0,2.0
433,12893.0,SET OF 6 TEA TIME BAKING CASES,1,75,19,2000,1925,0,16.399999999999995
434,12895.0,HOMEMADE JAM SCENTED CANDLES,3,79,13,1400,1321,0,11.600000000000003
435,12897.0,HEART OF WICKER LARGE,2,10,1,200,190,0,2.0
436,12901.0,GINGERBREAD MAN COOKIE CUTTER,36,189,64,6500,6311,1,128.0
437,12902.0,EMPIRE BIRTHDAY CARD,1,56,6,700,644,0,12.0
438,12904.0,CARD HOLDER LOVE BIRD SMALL,2,222,38,3900,3678,1,76.0
439,12906.0,BUNDLE OF 3 SCHOOL EXERCISE BOOKS  ,5,160,38,3900,3740,1,76.0
440,12908.0,ASSORTED COLOURS SILK FAN,4,2,2,300,298,0,4.0
441,12909.0,BLUE HAPPY BIRTHDAY BUNTING,8,642,48,4900,4258,1,96.0
442,12910.0,PICTURE DOMINOES,8,156,39,4000,3844,1,78.0
443,12912.0,TREASURE ISLAND BOOK BOX,5,65,13,1400,1335,0,11.599999999999998
444,12913.0,CHRISTMAS CRAFT WHITE FAIRY ,5,146,26,2700,2554,0,24.000000000000004
445,12915.0,REGENCY CAKESTAND 3 TIER,2,149,9,1000,851,0,11.4
446,12916.0,BLUE GIANT GARDEN THERMOMETER,5,450,52,5300,4850,1,104.0
447,12917.0,EDWARDIAN PARASOL BLACK,1,9,1,200,191,0,2.0
448,12919.0,RIBBON REEL SNOWY VILLAGE,8,144,27,2800,2656,0,26.500000000000004
449,12920.0,MIRRORED WALL ART LADIES,1,107,14,1500,1393,0,11.799999999999999
450,12921.0,LUNCH BAG  BLACK SKULL.,50,1772,218,21900,20128,1,436.0
451,12922.0,PACK OF 6 SKULL PAPER CUPS,1,45,18,1900,1855,0,11.700000000000001
452,12923.0,PICTURE DOMINOES,1,85,15,1600,1515,0,13.699999999999996
453,12924.0,JAM MAKING SET PRINTED,5,99,15,1600,1501,0,16.7
454,12925.0,PLAYING CARDS KEEP CALM & CARRY ON,2,103,25,2600,2497,0,21.69999999999999
455,12928.0,12 PENCIL SMALL TUBE WOODLAND,5,163,43,4400,4237,1,86.0
456,12929.0,WOODEN CROQUET GARDEN SET,2,69,5,600,531,0,10.0
457,12930.0,ZINC WILLIE WINKIE  CANDLE STICK,4,80,15,1600,1520,0,13.299999999999997
458,12931.0,GLITTER HANGING BUTTERFLY STRING,20,175,51,5200,5025,1,102.0
459,12933.0,SET 7 BABUSHKA NESTING BOXES,4,281,47,4800,4519,1,94.0
460,12935.0,SMALL PURPLE BABUSHKA NOTEBOOK ,8,266,63,6400,6134,1,126.0
461,12936.0,12 PENCIL SMALL TUBE WOODLAND,5,128,35,3600,3472,0,34.99999999999999
462,12937.0,LUNCH BAG  BLACK SKULL.,4,284,64,6500,6216,1,128.0
463,12938.0,GLITTER CHRISTMAS TREE WITH BELLS,1,11,3,400,389,0,6.0
464,12939.0,BLUE POLKADOT CUP,8,112,23,2400,2288,0,22.699999999999996
465,12940.0,DECORATIVE WICKER HEART LARGE,4,411,55,5600,5189,1,110.0
466,12942.0,LUNCH BAG  BLACK SKULL.,3,310,41,4200,3890,1,82.0
467,12943.0,FELTCRAFT CUSHION BUTTERFLY,1,3,0,100,97,0,0.0
468,12944.0,PICTURE DOMINOES,2,95,14,1500,1405,0,17.7
469,12945.0,SWEETHEART CAKESTAND 3 TIER,1,113,11,1200,1087,0,11.9
470,12947.0,LUNCH BAG  BLACK SKULL.,11,438,46,4700,4262,1,92.0
471,12948.0,LUNCH BAG  BLACK SKULL.,8,347,62,6300,5953,1,124.0
472,12949.0,LUNCH BAG  BLACK SKULL.,10,625,106,10700,10075,1,212.0
473,12950.0,WOODLAND CHARLOTTE BAG,3,31,12,1300,1269,0,13.3
474,12951.0,JUMBO BAG VINTAGE DOILY ,8,204,37,3800,3596,1,74.0
475,12952.0,GINGERBREAD MAN COOKIE CUTTER,5,325,41,4200,3875,1,82.0
476,12953.0,4 PINK DINNER CANDLE SILVER FLOCK,1,113,10,1100,987,0,20.0
477,12955.0,CHRISTMAS CRAFT WHITE FAIRY ,14,310,88,8900,8590,1,176.0
478,12956.0,HEART OF WICKER SMALL,1,82,10,1100,1018,0,10.399999999999999
479,12957.0,12 PENCIL SMALL TUBE WOODLAND,12,691,105,10600,9909,1,210.0
480,12962.0,SPACEBOY CHILDRENS CUP,2,47,8,900,853,0,16.0
481,12963.0,GINGHAM HEART  DOORSTOP RED,9,314,51,5200,4886,1,102.0
482,12965.0,LUNCH BAG VINTAGE LEAF DESIGN,1,399,59,6000,5601,1,118.0
483,12966.0,4 PEAR BOTANICAL DINNER CANDLES,1,34,6,700,666,0,12.0
484,12967.0,ASSORTED COLOUR MINI CASES,4,189,18,1900,1711,1,36.0
485,12968.0,POLYESTER FILLER PAD 40x40cm,1,16,2,300,284,0,4.0
486,12970.0,WHITE SKULL HOT WATER BOTTLE ,4,306,79,8000,7694,1,158.0
487,12971.0,BLUE HAPPY BIRTHDAY BUNTING,89,714,124,12500,11786,1,248.0
488,12974.0,DOORMAT RED RETROSPOT,1,61,4,500,439,0,8.0
489,12976.0,LUNCH BAG  BLACK SKULL.,1,33,12,1300,1267,0,24.0
490,12977.0,YELLOW/PINK FLOWER DESIGN BIG MUG,1,38,5,600,562,0,10.0
491,12980.0,BLACK RECORD COVER FRAME,12,396,15,1600,1204,1,30.0
492,12981.0,WOODLAND CHARLOTTE BAG,2,32,11,1200,1168,0,12.0
493,12982.0,FELTCRAFT GIRL AMELIE KIT,2,59,18,1900,1841,0,19.1
494,12984.0,PINK FLORAL FELTCRAFT SHOULDER BAG,1,15,1,200,185,0,2.0
495,12985.0,PIG KEYRING WITH LIGHT & SOUND ,3,145,40,4100,3955,0,45.39999999999997
496,12987.0,CHRISTMAS CRAFT WHITE FAIRY ,3,184,15,1600,1416,1,30.0
497,12988.0,FELT FARM ANIMAL CHICKEN,1,378,48,4900,4522,1,96.0
498,12989.0,WOODEN CROQUET GARDEN SET,19,213,33,3400,3187,1,66.0
499,12990.0,JUMBO BAG PINK POLKADOT,3,26,8,900,874,0,16.0
500,12991.0,VINTAGE SNAP CARDS,2,71,16,1700,1629,0,16.9
501,12993.0,TREASURE ISLAND BOOK BOX,4,57,15,1600,1543,0,15.599999999999998
502,12994.0,ENVELOPE 50 BLOSSOM IMAGES,5,304,39,4000,3696,1,78.0
503,12995.0,SILVER MUG BONE CHINA TREE OF LIFE,2,7,1,200,193,0,2.0
504,12997.0,BLUE GIANT GARDEN THERMOMETER,7,211,35,3600,3389,1,70.0
505,12999.0,12 PENCIL SMALL TUBE WOODLAND,3,71,14,1500,1429,0,15.1
506,13000.0,RED RETROSPOT PEG BAG,3,93,18,1900,1807,0,16.3
507,13001.0,CANDLE PLATE LACE WHITE,15,828,146,14700,13872,1,292.0
508,13002.0,SWEETHEART CAKESTAND 3 TIER,1,19,4,500,481,0,8.0
509,13003.0,RED RETROSPOT UMBRELLA,3,13,3,400,387,0,6.0
510,13004.0,LUNCH BAG  BLACK SKULL.,22,822,152,15300,14478,1,304.0
511,13005.0,TREASURE ISLAND BOOK BOX,3,157,16,1700,1543,1,32.0
512,13006.0,ASSORTED COLOUR MINI CASES,1,21,2,300,279,0,4.0
513,13008.0,PLASTERS IN TIN SPACEBOY,2,25,8,900,875,0,16.0
514,13011.0,BLACK/BLUE POLKADOT UMBRELLA,1,12,2,300,288,0,4.0
515,13012.0,MORE BUTTER METAL SIGN ,11,361,54,5500,5139,1,108.0
516,13013.0,RIBBON REEL SNOWY VILLAGE,15,701,107,10800,10099,1,214.0
517,13014.0,LUNCH BAG  BLACK SKULL.,16,649,59,6000,5351,1,118.0
518,13015.0,ALARM CLOCK BAKELIKE GREEN,5,886,80,8100,7214,1,160.0
519,13016.0,JAM MAKING SET PRINTED,3,149,22,2300,2151,0,22.499999999999996
520,13017.0,CHOCOLATE HOT WATER BOTTLE,1,4,0,100,96,0,0.0
521,13018.0,LUNCH BAG VINTAGE LEAF DESIGN,29,1003,160,16100,15097,1,320.0
522,13021.0,60 TEATIME FAIRY CAKE CASES,12,509,68,6900,6391,1,136.0
523,13023.0,RECIPE BOX PANTRY YELLOW DESIGN,2,182,23,2400,2218,1,46.0
524,13026.0,PAPERWEIGHT VINTAGE PAISLEY,8,36,25,2600,2564,0,25.4
525,13027.0,PACK OF 72 RETROSPOT CAKE CASES,6,10,16,1700,1690,0,12.0
526,13028.0,MORE BUTTER METAL SIGN ,3,47,24,2500,2453,0,26.1
527,13029.0,LUNCH BAG  BLACK SKULL.,3,73,3,400,327,0,6.0
528,13030.0,DECORATIVE WICKER HEART LARGE,2,314,45,4600,4286,1,90.0
529,13032.0,DOORMAT RED RETROSPOT,3,278,36,3700,3422,1,72.0
530,13033.0,TOY TIDY SPACEBOY  ,1,29,6,700,671,0,12.0
531,13034.0,WOODEN CROQUET GARDEN SET,2,87,20,2100,2013,0,18.8
532,13035.0,PINK BLUE FELT CRAFT TRINKET BOX,3,55,14,1500,1445,0,13.899999999999999
533,13037.0,HERB MARKER PARSLEY,3,183,27,2800,2617,1,54.0
534,13038.0,GINGERBREAD MAN COOKIE CUTTER,3,77,16,1700,1623,0,13.799999999999999
535,13040.0,CHRISTMAS CRAFT WHITE FAIRY ,2,120,22,2300,2180,0,23.599999999999994
536,13043.0,COFFEE MUG CAT + BIRD DESIGN,2,88,7,800,712,0,14.0
537,13044.0,BLUE GIANT GARDEN THERMOMETER,1,107,17,1800,1693,0,15.099999999999998
538,13045.0,SET OF 6 TEA TIME BAKING CASES,1,28,8,900,872,0,16.0
539,13046.0,WOODEN UNION JACK BUNTING,2,214,18,1900,1686,1,36.0
540,13047.0,IVORY SWEETHEART WIRE LETTER RACK ,18,798,90,9100,8302,1,180.0
541,13048.0,LUNCH BAG  BLACK SKULL.,5,252,70,7100,6848,1,140.0
542,13049.0,WALL ART STOP FOR TEA ,2,55,6,700,645,0,12.0
543,13050.0,LUNCH BAG  BLACK SKULL.,28,1300,155,15600,14300,1,310.0
544,13052.0,REX CASH+CARRY JUMBO SHOPPER,1,59,11,1200,1141,0,22.0
545,13055.0,LUNCH BAG VINTAGE LEAF DESIGN,4,196,42,4300,4104,1,84.0
546,13058.0,BLUE HAPPY BIRTHDAY BUNTING,3,46,3,400,354,0,6.0
547,13059.0,ROSES REGENCY TEACUP AND SAUCER ,1,41,3,400,359,0,6.0
548,13060.0,DOORMAT FANCY FONT HOME SWEET HOME,1,59,6,700,641,0,12.0
549,13061.0,PAPER LANTERN 9 POINT SNOW STAR,1,34,6,700,666,0,12.0
550,13062.0,WHITE BELL HONEYCOMB PAPER GARLAND ,1,75,7,800,725,0,14.0
551,13064.0,REX CASH+CARRY JUMBO SHOPPER,4,245,39,4000,3755,1,78.0
552,13065.0,SWEETHEART CAKESTAND 3 TIER,1,73,8,900,827,0,16.0
553,13066.0,12 PENCILS SMALL TUBE RED RETROSPOT,3,172,24,2500,2328,1,48.0
554,13067.0,SMALL WHITE HEART OF WICKER,1,57,7,800,743,0,14.0
555,13068.0,JUMBO  BAG BAROQUE BLACK WHITE,2,3,0,100,97,0,0.0
556,13069.0,12 PENCIL SMALL TUBE WOODLAND,27,809,170,17100,16291,1,340.0
557,13070.0,JUMBO BAG PINK POLKADOT,1,18,5,600,582,0,10.0
558,13072.0,RETROSPOT TEA SET CERAMIC 11 PC ,1,23,2,300,277,0,4.0
559,13075.0,SET OF 6 TEA TIME BAKING CASES,1,44,14,1500,1456,0,11.799999999999999
560,13077.0,HAND WARMER UNION JACK,4,196,55,5600,5404,1,110.0
561,13078.0,RIBBON REEL SNOWY VILLAGE,43,1510,148,14900,13390,1,296.0
562,13079.0,BOOM BOX SPEAKER BOYS,5,25,2,300,275,0,4.0
563,13080.0,PAPER POCKET TRAVELING FAN ,1,3,3,400,397,0,6.0
564,13081.0,LUNCH BAG VINTAGE LEAF DESIGN,21,2489,243,24400,21911,1,486.0
565,13082.0,LUNCH BAG VINTAGE LEAF DESIGN,10,220,40,4100,3880,1,80.0
566,13083.0,SET 7 BABUSHKA NESTING BOXES,2,61,9,1000,939,0,18.0
567,13085.0,PIG KEYRING WITH LIGHT & SOUND ,3,100,17,1800,1700,0,13.000000000000002
568,13089.0,HAND WARMER UNION JACK,118,5166,280,28100,22934,1,560.0
569,13090.0,T-LIGHT HOLDER SILVER HEART HANDLE,18,722,74,7500,6778,1,148.0
570,13091.0,GROOVY CACTUS INFLATABLE,2,25,12,1300,1275,0,12.1
571,13092.0,BOYS VINTAGE TIN SEASIDE BUCKET,6,127,17,1800,1673,0,14.200000000000001
572,13093.0,WRAP SUKI AND FRIENDS,13,583,78,7900,7317,1,156.0
573,13094.0,ANTIQUE SILVER TEA GLASS ETCHED,16,38,17,1800,1762,0,13.500000000000002
574,13095.0,HEADS AND TAILS SPORTING FUN,1,4,4,500,496,0,8.0
575,13097.0,BLUE HAPPY BIRTHDAY BUNTING,14,1886,154,15500,13614,1,308.0
576,13098.0,LUNCH BAG  BLACK SKULL.,41,1713,197,19800,18087,1,394.0
577,13099.0,PORCELAIN ROSE SMALL,1,0,0,100,100,0,0.0
578,13101.0,PEARL CRYSTAL PUMPKIN T-LIGHT HLDR,1,23,4,500,477,0,8.0
579,13102.0,PAPER BUNTING VINTAGE PARTY,27,797,124,12500,11703,1,248.0
580,13103.0,6 RIBBONS RUSTIC CHARM,1,31,4,500,469,0,8.0
581,13104.0,BLACK RECORD COVER FRAME,6,43,12,1300,1257,0,24.0
582,13106.0,NATURAL SLATE CHALKBOARD LARGE ,2,8,0,100,92,0,0.0
583,13107.0,PACK OF 6 COCKTAIL PARASOL STRAWS,5,107,31,3200,3093,0,27.60000000000001
584,13108.0,PICTURE DOMINOES,1,17,7,800,783,0,14.0
585,13109.0,LUNCH BAG  BLACK SKULL.,5,135,25,2600,2465,0,25.4
586,13110.0,CHRISTMAS TOILET ROLL,8,695,73,7400,6705,1,146.0
587,13113.0,IVORY SWEETHEART WIRE LETTER RACK ,40,1033,113,11400,10367,1,226.0
588,13115.0,PIG KEYRING WITH LIGHT & SOUND ,14,343,65,6600,6257,1,130.0
589,13116.0,SWEETHEART CAKESTAND 3 TIER,2,151,18,1900,1749,1,36.0
590,13117.0,DRAGONS BLOOD INCENSE,8,185,38,3900,3715,1,76.0
591,13118.0,BLUE GIANT GARDEN THERMOMETER,7,291,42,4300,4009,1,84.0
592,13120.0,WOODEN PICTURE FRAME WHITE FINISH,1,2,0,100,98,0,0.0
593,13121.0,LUNCH BAG  BLACK SKULL.,2,88,29,3000,2912,0,26.0
594,13122.0,WELCOME  WOODEN BLOCK LETTERS,2,145,28,2900,2755,0,26.900000000000006
595,13124.0,LUNCH BAG VINTAGE LEAF DESIGN,3,781,105,10600,9819,1,210.0
596,13126.0,SMALL HANGING IVORY/RED WOOD BIRD,10,315,73,7400,7085,1,146.0
597,13127.0,WOODLAND CHARLOTTE BAG,1,43,10,1100,1057,0,20.0
598,13130.0,SET/2 RED RETROSPOT TEA TOWELS ,1,4,0,100,96,0,0.0
599,13131.0,TREASURE ISLAND BOOK BOX,4,154,26,2700,2546,1,52.0
600,13132.0,"RECORD FRAME 7"" SINGLE SIZE ",1,14,1,200,186,0,2.0
601,13133.0,GINGHAM HEART  DOORSTOP RED,2,37,5,600,563,0,10.0
602,13134.0,IVORY SWEETHEART WIRE LETTER RACK ,7,328,51,5200,4872,1,102.0
603,13135.0,SMALL POPCORN HOLDER,1,0,0,100,100,0,0.0
604,13136.0,LUNCH BAG  BLACK SKULL.,11,410,71,7200,6790,1,142.0
605,13137.0,LUNCH BAG VINTAGE LEAF DESIGN,9,1393,210,21100,19707,1,420.0
606,13138.0,SPOTTY PINK DUCK DOORSTOP,6,177,33,3400,3223,1,66.0
607,13139.0,SET 7 BABUSHKA NESTING BOXES,8,607,86,8700,8093,1,172.0
608,13140.0,GINGHAM HEART  DOORSTOP RED,3,135,24,2500,2365,0,23.300000000000004
609,13141.0,LUNCH BAG  BLACK SKULL.,6,300,69,7000,6700,1,138.0
610,13142.0,TREASURE ISLAND BOOK BOX,1,68,13,1400,1332,0,10.5
611,13144.0,ROSES REGENCY TEACUP AND SAUCER ,1,18,1,200,182,0,2.0
612,13145.0,HOT STUFF HOT WATER BOTTLE,5,311,3,400,89,1,6.0
613,13146.0,4 LILY  BOTANICAL DINNER CANDLES,1,34,8,900,866,0,16.0
614,13147.0,CHILLI LIGHTS,4,19,3,400,381,0,6.0
615,13148.0,LUNCH BAG  BLACK SKULL.,17,1269,128,12900,11631,1,256.0
616,13149.0,RED KUKUI COCONUT SEED NECKLACE,4,247,44,4500,4253,1,88.0
617,13151.0,DOORMAT RED RETROSPOT,2,424,42,4300,3876,1,84.0
618,13153.0,CERAMIC PLATE STRAWBERRY DESIGN,1,19,7,800,781,0,14.0
619,13154.0,Manual,1,611,0,100,511,0,0.0
620,13155.0,LETS GO SHOPPING COTTON TOTE BAG,4,247,46,4700,4453,1,92.0
621,13157.0,LUNCH BAG  BLACK SKULL.,5,166,49,5000,4834,1,98.0
622,13158.0,LUNCH BAG  BLACK SKULL.,4,158,41,4200,4042,1,82.0
623,13159.0,BLUE HAPPY BIRTHDAY BUNTING,5,334,59,6000,5666,1,118.0
624,13160.0,DRAWER KNOB CERAMIC IVORY,1,12,2,300,288,0,4.0
625,13161.0,WOODEN FRAME ANTIQUE WHITE ,1,38,4,500,462,0,8.0
626,13162.0,LUNCH BAG  BLACK SKULL.,5,118,42,4300,4182,0,35.8
627,13165.0,IVORY LOVE BIRD CANDLE,2,33,23,2400,2367,0,21.500000000000004
628,13166.0,SWEETHEART CAKESTAND 3 TIER,2,99,20,2100,2001,0,20.699999999999996
629,13167.0,WRAP BILLBOARD FONTS DESIGN,4,191,36,3700,3509,1,72.0
630,13168.0,WHITE SKULL HOT WATER BOTTLE ,5,423,65,6600,6177,1,130.0
631,13169.0,WOODEN ADVENT CALENDAR RED,2,49,6,700,651,0,12.0
632,13170.0,REX CASH+CARRY JUMBO SHOPPER,1,49,17,1800,1751,0,15.1
633,13171.0,REX CASH+CARRY JUMBO SHOPPER,5,227,24,2500,2273,1,48.0
634,13173.0,JAM MAKING SET PRINTED,2,113,24,2500,2387,0,20.89999999999999
635,13174.0,RIBBON REEL SNOWY VILLAGE,3,1063,126,12700,11637,1,252.0
636,13176.0,REX CASH+CARRY JUMBO SHOPPER,1,199,33,3400,3201,1,66.0
637,13177.0,FELTCRAFT CUSHION OWL,1,59,7,800,741,0,14.0
638,13178.0,LUNCH BAG  BLACK SKULL.,11,542,112,11300,10758,1,224.0
639,13182.0,4 LILY  BOTANICAL DINNER CANDLES,1,7,7,800,793,0,14.0
640,13183.0,GARDENERS KNEELING PAD KEEP CALM ,9,191,48,4900,4709,1,96.0
641,13184.0,WRAP SUKI AND FRIENDS,12,337,85,8600,8263,1,170.0
642,13185.0,PICNIC BASKET WICKER SMALL,1,5,0,100,95,0,0.0
643,13186.0,DOORMAT RED RETROSPOT,5,268,48,4900,4632,1,96.0
644,13187.0,GINGERBREAD MAN COOKIE CUTTER,1,139,20,2100,1961,0,15.899999999999999
645,13188.0,Next Day Carriage,1,19,0,100,81,0,0.0
646,13189.0,"ACRYLIC JEWEL ANGEL,PINK",2,11,15,1600,1589,0,11.7
647,13192.0,LUNCH BAG  BLACK SKULL.,2,165,33,3400,3235,1,66.0
648,13193.0,REX CASH+CARRY JUMBO SHOPPER,1,83,17,1800,1717,0,15.100000000000001
649,13194.0,WOODEN OWLS LIGHT GARLAND ,1,7,0,100,93,0,0.0
650,13196.0,PAPER BUNTING WHITE LACE,4,275,51,5200,4925,1,102.0
651,13198.0,12 PENCIL SMALL TUBE WOODLAND,8,554,102,10300,9746,1,204.0
652,13199.0,WOODEN UNION JACK BUNTING,39,316,55,5600,5284,1,110.0
653,13200.0,WRAP ENGLISH ROSE ,4,155,25,2600,2445,1,50.0
654,13203.0,HOT WATER BOTTLE I AM SO POORLY,4,131,30,3100,2969,0,27.000000000000004
655,13207.0,EDWARDIAN PARASOL NATURAL,2,18,3,400,382,0,6.0
656,13208.0,LANTERN CREAM GAZEBO ,7,349,69,7000,6651,1,138.0
657,13209.0,LUNCH BAG  BLACK SKULL.,11,761,130,13100,12339,1,260.0
658,13210.0,DECORATIVE WICKER HEART SMALL,1,33,13,1400,1367,0,10.099999999999998
659,13211.0,PACK OF 6 SKULL PAPER CUPS,3,80,32,3300,3220,0,26.3
660,13212.0,DECORATIVE WICKER HEART LARGE,4,539,65,6600,6061,1,130.0
661,13213.0,BLUE HAPPY BIRTHDAY BUNTING,6,246,46,4700,4454,1,92.0
662,13216.0,TOY TIDY SPACEBOY  ,1,7,3,400,393,0,6.0
663,13217.0,SANDALWOOD FAN,5,16,5,600,584,0,10.0
664,13218.0,S/4 PINK FLOWER CANDLES IN BOWL,1,4,1,200,196,0,2.0
665,13220.0,WOODEN CROQUET GARDEN SET,4,95,10,1100,1005,0,11.2
666,13221.0,SWEETHEART CAKESTAND 3 TIER,2,330,32,3300,2970,1,64.0
667,13223.0,WOODEN BOX OF DOMINOES,2,9,3,400,391,0,6.0
668,13224.0,LUNCH BAG VINTAGE LEAF DESIGN,3,250,53,5400,5150,1,106.0
669,13225.0,SET/6 PINK  BUTTERFLY T-LIGHTS,8,87,19,2000,1913,0,13.9
670,13226.0,FELTCRAFT BUTTERFLY HEARTS,1,43,8,900,857,0,16.0
671,13227.0,TOY TIDY SPACEBOY  ,1,23,5,600,577,0,10.0
672,13228.0,JUMBO  BAG BAROQUE BLACK WHITE,1,3,1,200,197,0,2.0
673,13229.0,DOORMAT FAIRY CAKE,1,40,3,400,360,0,6.0
674,13230.0,LUNCH BAG VINTAGE LEAF DESIGN,15,1466,198,19900,18434,1,396.0
675,13232.0,DOORMAT MERRY CHRISTMAS RED ,7,678,95,9600,8922,1,190.0
676,13233.0,PACK OF 6 COCKTAIL PARASOL STRAWS,2,31,22,2300,2269,0,14.700000000000001
677,13235.0,PACK OF 6 SKULL PAPER CUPS,2,1087,30,3100,2013,1,60.0
678,13236.0,HEART OF WICKER SMALL,3,157,19,2000,1843,1,38.0
679,13238.0,VICTORIAN SEWING BOX LARGE,5,137,19,2000,1863,0,14.100000000000001
680,13239.0,MINI CAKE STAND  HANGING STRAWBERY,1,33,14,1500,1467,0,10.099999999999998
681,13240.0,SMALL TALL CAMPHOR WOOD TOADSTOOL,4,221,35,3600,3379,1,70.0
682,13242.0,JUMBO BAG PEARS,3,27,7,800,773,0,14.0
683,13243.0,GREEN POLKADOT BOWL,1,209,29,3000,2791,1,58.0
684,13244.0,BLUE GIANT GARDEN THERMOMETER,1,101,15,1600,1499,0,10.400000000000002
685,13245.0,DOG LICENCE WALL ART,1,99,8,900,801,0,16.0
686,13246.0,LUNCH BAG  BLACK SKULL.,7,263,69,7000,6737,1,138.0
687,13247.0,SET 20 NAPKINS FAIRY CAKES DESIGN ,4,52,13,1400,1348,0,11.899999999999997
688,13248.0,MEDIUM CERAMIC TOP STORAGE JAR,2,69,15,1600,1531,0,15.000000000000002
689,13249.0,DOORMAT RED RETROSPOT,3,78,12,1300,1222,0,12.900000000000002
690,13253.0,S/4 GROOVY CAT MAGNETS,2,41,18,1900,1859,0,14.599999999999998
691,13255.0,12 PENCIL SMALL TUBE WOODLAND,3,67,7,800,733,0,14.0
692,13256.0,ASSTD DESIGN 3D PAPER STICKERS,1,0,0,100,100,0,0.0
693,13258.0,DOORMAT KEEP CALM AND COME IN,3,139,21,2200,2061,0,20.5
694,13259.0,PANTRY HOOK BALLOON WHISK ,1,200,47,4800,4600,1,94.0
695,13260.0,REGENCY SUGAR TONGS,1,39,4,500,461,0,8.0
696,13261.0,PAPER CHAIN KIT EMPIRE,2,49,3,400,351,0,6.0
697,13262.0,FAMILY ALBUM WHITE PICTURE FRAME,1,34,6,700,666,0,12.0
698,13263.0,LUNCH BAG VINTAGE LEAF DESIGN,35,3760,270,27100,23340,1,540.0
699,13265.0,GINGERBREAD MAN COOKIE CUTTER,5,215,44,4500,4285,1,88.0
700,13266.0,WRAP SUKI AND FRIENDS,19,376,94,9500,9124,1,188.0
701,13267.0,WHITE SKULL HOT WATER BOTTLE ,27,786,101,10200,9414,1,202.0
702,13268.0,12 PENCIL SMALL TUBE WOODLAND,15,703,173,17400,16697,1,346.0
703,13269.0,SET 7 BABUSHKA NESTING BOXES,17,833,135,13600,12767,1,270.0
704,13270.0,AFGHAN SLIPPER SOCK PAIR,1,2,0,100,98,0,0.0
705,13271.0,TOXIC AREA  DOOR HANGER ,2,117,47,4800,4683,0,53.1
706,13272.0,SET OF 12  VINTAGE POSTCARD SET,2,80,7,800,720,0,14.0
707,13273.0,SET OF 3 NOTEBOOKS IN PARCEL,1,20,6,700,680,0,12.0
708,13276.0,HOT WATER BOTTLE I AM SO POORLY,2,152,17,1800,1648,1,34.0
709,13277.0,LUNCH BAG APPLE DESIGN,4,11,4,500,489,0,8.0
710,13278.0,SET OF 6 TEA TIME BAKING CASES,1,88,21,2200,2112,0,22.900000000000006
711,13279.0,SMALL RED RETROSPOT MUG IN BOX ,2,30,3,400,370,0,6.0
712,13280.0,REX CASH+CARRY JUMBO SHOPPER,3,222,41,4200,3978,1,82.0
713,13282.0,ALARM CLOCK BAKELIKE GREEN,6,186,21,2200,2014,1,42.0
714,13283.0,LETS GO SHOPPING COTTON TOTE BAG,2,9,3,400,391,0,6.0
715,13284.0,SWEETHEART CAKESTAND 3 TIER,2,57,7,800,743,0,14.0
716,13285.0,LUNCH BAG  BLACK SKULL.,4,399,83,8400,8001,1,166.0
717,13291.0,REX CASH+CARRY JUMBO SHOPPER,1,111,24,2500,2389,0,19.9
718,13292.0,DECORATIVE WICKER HEART SMALL,2,115,14,1500,1385,0,14.5
719,13294.0,SET 7 BABUSHKA NESTING BOXES,2,199,28,2900,2701,1,56.0
720,13295.0,DOORMAT RED RETROSPOT,2,38,6,700,662,0,12.0
721,13296.0,JAM MAKING SET PRINTED,1,12,1,200,188,0,2.0
722,13297.0,LUNCH BAG  BLACK SKULL.,4,175,27,2800,2625,1,54.0
723,13298.0,WHITE SKULL HOT WATER BOTTLE ,1,7,1,200,193,0,2.0
724,13299.0,PICNIC BASKET WICKER LARGE,1,23,1,200,177,0,2.0
725,13300.0,LUNCH BAG VINTAGE LEAF DESIGN,2,54,11,1200,1146,0,22.0
726,13301.0,SWEETHEART CAKESTAND 3 TIER,4,213,41,4200,3987,1,82.0
727,13302.0,SET OF 16 VINTAGE PISTACHIO CUTLERY,1,12,0,100,88,0,0.0
728,13304.0,RED RETROSPOT PEG BAG,1,66,11,1200,1134,0,10.000000000000002
729,13305.0,WELCOME  WOODEN BLOCK LETTERS,10,272,41,4200,3928,1,82.0
730,13307.0,SET 6 SCHOOL MILK BOTTLES IN CRATE,1,3,0,100,97,0,0.0
731,13308.0,MEDIUM CERAMIC TOP STORAGE JAR,4,180,25,2600,2420,1,50.0
732,13309.0,WRAP SUKI AND FRIENDS,5,173,50,5100,4927,1,100.0
733,13310.0,RED RETROSPOT PEG BAG,6,258,39,4000,3742,1,78.0
734,13311.0,WELCOME  WOODEN BLOCK LETTERS,2,107,13,1400,1293,0,11.6
735,13313.0,LUNCH BAG  BLACK SKULL.,5,166,42,4300,4134,1,84.0
736,13314.0,RETROSPOT CANDLE  MEDIUM,4,259,39,4000,3741,1,78.0
737,13316.0,BANQUET BIRTHDAY  CARD  ,5,380,51,5200,4820,1,102.0
738,13317.0,DOORMAT MERRY CHRISTMAS RED ,9,557,67,6800,6243,1,134.0
739,13318.0,PICTURE DOMINOES,3,57,11,1200,1143,0,10.7
740,13319.0,LUNCH BAG  BLACK SKULL.,36,1689,169,17000,15311,1,338.0
741,13320.0,LUNCH BAG  BLACK SKULL.,6,201,52,5300,5099,1,104.0
742,13321.0,15CM CHRISTMAS GLASS BALL 20 LIGHTS,2,23,5,600,577,0,10.0
743,13322.0,REX CASH+CARRY JUMBO SHOPPER,1,69,10,1100,1031,0,10.2
744,13323.0,RETROSPOT HEART HOT WATER BOTTLE,5,95,11,1200,1105,0,22.0
745,13324.0,SET OF 6 TEA TIME BAKING CASES,12,228,37,3800,3572,1,74.0
746,13325.0,PAINT YOUR OWN CANVAS SET,1,36,7,800,764,0,14.0
747,13327.0,GLITTER HANGING BUTTERFLY STRING,9,300,51,5200,4900,1,102.0
748,13328.0,GINGERBREAD MAN COOKIE CUTTER,1,31,9,1000,969,0,11.299999999999999
749,13329.0,HEADS AND TAILS SPORTING FUN,4,41,8,900,859,0,16.0
750,13330.0,SPACEBOY LUNCH BOX ,3,107,29,3000,2893,0,25.399999999999984
751,13332.0,TREASURE ISLAND BOOK BOX,1,63,9,1000,937,0,18.0
752,13334.0,WRAP SUKI AND FRIENDS,3,784,120,12100,11316,1,240.0
753,13336.0,SPACEBOY LUNCH BOX ,1,127,23,2400,2273,0,23.6
754,13338.0,REGENCY CAKESTAND 3 TIER,3,165,15,1600,1435,1,30.0
755,13339.0,CRAZY DAISY HEART DECORATION,1,282,30,3100,2818,1,60.0
756,13340.0,RIBBON REEL SNOWY VILLAGE,7,369,71,7200,6831,1,142.0
757,13341.0,RED RETROSPOT PEG BAG,1,175,23,2400,2225,1,46.0
758,13343.0,BLUE  TILE HOOK,2,141,11,1200,1059,0,12.199999999999998
759,13344.0,BISCUIT TIN 50'S CHRISTMAS,3,596,58,5900,5304,1,116.0
760,13345.0,SPACEBOY LUNCH BOX ,2,124,12,1300,1176,0,11.9
761,13347.0,VINTAGE RED ENAMEL TRIM PLATE,1,60,4,500,440,0,8.0
762,13348.0,RETROSPOT TEA SET CERAMIC 11 PC ,1,30,7,800,770,0,14.0
763,13349.0,12 PENCIL SMALL TUBE WOODLAND,1,64,8,900,836,0,10.4
764,13350.0,ANTIQUE SILVER BAUBLE LAMP  ,3,401,23,2400,1999,1,46.0
765,13351.0,DOG LICENCE WALL ART,1,103,7,800,697,0,14.0
766,13352.0,BLUE BUNNY EASTER EGG BASKET,2,95,13,1400,1305,0,13.600000000000001
767,13354.0,HOT WATER BOTTLE I AM SO POORLY,1,94,25,2600,2506,0,28.200000000000003
768,13355.0,LUNCH BAG  BLACK SKULL.,1,87,17,1800,1713,0,14.6
769,13356.0,MEDIUM CERAMIC TOP STORAGE JAR,1,181,19,2000,1819,1,38.0
770,13357.0,12 PENCILS SMALL TUBE RED RETROSPOT,1,262,47,4800,4538,1,94.0
771,13358.0,DOORMAT RED RETROSPOT,1,145,16,1700,1555,0,10.700000000000001
772,13359.0,DOORMAT MERRY CHRISTMAS RED ,2,137,13,1400,1263,0,12.700000000000003
773,13362.0,SET OF 16 VINTAGE SKY BLUE CUTLERY,5,586,72,7300,6714,1,144.0
774,13363.0,GINGERBREAD MAN COOKIE CUTTER,2,230,32,3300,3070,1,64.0
775,13364.0,POLYESTER FILLER PAD 40x40cm,2,51,12,1300,1249,0,24.0
776,13365.0,WRAP SUKI AND FRIENDS,3,413,73,7400,6987,1,146.0
777,13366.0,PACK OF 12 BLUE PAISLEY TISSUES ,1,0,0,100,100,0,0.0
778,13368.0,GINGERBREAD MAN COOKIE CUTTER,2,142,14,1500,1358,0,12.5
779,13369.0,BLUE ROUND COMPACT MIRROR,2,105,8,900,795,0,16.0
780,13370.0,PICTURE DOMINOES,2,166,18,1900,1734,1,36.0
781,13372.0,RECIPE BOX PANTRY YELLOW DESIGN,1,138,12,1300,1162,0,10.5
782,13373.0,DAISIES  HONEYCOMB GARLAND ,3,516,73,7400,6884,1,146.0
783,13375.0,HOT WATER BOTTLE I AM SO POORLY,2,121,21,2200,2079,0,17.7
784,13376.0,RED RETROSPOT PEG BAG,3,285,29,3000,2715,1,58.0
785,13379.0,HEART OF WICKER SMALL,3,169,48,4900,4731,1,96.0
786,13381.0,ALARM CLOCK BAKELIKE GREEN,7,530,75,7600,7070,1,150.0
787,13382.0,RED DRAWER KNOB ACRYLIC EDWARDIAN,1,41,9,1000,959,0,18.0
788,13384.0,LUNCH BAG VINTAGE LEAF DESIGN,9,496,76,7700,7204,1,152.0
789,13385.0,WRAP SUKI AND FRIENDS,1,158,21,2200,2042,1,42.0
790,13388.0,LARGE IVORY HEART WALL ORGANISER,3,209,22,2300,2091,1,44.0
791,13389.0,WOODEN UNION JACK BUNTING,3,196,23,2400,2204,1,46.0
792,13390.0,BOX OF VINTAGE JIGSAW BLOCKS ,1,39,6,700,661,0,12.0
793,13391.0,SILVER CHRISTMAS TREE BAUBLE STAND ,1,14,0,100,86,0,0.0
794,13394.0,12 PENCILS SMALL TUBE RED RETROSPOT,10,269,77,7800,7531,1,154.0
795,13395.0,SMALL TALL CAMPHOR WOOD TOADSTOOL,1,57,13,1400,1343,0,11.0
796,13396.0,DOORMAT RED RETROSPOT,4,188,27,2800,2612,1,54.0
797,13397.0,RECIPE BOX PANTRY YELLOW DESIGN,6,156,19,2000,1844,1,38.0
798,13398.0,BLUE GIANT GARDEN THERMOMETER,1,89,13,1400,1311,0,15.199999999999998
799,13402.0,FELT EGG COSY WHITE RABBIT ,2,77,23,2400,2323,0,19.9
800,13403.0,ANTIQUE SILVER T-LIGHT GLASS,1,8,1,200,192,0,2.0
801,13404.0,12 IVORY ROSE PEG PLACE SETTINGS,2,31,7,800,769,0,14.0
802,13405.0,GINGHAM HEART  DOORSTOP RED,3,146,14,1500,1354,0,10.799999999999999
803,13408.0,LUNCH BAG  BLACK SKULL.,81,1614,178,17900,16286,1,356.0
804,13410.0,MONSTERS STENCIL CRAFT,7,74,16,1700,1626,0,15.1
805,13411.0,"ART LIGHTS,FUNK MONKEY",1,58,8,900,842,0,16.0
806,13414.0,GINGERBREAD MAN COOKIE CUTTER,3,44,11,1200,1156,0,12.100000000000003
807,13416.0,HOT WATER BOTTLE I AM SO POORLY,2,103,10,1100,997,0,20.0
808,13417.0,DOORMAT BLACK FLOCK ,2,177,14,1500,1323,1,28.0
809,13418.0,SET 7 BABUSHKA NESTING BOXES,23,925,128,12900,11975,1,256.0
810,13419.0,SET OF 3 NOTEBOOKS IN PARCEL,1,16,6,700,684,0,12.0
811,13420.0,12 IVORY ROSE PEG PLACE SETTINGS,4,31,3,400,369,0,6.0
812,13421.0,RIBBON REEL POLKADOTS ,3,219,54,5500,5281,1,108.0
813,13422.0,LUNCH BAG VINTAGE LEAF DESIGN,2,389,65,6600,6211,1,130.0
814,13425.0,PACK OF 6 SKULL PAPER CUPS,3,205,38,3900,3695,1,76.0
815,13426.0,DECORATIVE WICKER HEART LARGE,12,307,85,8600,8293,1,170.0
816,13427.0,WOODEN STAR CHRISTMAS SCANDINAVIAN,3,47,15,1600,1553,0,14.1
817,13428.0,REX CASH+CARRY JUMBO SHOPPER,1,145,36,3700,3555,0,35.699999999999996
818,13429.0,WOODEN TREE CHRISTMAS SCANDINAVIAN,4,81,36,3700,3619,0,34.60000000000001
819,13430.0,GINGERBREAD MAN COOKIE CUTTER,4,94,29,3000,2906,0,25.699999999999996
820,13431.0,GINGERBREAD MAN COOKIE CUTTER,2,147,21,2200,2053,0,22.3
821,13434.0,GIN + TONIC DIET METAL SIGN,2,16,2,300,284,0,4.0
822,13435.0,DAIRY MAID STRIPE MUG,9,304,54,5500,5196,1,108.0
823,13436.0,BREAD BIN DINER STYLE RED ,1,69,6,700,631,0,12.0
824,13437.0,DECORATIVE WICKER HEART LARGE,7,816,81,8200,7384,1,162.0
825,13439.0,GLITTER HANGING BUTTERFLY STRING,1,93,29,3000,2907,0,30.500000000000004
826,13441.0,WOODEN TREE CHRISTMAS SCANDINAVIAN,1,25,6,700,675,0,12.0
827,13447.0,RIBBON REEL SNOWY VILLAGE,4,195,31,3200,3005,1,62.0
828,13448.0,LUNCH BAG VINTAGE LEAF DESIGN,10,635,92,9300,8665,1,184.0
829,13449.0,12 PENCILS SMALL TUBE RED RETROSPOT,1,36,8,900,864,0,11.100000000000001
830,13450.0,GINGERBREAD MAN COOKIE CUTTER,6,109,39,4000,3891,0,32.0
831,13451.0,SET 7 BABUSHKA NESTING BOXES,6,941,157,15800,14859,1,314.0
832,13452.0,VINTAGE BLUE KITCHEN CABINET,2,590,1,200,390,1,2.0
833,13453.0,CLEAR DRAWER KNOB ACRYLIC EDWARDIAN,2,77,10,1100,1023,0,20.0
834,13455.0,RIBBON REEL POLKADOTS ,4,253,26,2700,2447,1,52.0
835,13456.0,12 PENCIL SMALL TUBE WOODLAND,7,228,34,3500,3272,1,68.0
836,13458.0,WRAP SUKI AND FRIENDS,22,967,160,16100,15133,1,320.0
837,13460.0,WRAP  VINTAGE DOILY ,2,18,10,1100,1082,0,20.0
838,13461.0,WOODLAND CHARLOTTE BAG,3,42,14,1500,1458,0,14.1
839,13462.0,BULL DOG BOTTLE TOP WALL CLOCK,2,38,5,600,562,0,10.0
840,13464.0,WOODEN TREE CHRISTMAS SCANDINAVIAN,1,131,22,2300,2169,0,17.200000000000003
841,13466.0,MONSTERS STENCIL CRAFT,2,58,9,1000,942,0,18.0
842,13467.0,12 PENCIL SMALL TUBE WOODLAND,2,270,46,4700,4430,1,92.0
843,13468.0,SET 7 BABUSHKA NESTING BOXES,41,1266,140,14100,12834,1,280.0
844,13470.0,LUNCH BAG  BLACK SKULL.,2,16,5,600,584,0,10.0
845,13471.0,LUNCH BAG  BLACK SKULL.,4,651,116,11700,11049,1,232.0
846,13473.0,BLACK/BLUE POLKADOT UMBRELLA,3,79,12,1300,1221,0,24.0
847,13474.0,RED RETROSPOT PEG BAG,1,148,30,3100,2952,0,32.400000000000006
848,13475.0,DOORMAT RED RETROSPOT,4,248,46,4700,4452,1,92.0
849,13476.0,GINGERBREAD MAN COOKIE CUTTER,4,655,34,3500,2845,1,68.0
850,13477.0,PIG KEYRING WITH LIGHT & SOUND ,8,210,42,4300,4090,1,84.0
851,13479.0,SWEETHEART CAKESTAND 3 TIER,3,79,7,800,721,0,14.0
852,13481.0,BLUE HAPPY BIRTHDAY BUNTING,8,258,57,5800,5542,1,114.0
853,13482.0,PACK OF 12 BLUE PAISLEY TISSUES ,1,26,6,700,674,0,12.0
854,13483.0,PACK OF 12 COLOURED PENCILS,1,10,5,600,590,0,10.0
855,13484.0,DOORMAT RED RETROSPOT,1,60,3,400,340,0,6.0
856,13485.0,WHITE BELL HONEYCOMB PAPER GARLAND ,1,55,9,1000,945,0,12.7
857,13486.0,SWEETHEART CAKESTAND 3 TIER,3,200,35,3600,3400,1,70.0
858,13487.0,DOORMAT RED RETROSPOT,3,151,16,1700,1549,1,32.0
859,13488.0,BLUE HAPPY BIRTHDAY BUNTING,17,1505,156,15700,14195,1,312.0
860,13489.0,ZINC T-LIGHT HOLDER STAR LARGE,4,19,6,700,681,0,12.0
861,13491.0,RED RETROSPOT PEG BAG,10,289,47,4800,4511,1,94.0
862,13492.0,LUNCH BAG VINTAGE LEAF DESIGN,3,225,24,2500,2275,1,48.0
863,13493.0,EASTER TIN KEEPSAKE,2,103,5,600,497,0,10.0
864,13494.0,LUNCH BAG  BLACK SKULL.,1,65,7,800,735,0,14.0
865,13495.0,HOT WATER BOTTLE I AM SO POORLY,6,137,25,2600,2463,0,25.000000000000007
866,13496.0,REGENCY CAKESTAND 3 TIER,3,111,19,2000,1889,0,17.9
867,13497.0,EASTER TIN BUNNY BOUQUET,3,63,14,1500,1437,0,28.0
868,13499.0,WOODEN STAR CHRISTMAS SCANDINAVIAN,7,95,24,2500,2405,0,20.800000000000004
869,13500.0,GINGERBREAD MAN COOKIE CUTTER,4,238,31,3200,2962,1,62.0
870,13501.0,FELTCRAFT CUSHION RABBIT,2,204,30,3100,2896,1,60.0
871,13502.0,SET OF 3 NOTEBOOKS IN PARCEL,3,32,11,1200,1168,0,22.0
872,13503.0,WRAP  VINTAGE DOILY ,1,37,11,1200,1163,0,22.0
873,13504.0,BOX OF 24 COCKTAIL PARASOLS,1,81,11,1200,1119,0,11.700000000000001
874,13505.0,WRAP SUKI AND FRIENDS,8,770,96,9700,8930,1,192.0
875,13506.0,HOT WATER BOTTLE I AM SO POORLY,3,80,15,1600,1520,0,16.399999999999995
876,13507.0,IVORY SWEETHEART WIRE LETTER RACK ,4,543,76,7700,7157,1,152.0
877,13508.0,DOORMAT RED RETROSPOT,1,62,6,700,638,0,12.0
878,13509.0,GREEN POLKADOT BOWL,7,60,19,2000,1940,0,20.900000000000002
879,13510.0,WRAP SUKI AND FRIENDS,5,277,63,6400,6123,1,126.0
880,13512.0,EDWARDIAN PARASOL NATURAL,1,62,8,900,838,0,16.0
881,13513.0,LARGE DECO JEWELLERY STAND,1,36,5,600,564,0,10.0
882,13514.0,FRENCH CARRIAGE LANTERN,1,16,1,200,184,0,2.0
883,13515.0,HOT WATER BOTTLE I AM SO POORLY,4,127,30,3100,2973,0,31.400000000000002
884,13516.0,RIBBON REEL POLKADOTS ,3,129,25,2600,2471,0,24.1
885,13517.0,WRAP SUKI AND FRIENDS,5,417,68,6900,6483,1,136.0
886,13518.0,SPACEBOY LUNCH BOX ,1,104,22,2300,2196,0,17.800000000000004
887,13519.0,BLUE GIANT GARDEN THERMOMETER,2,62,2,300,238,0,4.0
888,13520.0,12 PENCIL SMALL TUBE WOODLAND,8,467,49,5000,4533,1,98.0
889,13521.0,MINI PLAYING CARDS GYMKHANA,3,790,165,16600,15810,1,330.0
890,13522.0,LOVE HOT WATER BOTTLE,1,16,3,400,384,0,6.0
891,13523.0,RIBBON REEL SNOWY VILLAGE,6,1268,81,8200,6932,1,162.0
892,13524.0,FAIRY CAKE FLANNEL ASSORTED COLOUR,5,93,13,1400,1307,0,15.000000000000004
893,13525.0,BELLE JARDINIERE CUSHION COVER,2,23,2,300,277,0,4.0
894,13527.0,DECORATIVE WICKER HEART LARGE,8,638,96,9700,9062,1,192.0
895,13529.0,CHILDRENS CUTLERY DOLLY GIRL ,2,83,7,800,717,0,14.0
896,13531.0,RED RETROSPOT ROUND CAKE TINS,2,99,9,1000,901,0,11.7
897,13532.0,GINGERBREAD MAN COOKIE CUTTER,1,146,30,3100,2954,0,34.79999999999999
898,13533.0,GINGERBREAD MAN COOKIE CUTTER,3,146,43,4400,4254,0,35.00000000000002
899,13534.0,LUNCH BAG  BLACK SKULL.,43,971,148,14900,13929,1,296.0
900,13536.0,ALARM CLOCK BAKELIKE GREEN,7,576,94,9500,8924,1,188.0
901,13538.0,DOORMAT SPOTTY HOME SWEET HOME,7,186,16,1700,1514,1,32.0
902,13539.0,FELT EGG COSY WHITE RABBIT ,4,159,20,2100,1941,1,40.0
903,13544.0,REX CASH+CARRY JUMBO SHOPPER,2,256,43,4400,4144,1,86.0
904,13546.0,DAIRY MAID STRIPE MUG,3,216,53,5400,5184,1,106.0
905,13548.0,SET OF 4 POLKADOT PLACEMATS ,2,349,61,6200,5851,1,122.0
906,13549.0,PINK VINTAGE SPOT BEAKER,8,182,22,2300,2118,1,44.0
907,13551.0,EDWARDIAN PARASOL BLACK,1,30,1,200,170,0,2.0
908,13552.0,IVORY SWEETHEART WIRE LETTER RACK ,16,507,58,5900,5393,1,116.0
909,13555.0,12 PENCIL SMALL TUBE WOODLAND,4,324,69,7000,6676,1,138.0
910,13557.0,WRAP SUKI AND FRIENDS,2,50,17,1800,1750,0,15.3
911,13558.0,CHRISTMAS CRAFT WHITE FAIRY ,4,386,78,7900,7514,1,156.0
912,13560.0,WHITE SKULL HOT WATER BOTTLE ,1,98,17,1800,1702,0,17.0
913,13561.0,PACK OF 12 HEARTS DESIGN TISSUES ,1,49,7,800,751,0,14.0
914,13562.0,DOORMAT RED RETROSPOT,3,314,39,4000,3686,1,78.0
915,13563.0,TOXIC AREA  DOOR HANGER ,2,417,29,3000,2583,1,58.0
916,13564.0,HOT WATER BOTTLE I AM SO POORLY,5,1951,41,4200,2249,1,82.0
917,13565.0,RIBBON REEL POLKADOTS ,2,65,22,2300,2235,0,21.10000000000001
918,13566.0,WHITE SKULL HOT WATER BOTTLE ,2,332,80,8100,7768,1,160.0
919,13568.0,GARDENERS KNEELING PAD KEEP CALM ,1,132,22,2300,2168,0,22.199999999999996
920,13569.0,LUNCH BAG  BLACK SKULL.,2,268,42,4300,4032,1,84.0
921,13570.0,REX CASH+CARRY JUMBO SHOPPER,1,56,12,1300,1244,0,12.2
922,13571.0,CHARLIE & LOLA WASTEPAPER BIN BLUE,12,588,140,14100,13512,1,280.0
923,13572.0,S/12 VANILLA  BOTANICAL T-LIGHTS,1,148,16,1700,1552,0,19.900000000000002
924,13573.0,REX CASH+CARRY JUMBO SHOPPER,2,92,9,1000,908,0,12.8
925,13575.0,LUNCH BAG  BLACK SKULL.,5,98,26,2700,2602,0,23.6
926,13576.0,MIRRORED WALL ART LADIES,20,416,70,7100,6684,1,140.0
927,13577.0,JUMBO BAG VINTAGE DOILY ,5,259,44,4500,4241,1,88.0
928,13579.0,HOT WATER BOTTLE I AM SO POORLY,2,97,11,1200,1103,0,14.000000000000002
929,13581.0,SET OF 36 PAISLEY FLOWER DOILIES,1,44,6,700,656,0,12.0
930,13583.0,ENVELOPE 50 BLOSSOM IMAGES,1,106,29,3000,2894,0,29.099999999999998
931,13584.0,12 PENCILS TALL TUBE WOODLAND,1,99,13,1400,1301,0,11.8
932,13587.0,REVOLVER WOODEN RULER ,3,94,5,600,506,0,10.0
933,13588.0,WRAP RED DOILEY,13,249,81,8200,7951,1,162.0
934,13589.0,WOODEN CROQUET GARDEN SET,2,140,8,900,760,0,12.3
935,13590.0,LUNCH BAG  BLACK SKULL.,7,166,41,4200,4034,1,82.0
936,13591.0,SWEETHEART CAKESTAND 3 TIER,3,230,26,2700,2470,1,52.0
937,13592.0,WOODEN CROQUET GARDEN SET,4,100,9,1000,900,0,18.0
938,13593.0,GARLAND WOODEN HAPPY EASTER,6,561,64,6500,5939,1,128.0
939,13594.0,SET OF 6 TEA TIME BAKING CASES,1,41,13,1400,1359,0,14.299999999999997
940,13596.0,PAPER BUNTING VINTAGE PARTY,2,378,85,8600,8222,1,170.0
941,13598.0,JUMBO BAG VINTAGE DOILY ,2,146,24,2500,2354,0,17.900000000000006
942,13599.0,LUNCH BAG  BLACK SKULL.,33,730,106,10700,9970,1,212.0
943,13600.0,REX CASH+CARRY JUMBO SHOPPER,1,58,11,1200,1142,0,10.1
944,13601.0,12 PENCIL SMALL TUBE WOODLAND,2,184,47,4800,4616,1,94.0
945,13602.0,JUMBO BAG VINTAGE DOILY ,1,47,10,1100,1053,0,11.899999999999999
946,13603.0,FELT EGG COSY WHITE RABBIT ,1,57,15,1600,1543,0,11.700000000000001
947,13606.0,SET OF 4 NAPKIN CHARMS HEARTS,3,97,23,2400,2303,0,23.8
948,13607.0,DECORATIVE WICKER HEART LARGE,1,308,50,5100,4792,1,100.0
949,13610.0,LUNCH BAG VINTAGE LEAF DESIGN,9,667,107,10800,10133,1,214.0
950,13611.0,BLUE GIANT GARDEN THERMOMETER,4,179,41,4200,4021,1,82.0
951,13614.0,PAPER BUNTING VINTAGE PARTY,4,758,89,9000,8242,1,178.0
952,13615.0,LARGE WHITE/PINK ROSE ART FLOWER,2,80,14,1500,1420,0,13.899999999999999
953,13617.0,REX CASH+CARRY JUMBO SHOPPER,3,122,24,2500,2378,0,22.799999999999994
954,13618.0,"ACRYLIC JEWEL ICICLE, PINK",1,13,7,800,787,0,14.0
955,13621.0,VINTAGE SNAP CARDS,1,21,10,1100,1079,0,10.299999999999999
956,13623.0,ANT COPPER LIME BOUDICCA BRACELET,7,333,40,4100,3767,1,80.0
957,13626.0,JAM MAKING SET PRINTED,1,40,10,1100,1060,0,20.0
958,13627.0,DECORATIVE WICKER HEART LARGE,7,287,44,4500,4213,1,88.0
959,13629.0,RED RETROSPOT PEG BAG,11,137,32,3300,3163,0,27.6
960,13630.0,RECIPE BOX PANTRY YELLOW DESIGN,11,168,39,4000,3832,1,78.0
961,13631.0,ROSE COTTAGE KEEPSAKE BOX ,12,74,6,700,626,0,12.0
962,13632.0,TOXIC AREA  DOOR HANGER ,6,467,71,7200,6733,1,142.0
963,13634.0,CHRISTMAS CRAFT WHITE FAIRY ,5,626,95,9600,8974,1,190.0
964,13635.0,TREASURE ISLAND BOOK BOX,1,149,33,3400,3251,0,31.7
965,13636.0,LUNCH BAG  BLACK SKULL.,6,239,35,3600,3361,1,70.0
966,13637.0,IVORY SWEETHEART WIRE LETTER RACK ,3,238,56,5700,5462,1,112.0
967,13638.0,ROLL WRAP 50'S CHRISTMAS,1,23,3,400,377,0,6.0
968,13639.0,GINGERBREAD MAN COOKIE CUTTER,1,57,20,2100,2043,0,21.799999999999997
969,13642.0,REX CASH+CARRY JUMBO SHOPPER,1,214,29,3000,2786,1,58.0
970,13643.0,LUNCH BAG PINK POLKADOT,3,67,13,1400,1333,0,16.6
971,13644.0,DECORATIVE WICKER HEART LARGE,5,469,74,7500,7031,1,148.0
972,13645.0,CLEAR DRAWER KNOB ACRYLIC EDWARDIAN,1,16,3,400,384,0,6.0
973,13647.0,JUMBO BAG VINTAGE DOILY ,5,270,41,4200,3930,1,82.0
974,13649.0,REX CASH+CARRY JUMBO SHOPPER,2,73,11,1200,1127,0,22.0
975,13650.0,LANTERN CREAM GAZEBO ,7,316,45,4600,4284,1,90.0
976,13651.0,PARTY METAL SIGN ,2,36,3,400,364,0,6.0
977,13652.0,HOT WATER BOTTLE I AM SO POORLY,3,196,29,3000,2804,1,58.0
978,13654.0,LUNCH BAG  BLACK SKULL.,6,419,82,8300,7881,1,164.0
979,13655.0,SWEETHEART CAKESTAND 3 TIER,2,186,29,3000,2814,1,58.0
980,13656.0,ASS COL SMALL SAND GECKO P'WEIGHT,2,84,23,2400,2316,0,21.899999999999995
981,13657.0,ROTATING SILVER ANGELS T-LIGHT HLDR,2,47,7,800,753,0,14.0
982,13658.0,LUNCH BAG  BLACK SKULL.,7,500,60,6100,5600,1,120.0
983,13659.0,SET 7 BABUSHKA NESTING BOXES,3,411,56,5700,5289,1,112.0
984,13662.0,HERB MARKER PARSLEY,7,192,26,2700,2508,1,52.0
985,13663.0,CHRISTMAS TABLE CANDLE SILVER SPIKE,1,58,6,700,642,0,12.0
986,13666.0,BUNDLE OF 3 SCHOOL EXERCISE BOOKS  ,3,44,7,800,756,0,14.0
987,13667.0,NO JUNK MAIL METAL SIGN,1,211,41,4200,3989,1,82.0
988,13668.0,SET 7 BABUSHKA NESTING BOXES,29,1478,167,16800,15322,1,334.0
989,13669.0,PINK CREAM FELT CRAFT TRINKET BOX ,2,24,5,600,576,0,10.0
990,13670.0,CARD WEDDING DAY,1,46,13,1400,1354,0,11.3
991,13672.0,Manual,6,138,9,1000,862,0,18.0
992,13673.0,REX CASH+CARRY JUMBO SHOPPER,2,214,37,3800,3586,1,74.0
993,13675.0,GARLAND WOODEN HAPPY EASTER,2,47,11,1200,1153,0,14.299999999999999
994,13678.0,BLACK STITCHED WALL CLOCK,1,6,8,900,894,0,16.0
995,13680.0,LUNCH BAG  BLACK SKULL.,5,480,99,10000,9520,1,198.0
996,13681.0,REX CASH+CARRY JUMBO SHOPPER,4,165,26,2700,2535,1,52.0
997,13682.0,SET OF 4 DIAMOND NAPKIN RINGS,1,21,0,100,79,0,0.0
998,13684.0,MORE BUTTER METAL SIGN ,2,55,16,1700,1645,0,13.6
999,13685.0,SPOTTY PINK DUCK DOORSTOP,7,27,21,2200,2173,0,21.999999999999996
1000,13686.0,CHARLOTTE BAG DOLLY GIRL DESIGN,1,9,4,500,491,0,8.0
1001,13689.0,WOODEN BOX OF DOMINOES,1,10,4,500,490,0,8.0
1002,13690.0,3 TIER CAKE TIN RED AND CREAM,1,53,5,600,547,0,10.0
1003,13692.0,PACK OF 6 COCKTAIL PARASOL STRAWS,5,159,31,3200,3041,1,62.0
1004,13693.0,SWEETHEART CAKESTAND 3 TIER,2,22,2,300,278,0,4.0
1005,13694.0,LUNCH BAG VINTAGE LEAF DESIGN,60,1163,188,18900,17737,1,376.0
1006,13695.0,CANDLE PLATE LACE WHITE,15,238,47,4800,4562,1,94.0
1007,13697.0,BLUE SCANDINAVIAN PAISLEY WRAP,1,16,6,700,684,0,12.0
1008,13699.0,DOORMAT FANCY FONT HOME SWEET HOME,1,88,7,800,712,0,14.0
1009,13700.0,WRAP SUKI AND FRIENDS,10,312,88,8900,8588,1,176.0
1010,13703.0,SWEETHEART CAKESTAND 3 TIER,1,9,0,100,91,0,0.0
1011,13704.0,MAGIC DRAWING SLATE DINOSAUR,10,450,67,6800,6350,1,134.0
1012,13705.0,GREEN DRAWER KNOB ACRYLIC EDWARDIAN,3,213,15,1600,1387,1,30.0
1013,13706.0,FELT FARM ANIMAL CHICKEN,1,55,10,1100,1045,0,10.499999999999998
1014,13707.0,WOODEN CROQUET GARDEN SET,2,214,26,2700,2486,1,52.0
1015,13708.0,LUNCH BAG  BLACK SKULL.,1,104,28,2900,2796,0,29.9
1016,13709.0,LUNCH BAG  BLACK SKULL.,17,1244,148,14900,13656,1,296.0
1017,13710.0,HANGING HEART WITH BELL,1,9,5,600,591,0,10.0
1018,13711.0,CREAM WALL PLANTER HEART SHAPED,2,49,7,800,751,0,14.0
1019,13712.0,WORLD WAR 2 GLIDERS ASSTD DESIGNS,1,12,4,500,488,0,8.0
1020,13715.0,LUNCH BAG  BLACK SKULL.,8,251,55,5600,5349,1,110.0
1021,13716.0,12 PENCILS TALL TUBE WOODLAND,1,29,14,1500,1471,0,12.600000000000001
1022,13717.0,HEART DECORATION RUSTIC HANGING ,7,221,52,5300,5079,1,104.0
1023,13718.0,RED DRAWER KNOB ACRYLIC EDWARDIAN,2,66,7,800,734,0,14.0
1024,13719.0,WOODEN UNION JACK BUNTING,5,195,28,2900,2705,1,56.0
1025,13720.0,WOODEN UNION JACK BUNTING,4,136,22,2300,2164,0,21.799999999999997
1026,13721.0,WOODEN TREE CHRISTMAS SCANDINAVIAN,1,79,21,2200,2121,0,12.499999999999996
1027,13722.0,PINK VINTAGE SPOT BEAKER,4,251,41,4200,3949,1,82.0
1028,13723.0,RETROSPOT TEA SET CERAMIC 11 PC ,1,31,4,500,469,0,8.0
1029,13725.0,FLOWER VINE RAFFIA FOOD COVER,11,495,56,5700,5205,1,112.0
1030,13726.0,PLASTERS IN TIN CIRCUS PARADE ,2,45,24,2500,2455,0,19.5
1031,13727.0,VINTAGE SNAP CARDS,2,58,9,1000,942,0,12.100000000000001
1032,13728.0,DOORMAT RED RETROSPOT,6,343,34,3500,3157,1,68.0
1033,13730.0,MAGIC DRAWING SLATE PURDEY,2,139,22,2300,2161,0,17.8
1034,13731.0,WOODEN CROQUET GARDEN SET,2,162,20,2100,1938,1,40.0
1035,13732.0,ROSE 1 WICK MORRIS BOXED CANDLE,1,52,17,1800,1748,0,15.200000000000001
1036,13735.0,PAPER BUNTING VINTAGE PARTY,8,849,88,8900,8051,1,176.0
1037,13736.0,LUNCH BAG  BLACK SKULL.,3,422,81,8200,7778,1,162.0
1038,13737.0,SET OF 4 NAPKIN CHARMS HEARTS,1,115,17,1800,1685,0,19.499999999999996
1039,13739.0,POMPOM CURTAIN,1,16,1,200,184,0,2.0
1040,13740.0,PINK POLKADOT GARDEN PARASOL,1,36,11,1200,1164,0,22.0
1041,13741.0,GLASS BON BON JAR,4,179,18,1900,1721,1,36.0
1042,13742.0,BLUE HAPPY BIRTHDAY BUNTING,14,1328,128,12900,11572,1,256.0
1043,13743.0,PAINT YOUR OWN CANVAS SET,8,47,26,2700,2653,0,21.300000000000004
1044,13744.0,MORE BUTTER METAL SIGN ,2,122,45,4600,4478,0,31.3
1045,13745.0,"ELEPHANT, BIRTHDAY CARD, ",2,16,12,1300,1284,0,11.799999999999997
1046,13747.0,RETROSPOT LAMP,1,9,0,100,91,0,0.0
1047,13748.0,JAM MAKING SET PRINTED,5,111,13,1400,1289,0,13.700000000000001
1048,13750.0,RED RETROSPOT PEG BAG,5,120,12,1300,1180,0,10.5
1049,13751.0,GUMBALL MONOCHROME COAT RACK,1,31,6,700,669,0,12.0
1050,13752.0,12 PENCIL SMALL TUBE WOODLAND,6,233,34,3500,3267,1,68.0
1051,13753.0,JAM MAKING SET PRINTED,1,62,18,1900,1838,0,15.499999999999996
1052,13754.0,SET OF 72 RETROSPOT PAPER  DOILIES,2,28,8,900,872,0,16.0
1053,13755.0,LUNCH BAG  BLACK SKULL.,10,1051,129,13000,11949,1,258.0
1054,13756.0,WRAP BILLBOARD FONTS DESIGN,15,390,70,7100,6710,1,140.0
1055,13758.0,IVORY SWEETHEART WIRE LETTER RACK ,7,384,54,5500,5116,1,108.0
1056,13759.0,REGENCY TEA STRAINER,2,84,13,1400,1316,0,13.799999999999999
1057,13760.0,GINGERBREAD MAN COOKIE CUTTER,2,113,32,3300,3187,0,25.2
1058,13761.0,BLUE GIANT GARDEN THERMOMETER,2,206,36,3700,3494,1,72.0
1059,13762.0,SET/10 BLUE POLKADOT PARTY CANDLES,2,17,7,800,783,0,14.0
1060,13763.0,SWEETHEART CAKESTAND 3 TIER,3,55,8,900,845,0,16.0
1061,13764.0,LUNCH BAG  BLACK SKULL.,3,566,90,9100,8534,1,180.0
1062,13767.0,SET 7 BABUSHKA NESTING BOXES,52,1495,157,15800,14305,1,314.0
1063,13769.0,FELT EGG COSY WHITE RABBIT ,16,523,67,6800,6277,1,134.0
1064,13771.0,SET 7 BABUSHKA NESTING BOXES,5,315,61,6200,5885,1,122.0
1065,13772.0,LUNCH BAG VINTAGE LEAF DESIGN,3,436,89,9000,8564,1,178.0
1066,13774.0,JAM MAKING SET PRINTED,1,72,9,1000,928,0,11.0
1067,13777.0,LUNCH BAG  BLACK SKULL.,41,520,106,10700,10180,1,212.0
1068,13778.0,BLUE HAPPY BIRTHDAY BUNTING,1,29,4,500,471,0,8.0
1069,13780.0,WOODLAND MINI BACKPACK,2,147,30,3100,2953,0,31.599999999999994
1070,13781.0,MORE BUTTER METAL SIGN ,1,77,9,1000,923,0,18.0
1071,13782.0,IVORY SWEETHEART WIRE LETTER RACK ,6,403,61,6200,5797,1,122.0
1072,13784.0,REGENCY SUGAR TONGS,11,81,16,1700,1619,0,13.599999999999996
1073,13786.0,POLYESTER FILLER PAD 40x40cm,1,13,3,400,387,0,6.0
1074,13787.0,WOODEN STAR CHRISTMAS SCANDINAVIAN,2,76,18,1900,1824,0,16.3
1075,13790.0,PIG KEYRING WITH LIGHT & SOUND ,1,34,26,2700,2666,0,24.099999999999998
1076,13791.0,LUNCH BAG  BLACK SKULL.,3,21,8,900,879,0,16.0
1077,13792.0,STOOL HOME SWEET HOME ,2,46,6,700,654,0,12.0
1078,13798.0,LUNCH BAG  BLACK SKULL.,63,907,168,16900,15993,1,336.0
1079,13799.0,GLITTER HANGING BUTTERFLY STRING,2,83,21,2200,2117,0,18.2
1080,13800.0,GINGERBREAD MAN COOKIE CUTTER,1,84,18,1900,1816,0,17.6
1081,13801.0,SET OF 4 NAPKIN CHARMS HEARTS,1,90,10,1100,1010,0,12.7
1082,13802.0,SWEETHEART CAKESTAND 3 TIER,6,186,36,3700,3514,1,72.0
1083,13803.0,SET 20 NAPKINS FAIRY CAKES DESIGN ,1,49,10,1100,1051,0,20.0
1084,13804.0,BLUE HAPPY BIRTHDAY BUNTING,7,422,62,6300,5878,1,124.0
1085,13805.0,SET OF 3 NOTEBOOKS IN PARCEL,2,7,5,600,593,0,10.0
1086,13806.0,SET OF 10 LED DOLLY LIGHTS,1,52,5,600,548,0,10.0
1087,13807.0,WHITE METAL LANTERN,1,36,3,400,364,0,6.0
1088,13808.0,SET 6 PAPER TABLE LANTERN STARS ,5,285,43,4400,4115,1,86.0
1089,13809.0,DANISH ROSE FOLDING CHAIR,1,85,5,600,515,0,10.0
1090,13810.0,GINGERBREAD MAN COOKIE CUTTER,4,1344,21,2200,856,1,42.0
1091,13811.0,RECYCLED ACAPULCO MAT GREEN,4,564,9,1000,436,1,18.0
1092,13812.0,RED RETROSPOT PEG BAG,3,129,19,2000,1871,0,17.200000000000003
1093,13813.0,WRAP ENGLISH ROSE ,5,308,35,3600,3292,1,70.0
1094,13814.0,ALARM CLOCK BAKELIKE GREEN,3,180,32,3300,3120,1,64.0
1095,13815.0,RIBBON REEL POLKADOTS ,5,455,86,8700,8245,1,172.0
1096,13816.0,RED RETROSPOT SUGAR JAM BOWL,4,141,17,1800,1659,0,16.2
1097,13817.0,PLASTERS IN TIN CIRCUS PARADE ,2,77,14,1500,1423,0,12.8
1098,13819.0,LUNCH BAG  BLACK SKULL.,3,72,19,2000,1928,0,18.8
1099,13821.0,ALARM CLOCK BAKELIKE GREEN,2,194,30,3100,2906,1,60.0
1100,13822.0,DECORATIVE WICKER HEART LARGE,2,171,48,4900,4729,1,96.0
1101,13823.0,DOORMAT RED RETROSPOT,2,156,21,2200,2044,1,42.0
1102,13824.0,LUNCH BAG  BLACK SKULL.,5,126,24,2500,2374,0,22.299999999999997
1103,13826.0,SWEETHEART CAKESTAND 3 TIER,2,72,7,800,728,0,14.0
1104,13827.0,TOXIC AREA  DOOR HANGER ,3,348,51,5200,4852,1,102.0
1105,13828.0,LUNCH BAG  BLACK SKULL.,1,28,8,900,872,0,16.0
1106,13829.0,NOVELTY BISCUITS CAKE STAND 3 TIER,1,8,0,100,92,0,0.0
1107,13831.0,TREASURE ISLAND BOOK BOX,6,292,41,4200,3908,1,82.0
1108,13832.0,GARDENERS KNEELING PAD KEEP CALM ,2,10,0,100,90,0,0.0
1109,13833.0,REX CASH+CARRY JUMBO SHOPPER,1,142,21,2200,2058,0,12.0
1110,13835.0,RED RETROSPOT PEG BAG,4,176,28,2900,2724,1,56.0
1111,13837.0,FELTCRAFT BUTTERFLY HEARTS,2,41,10,1100,1059,0,10.2
1112,13838.0,DECORATIVE WICKER HEART LARGE,4,539,83,8400,7861,1,166.0
1113,13841.0,LARGE CHINESE STYLE SCISSOR,1,0,0,100,100,0,0.0
1114,13842.0,MIRROR CORNICE,9,833,93,9400,8567,1,186.0
1115,13844.0,DOORMAT RED RETROSPOT,1,49,9,1000,951,0,10.299999999999999
1116,13845.0,HEART IVORY TRELLIS LARGE,1,17,4,500,483,0,8.0
1117,13846.0,PACK OF 6 SKULL PAPER CUPS,4,207,33,3400,3193,1,66.0
1118,13848.0,SMALL CHINESE STYLE SCISSOR,3,2,2,300,298,0,4.0
1119,13849.0,SET OF 16 VINTAGE SKY BLUE CUTLERY,2,305,54,5500,5195,1,108.0
1120,13850.0,RIBBON REEL SNOWY VILLAGE,2,227,46,4700,4473,1,92.0
1121,13851.0,60 TEATIME FAIRY CAKE CASES,3,181,39,4000,3819,1,78.0
1122,13853.0,REGENCY CAKESTAND 3 TIER,2,108,10,1100,992,0,12.5
1123,13854.0,PINK VINTAGE SPOT BEAKER,29,528,55,5600,5072,1,110.0
1124,13856.0,MOROCCAN TEA GLASS,5,22,7,800,778,0,14.0
1125,13858.0,WALL ART STOP FOR TEA ,1,47,4,500,453,0,8.0
1126,13859.0,I CAN ONLY PLEASE ONE PERSON MUG,1,80,15,1600,1520,0,14.100000000000001
1127,13860.0,LUNCH BAG  BLACK SKULL.,6,270,43,4400,4130,1,86.0
1128,13862.0,LUNCH BAG  BLACK SKULL.,10,245,73,7400,7155,1,146.0
1129,13863.0,GIFT BAG PSYCHEDELIC APPLES,2,53,10,1100,1047,0,11.0
1130,13865.0,RED TEA TOWEL CLASSIC DESIGN,4,117,14,1500,1383,0,15.4
1131,13866.0,SET OF 3 CAKE TINS PANTRY DESIGN ,1,23,4,500,477,0,8.0
1132,13867.0,CARD HOLDER LOVE BIRD SMALL,3,240,37,3800,3560,1,74.0
1133,13868.0,JAM MAKING SET PRINTED,2,61,15,1600,1539,0,14.0
1134,13869.0,LUNCH BAG VINTAGE LEAF DESIGN,4,903,126,12700,11797,1,252.0
1135,13870.0,LUNCH BAG VINTAGE LEAF DESIGN,10,398,57,5800,5402,1,114.0
1136,13871.0,BISCUIT TIN 50'S CHRISTMAS,14,1268,136,13700,12432,1,272.0
1137,13873.0,BLUE POLKADOT GARDEN PARASOL,4,109,12,1300,1191,0,12.899999999999999
1138,13874.0,CREAM WALL PLANTER HEART SHAPED,1,99,9,1000,901,0,18.0
1139,13875.0,WRAP SUKI AND FRIENDS,5,203,47,4800,4597,1,94.0
1140,13876.0,HANGING  BUTTERFLY T-LIGHT HOLDER,1,35,2,300,265,0,4.0
1141,13877.0,RIDGED BONNE JAM JAR T-LIGHT HOLDER,1,3,0,100,97,0,0.0
1142,13878.0,BISCUIT TIN 50'S CHRISTMAS,1,167,22,2300,2133,1,44.0
1143,13880.0,DECORATIVE WICKER HEART LARGE,13,443,73,7400,6957,1,146.0
1144,13881.0,PIG KEYRING WITH LIGHT & SOUND ,22,483,95,9600,9117,1,190.0
1145,13882.0,VINTAGE JINGLE BELLS WREATH,6,239,30,3100,2861,1,60.0
1146,13883.0,IVORY SWEETHEART WIRE LETTER RACK ,9,534,74,7500,6966,1,148.0
1147,13884.0,RIBBON REEL POLKADOTS ,6,212,28,2900,2688,1,56.0
1148,13885.0,HOMEMADE JAM SCENTED CANDLES,2,110,15,1600,1490,0,17.6
1149,13886.0,STOOL HOME SWEET HOME ,1,60,8,900,840,0,16.0
1150,13887.0,BLUE HAPPY BIRTHDAY BUNTING,1,73,8,900,827,0,16.0
1151,13888.0,DECORATIVE WICKER HEART LARGE,2,164,19,2000,1836,1,38.0
1152,13889.0,HOT WATER BOTTLE I AM SO POORLY,1,57,7,800,743,0,14.0
1153,13890.0,VICTORIAN SEWING BOX LARGE,14,394,58,5900,5506,1,116.0
1154,13892.0,ENVELOPE 50 BLOSSOM IMAGES,4,29,14,1500,1471,0,14.5
1155,13893.0,SWEETHEART RECIPE BOOK STAND,1,130,11,1200,1070,0,22.0
1156,13894.0,CHRISTMAS CRAFT WHITE FAIRY ,5,78,18,1900,1822,0,13.700000000000003
1157,13895.0,HEART OF WICKER SMALL,5,351,64,6500,6149,1,128.0
1158,13897.0,PACK OF 12 VINTAGE CHRISTMAS TISSUE,1,33,7,800,767,0,14.0
1159,13898.0,CUTE CATS TAPE,1,31,7,800,769,0,14.0
1160,13899.0,VINTAGE SNAP CARDS,2,57,13,1400,1343,0,26.0
1161,13900.0,HERB MARKER PARSLEY,3,133,25,2600,2467,0,20.7
1162,13901.0,IVORY SWEETHEART WIRE LETTER RACK ,5,557,68,6900,6343,1,136.0
1163,13904.0,PICTURE DOMINOES,2,34,14,1500,1466,0,13.600000000000001
1164,13908.0,RIBBON REEL SNOWY VILLAGE,5,360,60,6100,5740,1,120.0
1165,13911.0,WRAP SUKI AND FRIENDS,9,353,68,6900,6547,1,136.0
1166,13914.0,GINGERBREAD MAN COOKIE CUTTER,3,96,18,1900,1804,0,16.799999999999997
1167,13917.0,HAND WARMER BIRD DESIGN,2,36,9,1000,964,0,18.0
1168,13918.0,GREEN DRAWER KNOB ACRYLIC EDWARDIAN,2,65,14,1500,1435,0,16.7
1169,13919.0,WRAP SUKI AND FRIENDS,3,87,16,1700,1613,0,16.200000000000003
1170,13922.0,LOVE HEART POCKET WARMER,1,34,3,400,366,0,6.0
1171,13923.0,LARGE IVORY HEART WALL ORGANISER,1,59,11,1200,1141,0,10.600000000000001
1172,13924.0,PIG KEYRING WITH LIGHT & SOUND ,11,386,65,6600,6214,1,130.0
1173,13925.0,SET OF 6 TEA TIME BAKING CASES,6,304,26,2700,2396,1,52.0
1174,13926.0,MULTI COLOUR SILVER T-LIGHT HOLDER,1,71,4,500,429,0,8.0
1175,13927.0,12 PENCILS SMALL TUBE RED RETROSPOT,1,56,12,1300,1244,0,12.6
1176,13928.0,ASSORTED COLOUR MINI CASES,4,155,16,1700,1545,1,32.0
1177,13929.0,HEART OF WICKER LARGE,3,57,7,800,743,0,14.0
1178,13930.0,SET/10 BLUE POLKADOT PARTY CANDLES,2,27,9,1000,973,0,18.0
1179,13931.0,SET OF 6 TEA TIME BAKING CASES,3,120,30,3100,2980,0,29.400000000000002
1180,13932.0,WOODEN CROQUET GARDEN SET,1,97,7,800,703,0,14.0
1181,13933.0,HOT WATER BOTTLE I AM SO POORLY,2,79,14,1500,1421,0,13.199999999999998
1182,13934.0,TREASURE ISLAND BOOK BOX,1,98,16,1700,1602,0,14.600000000000001
1183,13936.0,PICTURE DOMINOES,2,42,15,1600,1558,0,15.1
1184,13937.0,RETROSPOT TEA SET CERAMIC 11 PC ,1,15,5,600,585,0,10.0
1185,13938.0,SET OF 6 TEA TIME BAKING CASES,1,7,2,300,293,0,4.0
1186,13939.0,PICTURE DOMINOES,4,56,22,2300,2244,0,24.8
1187,13940.0,DECORATIVE WICKER HEART LARGE,4,152,28,2900,2748,1,56.0
1188,13941.0,SET 6 PAPER TABLE LANTERN STARS ,7,181,23,2400,2219,1,46.0
1189,13946.0,PAPER POCKET TRAVELING FAN ,3,18,5,600,582,0,10.0
1190,13947.0,DECORATIVE WICKER HEART LARGE,1,14,3,400,386,0,6.0
1191,13948.0,DANISH ROSE FOLDING CHAIR,1,11,1,200,189,0,2.0
1192,13949.0,MIRRORED WALL ART LADIES,6,233,77,7800,7567,1,154.0
1193,13950.0,LUNCH BAG  BLACK SKULL.,5,168,19,2000,1832,1,38.0
1194,13951.0,RED RETROSPOT PEG BAG,3,136,24,2500,2364,0,20.6
1195,13952.0,12 PENCILS SMALL TUBE RED RETROSPOT,3,546,66,6700,6154,1,132.0
1196,13953.0,PINK HAPPY BIRTHDAY BUNTING,7,45,12,1300,1255,0,10.399999999999997
1197,13954.0,DOORMAT KEEP CALM AND COME IN,3,181,17,1800,1619,1,34.0
1198,13955.0,SWEETHEART CAKESTAND 3 TIER,2,99,18,1900,1801,0,16.800000000000004
1199,13956.0,BLUE HAPPY BIRTHDAY BUNTING,5,520,72,7300,6780,1,144.0
1200,13958.0,VICTORIAN SEWING BOX LARGE,1,38,2,300,262,0,4.0
1201,13959.0,HAND WARMER UNION JACK,3,202,48,4900,4698,1,96.0
1202,13960.0,WOODEN TREE CHRISTMAS SCANDINAVIAN,2,25,7,800,775,0,14.0
1203,13962.0,SET OF 12  VINTAGE POSTCARD SET,2,77,6,700,623,0,12.0
1204,13963.0,FELTCRAFT CUSHION RABBIT,4,114,21,2200,2086,0,14.699999999999996
1205,13967.0,T-LIGHT GLASS FLUTED ANTIQUE,1,7,1,200,193,0,2.0
1206,13969.0,LUNCH BAG VINTAGE LEAF DESIGN,20,1865,203,20400,18535,1,406.0
1207,13971.0,12 PENCILS SMALL TUBE RED RETROSPOT,11,354,75,7600,7246,1,150.0
1208,13972.0,PAINTED METAL HEART WITH HOLLY BELL,2,38,6,700,662,0,12.0
1209,13973.0,RED RETROSPOT ROUND CAKE TINS,1,41,6,700,659,0,12.0
1210,13974.0,WOODEN TREE CHRISTMAS SCANDINAVIAN,1,61,13,1400,1339,0,10.4
1211,13975.0,LUNCH BAG  BLACK SKULL.,7,747,148,14900,14153,1,296.0
1212,13976.0,DOORMAT RED RETROSPOT,1,35,5,600,565,0,10.0
1213,13978.0,PAINTED METAL HEART WITH HOLLY BELL,2,18,10,1100,1082,0,20.0
1214,13979.0,PACK OF 6 COCKTAIL PARASOL STRAWS,1,98,28,2900,2802,0,28.5
1215,13980.0,STOOL HOME SWEET HOME ,1,43,6,700,657,0,12.0
1216,13982.0,JAM MAKING SET PRINTED,5,258,61,6200,5942,1,122.0
1217,13983.0,WRAP SUKI AND FRIENDS,13,684,48,4900,4216,1,96.0
1218,13984.0,CHRISTMAS TOILET ROLL,6,34,8,900,866,0,16.0
1219,13985.0,LUNCH BAG  BLACK SKULL.,16,840,133,13400,12560,1,266.0
1220,13986.0,SMALL WHITE RETROSPOT MUG IN BOX ,1,24,7,800,776,0,14.0
1221,13988.0,TOXIC AREA  DOOR HANGER ,9,719,119,12000,11281,1,238.0
1222,13989.0,RED RETROSPOT PEG BAG,2,107,21,2200,2093,0,18.5
1223,13990.0,TOTE BAG I LOVE LONDON,1,42,8,900,858,0,16.0
1224,13991.0,LUNCH BAG  BLACK SKULL.,7,130,46,4700,4570,0,39.79999999999998
1225,13992.0,WOODLAND CHARLOTTE BAG,1,5,3,400,395,0,6.0
1226,13993.0,RED RETROSPOT PEG BAG,12,704,65,6600,5896,1,130.0
1227,13994.0,IVORY SWEETHEART WIRE LETTER RACK ,6,590,70,7100,6510,1,140.0
1228,13995.0,LUNCH BAG  BLACK SKULL.,6,192,43,4400,4208,1,86.0
1229,13999.0,LUNCH BAG VINTAGE LEAF DESIGN,15,489,92,9300,8811,1,184.0
1230,14000.0,MULTI COLOUR SILVER T-LIGHT HOLDER,2,29,9,1000,971,0,18.0
1231,14001.0,PAPER BUNTING WHITE LACE,4,142,23,2400,2258,0,18.0
1232,14002.0,TOXIC AREA  DOOR HANGER ,2,113,20,2100,1987,0,20.7
1233,14004.0,LUNCH BAG VINTAGE LEAF DESIGN,7,486,84,8500,8014,1,168.0
1234,14005.0,SET OF 36 DOILIES SPACEBOY DESIGN ,5,185,46,4700,4515,1,92.0
1235,14006.0,GINGERBREAD MAN COOKIE CUTTER,3,71,14,1500,1429,0,15.099999999999998
1236,14009.0,GINGERBREAD MAN COOKIE CUTTER,3,122,24,2500,2378,0,21.799999999999997
1237,14012.0,BLUE HAPPY BIRTHDAY BUNTING,1,31,5,600,569,0,10.0
1238,14013.0,JAM MAKING SET PRINTED,3,46,15,1600,1554,0,18.699999999999996
1239,14014.0,ENVELOPE 50 BLOSSOM IMAGES,1,22,21,2200,2178,0,18.699999999999996
1240,14015.0,GINGERBREAD MAN COOKIE CUTTER,1,62,8,900,838,0,10.399999999999999
1241,14016.0,FLOWER VINE RAFFIA FOOD COVER,5,648,74,7500,6852,1,148.0
1242,14019.0,VINTAGE RED ENAMEL TRIM PLATE,4,177,37,3800,3623,1,74.0
1243,14020.0,CHRISTMAS LIGHTS 10 REINDEER,2,111,18,1900,1789,0,22.400000000000006
1244,14021.0,RECIPE BOX PANTRY YELLOW DESIGN,3,99,12,1300,1201,0,11.4
1245,14022.0,WRAP I LOVE LONDON ,1,36,16,1700,1664,0,14.5
1246,14023.0,DOUGHNUT LIP GLOSS ,2,89,14,1500,1411,0,19.8
1247,14024.0,FLOWER VINE RAFFIA FOOD COVER,2,59,9,1000,941,0,18.0
1248,14027.0,PANTRY HOOK BALLOON WHISK ,1,12,2,300,288,0,4.0
1249,14029.0,WOODEN CROQUET GARDEN SET,2,65,7,800,735,0,14.0
1250,14030.0,RIBBON REEL POLKADOTS ,8,985,112,11300,10315,1,224.0
1251,14031.0,ROUND SNACK BOXES SET OF4 WOODLAND ,23,1185,117,11800,10615,1,234.0
1252,14032.0,WRAP I LOVE LONDON ,18,359,70,7100,6741,1,140.0
1253,14034.0,DOORMAT MERRY CHRISTMAS RED ,4,213,49,5000,4787,1,98.0
1254,14035.0,ROSE 1 WICK MORRIS BOXED CANDLE,5,185,34,3500,3315,1,68.0
1255,14036.0,SPOTTY PINK DUCK DOORSTOP,1,166,18,1900,1734,1,36.0
1256,14037.0,LUNCH BAG  BLACK SKULL.,2,96,19,2000,1904,0,14.200000000000003
1257,14038.0,LUNCH BAG  BLACK SKULL.,4,179,43,4400,4221,1,86.0
1258,14039.0,LUNCH BAG ALPHABET DESIGN,1,12,3,400,388,0,6.0
1259,14040.0,LUNCH BAG  BLACK SKULL.,15,917,105,10600,9683,1,210.0
1260,14041.0,60 TEATIME FAIRY CAKE CASES,1,39,9,1000,961,0,18.0
1261,14044.0,LUNCH BAG  BLACK SKULL.,4,536,94,9500,8964,1,188.0
1262,14045.0,PINK FAIRY CAKE CHILDRENS APRON,4,25,3,400,375,0,6.0
1263,14046.0,LOVE POTION MASALA INCENSE,1,7,7,800,793,0,14.0
1264,14047.0,WELCOME  WOODEN BLOCK LETTERS,7,164,20,2100,1936,1,40.0
1265,14048.0,TOXIC AREA  DOOR HANGER ,2,193,41,4200,4007,1,82.0
1266,14049.0,HAND WARMER UNION JACK,6,1290,173,17400,16110,1,346.0
1267,14050.0,PACK OF 6 SKULL PAPER CUPS,2,83,28,2900,2817,0,27.6
1268,14051.0,WHITE SKULL HOT WATER BOTTLE ,26,1008,96,9700,8692,1,192.0
1269,14052.0,BUNDLE OF 3 SCHOOL EXERCISE BOOKS  ,1,161,31,3200,3039,1,62.0
1270,14053.0,COLOURING PENCILS BROWN TUBE,2,5,2,300,295,0,4.0
1271,14054.0,LUNCH BAG ALPHABET DESIGN,1,9,3,400,391,0,6.0
1272,14055.0,BOX OF VINTAGE JIGSAW BLOCKS ,1,44,6,700,656,0,12.0
1273,14056.0,LUNCH BAG VINTAGE LEAF DESIGN,29,3172,247,24800,21628,1,494.0
1274,14057.0,SET OF 36 DOILIES SPACEBOY DESIGN ,18,552,120,12100,11548,1,240.0
1275,14059.0,FELT EGG COSY CHICKEN,1,18,3,400,382,0,6.0
1276,14060.0,WRAP SUKI AND FRIENDS,20,291,93,9400,9109,1,186.0
1277,14062.0,HOT WATER BOTTLE I AM SO POORLY,12,313,61,6200,5887,1,122.0
1278,14064.0,DECORATIVE WICKER HEART LARGE,7,128,43,4400,4272,0,38.50000000000001
1279,14066.0,CREAM WALL PLANTER HEART SHAPED,1,30,3,400,370,0,6.0
1280,14067.0,DRAWER KNOB CRACKLE GLAZE BLUE,2,148,27,2800,2652,0,29.0
1281,14068.0,HOT WATER BOTTLE I AM SO POORLY,1,98,16,1700,1602,0,10.500000000000002
1282,14071.0,LUNCH BAG  BLACK SKULL.,9,792,138,13900,13108,1,276.0
1283,14073.0,WHITE METAL LANTERN,2,33,6,700,667,0,12.0
1284,14075.0,GINGERBREAD MAN COOKIE CUTTER,3,77,21,2200,2123,0,20.999999999999993
1285,14076.0,REX CASH+CARRY JUMBO SHOPPER,1,92,23,2400,2308,0,27.000000000000004
1286,14077.0,REX CASH+CARRY JUMBO SHOPPER,5,111,21,2200,2089,0,24.1
1287,14078.0,ASS COL SMALL SAND GECKO P'WEIGHT,6,174,34,3500,3326,1,68.0
1288,14079.0,WELCOME  WOODEN BLOCK LETTERS,1,39,6,700,661,0,12.0
1289,14080.0,SEWING SUSAN 21 NEEDLE SET,1,3,2,300,297,0,4.0
1290,14081.0,WHITE SKULL HOT WATER BOTTLE ,4,493,71,7200,6707,1,142.0
1291,14082.0,REX CASH+CARRY JUMBO SHOPPER,1,75,17,1800,1725,0,15.4
1292,14083.0,CHRISTMAS TOILET ROLL,9,507,85,8600,8093,1,170.0
1293,14085.0,RIBBON REEL POLKADOTS ,19,1093,169,17000,15907,1,338.0
1294,14087.0,12 PENCIL SMALL TUBE WOODLAND,2,110,35,3600,3490,0,37.7
1295,14088.0,LUNCH BAG VINTAGE LEAF DESIGN,14,3376,199,20000,16624,1,398.0
1296,14089.0,MONSTERS STENCIL CRAFT,1,30,7,800,770,0,14.0
1297,14090.0,ANTIQUE SILVER TEA GLASS ETCHED,1,1,0,100,99,0,0.0
1298,14092.0,ALARM CLOCK BAKELIKE GREEN,17,593,101,10200,9607,1,202.0
1299,14093.0,TOXIC AREA  DOOR HANGER ,1,156,55,5600,5444,1,110.0
1300,14096.0,SET 7 BABUSHKA NESTING BOXES,34,41376,281,28200,13176,1,562.0
1301,14098.0,PLAYING CARDS I LOVE LONDON ,1,35,10,1100,1065,0,11.299999999999999
1302,14099.0,MIRRORED WALL ART LADIES,12,659,101,10200,9541,1,202.0
1303,14100.0,REX CASH+CARRY JUMBO SHOPPER,1,88,13,1400,1312,0,12.000000000000002
1304,14101.0,SET 12 KIDS COLOUR  CHALK STICKS,6,60,19,2000,1940,0,16.7
1305,14102.0,REX CASH+CARRY JUMBO SHOPPER,8,177,43,4400,4223,1,86.0
1306,14104.0,GLASS BON BON JAR,2,166,10,1100,934,1,20.0
1307,14105.0,WELCOME  WOODEN BLOCK LETTERS,2,221,41,4200,3979,1,82.0
1308,14107.0,LUNCH BAG  BLACK SKULL.,8,330,58,5900,5570,1,116.0
1309,14108.0,JAM MAKING SET PRINTED,3,108,18,1900,1792,0,17.0
1310,14109.0,36 PENCILS TUBE RED RETROSPOT,2,38,7,800,762,0,14.0
1311,14110.0,LUNCH BAG  BLACK SKULL.,13,372,77,7800,7428,1,154.0
1312,14111.0,FRENCH PAISLEY CUSHION COVER ,5,41,6,700,659,0,12.0
1313,14112.0,LUNCH BAG  BLACK SKULL.,12,461,72,7300,6839,1,144.0
1314,14113.0,GINGERBREAD MAN COOKIE CUTTER,8,107,23,2400,2293,0,21.2
1315,14114.0,MOUSE TOY WITH PINK T-SHIRT,2,94,9,1000,906,0,18.0
1316,14116.0,CARD HOLDER LOVE BIRD SMALL,5,234,38,3900,3666,1,76.0
1317,14117.0,ANTIQUE SILVER T-LIGHT GLASS,1,3,1,200,197,0,2.0
1318,14119.0,FAMILY PHOTO FRAME CORNICE,1,9,0,100,91,0,0.0
1319,14121.0,PIG KEYRING WITH LIGHT & SOUND ,6,394,77,7800,7406,1,154.0
1320,14124.0,POPART WOODEN PENCILS ASST,1,1,2,300,299,0,4.0
1321,14125.0,WRAP SUKI AND FRIENDS,3,527,81,8200,7673,1,162.0
1322,14126.0,WOODEN CROQUET GARDEN SET,4,61,8,900,839,0,16.0
1323,14127.0,DOORMAT RED RETROSPOT,3,174,25,2600,2426,1,50.0
1324,14128.0,WOODEN TREE CHRISTMAS SCANDINAVIAN,2,87,25,2600,2513,0,23.4
1325,14129.0,DAISIES  HONEYCOMB GARLAND ,5,142,30,3100,2958,0,27.29999999999999
1326,14130.0,RED RETROSPOT PEG BAG,1,191,30,3100,2909,1,60.0
1327,14132.0,CHRISTMAS CRAFT WHITE FAIRY ,12,346,93,9400,9054,1,186.0
1328,14133.0,SWEETHEART CAKESTAND 3 TIER,5,111,17,1800,1689,0,15.699999999999998
1329,14135.0,WRAP SUKI AND FRIENDS,15,331,70,7100,6769,1,140.0
1330,14138.0,SET OF 5 PANCAKE DAY MAGNETS,2,108,22,2300,2192,0,27.299999999999997
1331,14139.0,MAGIC DRAWING SLATE PURDEY,1,37,15,1600,1563,0,14.799999999999999
1332,14140.0,PICTURE DOMINOES,3,127,32,3300,3173,0,34.300000000000004
1333,14141.0,CRAZY DAISY HEART DECORATION,6,158,24,2500,2342,1,48.0
1334,14142.0,SET 7 BABUSHKA NESTING BOXES,1,38,10,1100,1062,0,10.4
1335,14143.0,VINTAGE SNAKES & LADDERS,1,38,4,500,462,0,8.0
1336,14145.0,EDWARDIAN PARASOL PINK,5,59,5,600,541,0,10.0
1337,14146.0,PIG KEYRING WITH LIGHT & SOUND ,6,653,98,9900,9247,1,196.0
1338,14147.0,VINTAGE UNION JACK BUNTING,3,24,3,400,376,0,6.0
1339,14148.0,BAKING SET SPACEBOY DESIGN,1,22,1,200,178,0,2.0
1340,14149.0,RED RETROSPOT PEG BAG,3,123,17,1800,1677,0,20.400000000000002
1341,14150.0,SMALL HANGING IVORY/RED WOOD BIRD,2,43,9,1000,957,0,10.700000000000001
1342,14152.0,ENVELOPE 50 BLOSSOM IMAGES,3,56,31,3200,3144,0,30.099999999999998
1343,14154.0,FELTCRAFT CUSHION RABBIT,2,410,29,3000,2590,1,58.0
1344,14155.0,EDWARDIAN PARASOL PINK,1,32,2,300,268,0,4.0
1345,14156.0,SET OF 4 POLKADOT PLACEMATS ,66,6544,262,26300,19756,1,524.0
1346,14157.0,HOT WATER BOTTLE I AM SO POORLY,3,108,22,2300,2192,0,26.59999999999999
1347,14158.0,WOODEN TREE CHRISTMAS SCANDINAVIAN,1,63,20,2100,2037,0,20.399999999999995
1348,14159.0,LUNCH BAG VINTAGE LEAF DESIGN,14,1810,252,25300,23490,1,504.0
1349,14161.0,LUNCH BAG VINTAGE LEAF DESIGN,3,343,56,5700,5357,1,112.0
1350,14162.0,REX CASH+CARRY JUMBO SHOPPER,2,97,12,1300,1203,0,13.2
1351,14163.0,DOUGHNUT LIP GLOSS ,4,246,28,2900,2654,1,56.0
1352,14164.0,DECORATIVE WICKER HEART LARGE,2,45,20,2100,2055,0,14.0
1353,14165.0,BLUE POLKADOT EGG CUP ,1,80,13,1400,1320,0,14.100000000000001
1354,14167.0,ROSE SCENT CANDLE IN JEWELLED BOX,4,223,29,3000,2777,1,58.0
1355,14171.0,SET OF 6 TEA TIME BAKING CASES,1,167,30,3100,2933,1,60.0
1356,14173.0,REX CASH+CARRY JUMBO SHOPPER,4,126,16,1700,1574,0,16.800000000000004
1357,14174.0,SET OF 4 NAPKIN CHARMS HEARTS,1,50,12,1300,1250,0,11.1
1358,14175.0,DOORMAT MERRY CHRISTMAS RED ,7,620,68,6900,6280,1,136.0
1359,14176.0,SPOTTY PINK DUCK DOORSTOP,5,112,20,2100,1988,0,17.400000000000002
1360,14177.0,PLASTERS IN TIN CIRCUS PARADE ,5,187,24,2500,2313,1,48.0
1361,14178.0,12 PENCIL SMALL TUBE WOODLAND,7,556,132,13300,12744,1,264.0
1362,14179.0,LUNCH BAG  BLACK SKULL.,2,464,78,7900,7436,1,156.0
1363,14180.0,SET OF 16 VINTAGE SKY BLUE CUTLERY,31,2332,106,10700,8368,1,212.0
1364,14184.0,RETROSPOT LAMP,1,130,10,1100,970,0,11.400000000000002
1365,14185.0,MIRRORED WALL ART PHOTO FRAMES,1,179,2,300,121,1,4.0
1366,14188.0,LUNCH BAG VINTAGE LEAF DESIGN,10,138,38,3900,3762,0,37.800000000000004
1367,14189.0,WRAP SUKI AND FRIENDS,24,605,117,11800,11195,1,234.0
1368,14191.0,CAKE STAND LOVEBIRD 2 TIER WHITE,14,533,111,11200,10667,1,222.0
1369,14193.0,HOT WATER BOTTLE I AM SO POORLY,2,114,25,2600,2486,0,22.599999999999998
1370,14194.0,LUNCH BAG VINTAGE LEAF DESIGN,32,2032,205,20600,18568,1,410.0
1371,14195.0,WOODEN CROQUET GARDEN SET,3,42,5,600,558,0,10.0
1372,14196.0,SET 7 BABUSHKA NESTING BOXES,1,19,2,300,281,0,4.0
1373,14198.0,WRAP ENGLISH ROSE ,7,204,22,2300,2096,1,44.0
1374,14199.0,REGENCY CAKESTAND 3 TIER,1,11,1,200,189,0,2.0
1375,14201.0,SMALLFOLKART BAUBLE CHRISTMAS DEC,9,104,21,2200,2096,0,15.200000000000003
1376,14204.0,REX CASH+CARRY JUMBO SHOPPER,1,105,23,2400,2295,0,18.499999999999996
1377,14205.0,GINGERBREAD MAN COOKIE CUTTER,4,163,19,2000,1837,1,38.0
1378,14206.0,TRADITIONAL MODELLING CLAY,2,45,12,1300,1255,0,10.599999999999998
1379,14208.0,JAM MAKING SET PRINTED,1,35,7,800,765,0,14.0
1380,14209.0,HERB MARKER PARSLEY,7,462,41,4200,3738,1,82.0
1381,14210.0,RED RETROSPOT PEG BAG,7,394,53,5400,5006,1,106.0
1382,14211.0,DECORATIVE WICKER HEART LARGE,13,339,57,5800,5461,1,114.0
1383,14212.0,PACK OF 72 RETROSPOT CAKE CASES,1,11,3,400,389,0,6.0
1384,14213.0,DOORMAT MERRY CHRISTMAS RED ,1,24,3,400,376,0,6.0
1385,14214.0,DRAWER KNOB CRACKLE GLAZE BLUE,7,160,36,3700,3540,1,72.0
1386,14215.0,SMALL PURPLE BABUSHKA NOTEBOOK ,7,242,57,5800,5558,1,114.0
1387,14216.0,DOORMAT KEEP CALM AND COME IN,4,278,28,2900,2622,1,56.0
1388,14217.0,IVORY SWEETHEART WIRE LETTER RACK ,24,605,53,5400,4795,1,106.0
1389,14218.0,BLUE CHARLIE+LOLA PERSONAL DOORSIGN,1,17,6,700,683,0,12.0
1390,14219.0,RETROSPOT CANDLE  MEDIUM,1,16,3,400,384,0,6.0
1391,14220.0,BATH BUILDING BLOCK WORD,2,71,10,1100,1029,0,20.0
1392,14221.0,DECORATIVE WICKER HEART LARGE,10,636,92,9300,8664,1,184.0
1393,14222.0,LUNCH BAG  BLACK SKULL.,1,69,23,2400,2331,0,21.1
1394,14223.0,DOORMAT RED RETROSPOT,4,241,30,3100,2859,1,60.0
1395,14224.0,HEART OF WICKER SMALL,4,455,55,5600,5145,1,110.0
1396,14226.0,HERB MARKER PARSLEY,7,221,43,4400,4179,1,86.0
1397,14227.0,LUNCH BAG VINTAGE LEAF DESIGN,15,525,84,8500,7975,1,168.0
1398,14229.0,FRENCH BLUE METAL DOOR SIGN 3,5,145,24,2500,2355,0,21.700000000000003
1399,14231.0,LUNCH BAG VINTAGE LEAF DESIGN,5,235,25,2600,2365,1,50.0
1400,14232.0,LUNCH BAG  BLACK SKULL.,8,213,57,5800,5587,1,114.0
1401,14233.0,FELTCRAFT CUSHION RABBIT,5,99,18,1900,1801,0,21.200000000000003
1402,14234.0,IVORY SWEETHEART WIRE LETTER RACK ,4,252,78,7900,7648,1,156.0
1403,14235.0,JAM MAKING SET PRINTED,6,163,46,4700,4537,1,92.0
1404,14236.0,PACK OF 72 RETROSPOT CAKE CASES,2,30,7,800,770,0,14.0
1405,14237.0,WOODEN ADVENT CALENDAR RED,1,64,4,500,436,0,8.0
1406,14238.0,WHITE CANDYSTUFT ARTIFICIAL FLOWER,1,18,4,500,482,0,8.0
1407,14239.0,DECORATIVE WICKER HEART LARGE,13,430,61,6200,5770,1,122.0
1408,14240.0,MAGIC DRAWING SLATE PURDEY,2,144,22,2300,2156,0,14.1
1409,14241.0,FUNKY WASHING UP GLOVES ASSORTED,1,19,6,700,681,0,12.0
1410,14242.0,SET OF 3 NOTEBOOKS IN PARCEL,2,59,7,800,741,0,14.0
1411,14243.0,LANTERN CREAM GAZEBO ,14,584,71,7200,6616,1,142.0
1412,14245.0,12 PENCILS SMALL TUBE RED RETROSPOT,5,348,56,5700,5352,1,112.0
1413,14246.0,LUNCH BAG  BLACK SKULL.,3,223,36,3700,3477,1,72.0
1414,14247.0,SWEETHEART CAKESTAND 3 TIER,1,78,8,900,822,0,10.8
1415,14248.0,PINK CREAM FELT CRAFT TRINKET BOX ,1,24,4,500,476,0,8.0
1416,14250.0,12 PENCIL SMALL TUBE WOODLAND,3,276,53,5400,5124,1,106.0
1417,14251.0,SET OF 5 PANCAKE DAY MAGNETS,5,161,35,3600,3439,1,70.0
1418,14256.0,GREEN POLKADOT BOWL,3,223,30,3100,2877,1,60.0
1419,14257.0,STRAWBERRY HONEYCOMB  GARLAND ,6,303,53,5400,5097,1,106.0
1420,14258.0,SWEETHEART CAKESTAND 3 TIER,10,435,60,6100,5665,1,120.0
1421,14259.0,RIBBON REEL HEARTS DESIGN ,1,14,1,200,186,0,2.0
1422,14261.0,JAM MAKING SET PRINTED,2,263,30,3100,2837,1,60.0
1423,14262.0,PAPER BUNTING VINTAGE PARTY,8,298,69,7000,6702,1,138.0
1424,14264.0,CREAM WALL PLANTER HEART SHAPED,3,124,12,1300,1176,0,24.0
1425,14265.0,PAPER LANTERN 5 POINT STAR MOON ,2,181,17,1800,1619,1,34.0
1426,14267.0,SWEETHEART CAKESTAND 3 TIER,7,287,40,4100,3813,1,80.0
1427,14270.0,GINGERBREAD MAN COOKIE CUTTER,1,132,15,1600,1468,0,13.8
1428,14271.0,LARGE HANGING IVORY & RED WOOD BIRD,1,24,6,700,676,0,12.0
1429,14272.0,LANTERN CREAM GAZEBO ,2,74,19,2000,1926,0,16.9
1430,14273.0,RED RETROSPOT PEG BAG,4,72,18,1900,1828,0,14.9
1431,14276.0,BUNDLE OF 3 SCHOOL EXERCISE BOOKS  ,5,192,42,4300,4108,1,84.0
1432,14277.0,TOXIC AREA  DOOR HANGER ,4,872,105,10600,9728,1,210.0
1433,14280.0,ENVELOPE 50 BLOSSOM IMAGES,1,37,4,500,463,0,8.0
1434,14282.0,LUNCH BAG  BLACK SKULL.,15,249,67,6800,6551,1,134.0
1435,14284.0,GREY HEART HOT WATER BOTTLE,3,165,17,1800,1635,1,34.0
1436,14285.0,BOX OF VINTAGE JIGSAW BLOCKS ,4,130,13,1400,1270,0,13.199999999999998
1437,14286.0,WRAP SUKI AND FRIENDS,5,439,123,12400,11961,1,246.0
1438,14287.0,VINTAGE HEADS AND TAILS CARD GAME ,4,23,7,800,777,0,14.0
1439,14288.0,TREASURE ISLAND BOOK BOX,2,60,9,1000,940,0,18.0
1440,14289.0,DOORMAT RED RETROSPOT,6,251,28,2900,2649,1,56.0
1441,14290.0,ALARM CLOCK BAKELIKE GREEN,6,376,48,4900,4524,1,96.0
1442,14291.0,12 PENCIL SMALL TUBE WOODLAND,12,624,110,11100,10476,1,220.0
1443,14292.0,JAM MAKING SET PRINTED,14,361,53,5400,5039,1,106.0
1444,14293.0,LUNCH BAG  BLACK SKULL.,4,134,32,3300,3166,0,31.39999999999999
1445,14295.0,HAND WARMER BIRD DESIGN,2,21,3,400,379,0,6.0
1446,14297.0,DECORATIVE WICKER HEART LARGE,6,156,40,4100,3944,1,80.0
1447,14298.0,LUNCH BAG VINTAGE LEAF DESIGN,45,2455,265,26600,24145,1,530.0
1448,14299.0,SET/6 PINK  BUTTERFLY T-LIGHTS,18,573,73,7400,6827,1,146.0
1449,14300.0,ZINC WILLIE WINKIE  CANDLE STICK,1,4,1,200,196,0,2.0
1450,14301.0,CERAMIC BOWL WITH STRAWBERRY DESIGN,2,21,7,800,779,0,14.0
1451,14304.0,GINGERBREAD MAN COOKIE CUTTER,2,112,15,1600,1488,0,12.5
1452,14305.0,LUNCH BAG  BLACK SKULL.,5,264,52,5300,5036,1,104.0
1453,14306.0,SET 6 PAPER TABLE LANTERN STARS ,3,146,19,2000,1854,0,17.7
1454,14307.0,WHITE SKULL HOT WATER BOTTLE ,6,447,81,8200,7753,1,162.0
1455,14309.0,ENVELOPE 50 BLOSSOM IMAGES,10,308,57,5800,5492,1,114.0
1456,14311.0,BATH BUILDING BLOCK WORD,2,147,15,1600,1453,0,14.599999999999998
1457,14312.0,SWEETHEART CAKESTAND 3 TIER,6,308,46,4700,4392,1,92.0
1458,14314.0,WATERING CAN PINK BUNNY,1,5,3,400,395,0,6.0
1459,14315.0,LETS GO SHOPPING COTTON TOTE BAG,7,381,58,5900,5519,1,116.0
1460,14317.0,DOORMAT MERRY CHRISTMAS RED ,1,74,13,1400,1326,0,11.4
1461,14320.0,GINGERBREAD MAN COOKIE CUTTER,3,82,21,2200,2118,0,20.2
1462,14321.0,DECORATIVE WICKER HEART LARGE,5,174,64,6500,6326,1,128.0
1463,14323.0,GLASS BON BON JAR,4,123,21,2200,2077,0,16.4
1464,14326.0,ICE CREAM SUNDAE LIP GLOSS,2,26,3,400,374,0,6.0
1465,14327.0,MODERN FLORAL STATIONERY SET,1,31,7,800,769,0,14.0
1466,14329.0,LUNCH BAG  BLACK SKULL.,14,776,116,11700,10924,1,232.0
1467,14331.0,RECIPE BOX PANTRY YELLOW DESIGN,2,84,15,1600,1516,0,14.399999999999999
1468,14332.0,REX CASH+CARRY JUMBO SHOPPER,3,55,15,1600,1545,0,14.000000000000002
1469,14333.0,MISELTOE HEART WREATH ,2,159,10,1100,941,1,20.0
1470,14334.0,CHRISTMAS TOILET ROLL,9,545,84,8500,7955,1,168.0
1471,14335.0,REX CASH+CARRY JUMBO SHOPPER,2,144,30,3100,2956,0,31.900000000000002
1472,14336.0,HEART OF WICKER SMALL,4,145,47,4800,4655,0,46.20000000000002
1473,14338.0,BLUE GIANT GARDEN THERMOMETER,4,128,18,1900,1772,0,18.900000000000002
1474,14339.0,PLASTERS IN TIN CIRCUS PARADE ,4,35,11,1200,1165,0,22.0
1475,14340.0,HEART IVORY TRELLIS LARGE,1,17,4,500,483,0,8.0
1476,14341.0,LUNCH BAG VINTAGE LEAF DESIGN,9,337,67,6800,6463,1,134.0
1477,14342.0,PARISIENNE CURIO CABINET,6,75,12,1300,1225,0,16.8
1478,14344.0,FRENCH PAISLEY CUSHION COVER ,8,300,36,3700,3400,1,72.0
1479,14345.0,FAWN BLUE HOT WATER BOTTLE,1,20,2,300,280,0,4.0
1480,14346.0,BLACK/BLUE POLKADOT UMBRELLA,2,276,30,3100,2824,1,60.0
1481,14348.0,COFFEE MUG CAT + BIRD DESIGN,1,53,9,1000,947,0,18.0
1482,14349.0,MORE BUTTER METAL SIGN ,1,71,17,1800,1729,0,14.9
1483,14350.0,WOODEN UNION JACK BUNTING,2,46,9,1000,954,0,11.5
1484,14351.0,LANTERN CREAM GAZEBO ,1,4,0,100,96,0,0.0
1485,14352.0,WOODEN CROQUET GARDEN SET,4,181,26,2700,2519,1,52.0
1486,14353.0,SET OF 3 NOTEBOOKS IN PARCEL,1,8,3,400,392,0,6.0
1487,14354.0,6 RIBBONS RUSTIC CHARM,2,11,6,700,689,0,12.0
1488,14355.0,SET OF 6 T-LIGHTS TOADSTOOLS,1,31,5,600,569,0,10.0
1489,14356.0,MAGIC DRAWING SLATE PURDEY,4,146,17,1800,1654,0,18.4
1490,14357.0,BLACK PIRATE TREASURE CHEST,1,79,23,2400,2321,0,19.900000000000006
1491,14359.0,GLASS BON BON JAR,6,228,31,3200,2972,1,62.0
1492,14360.0,LUNCH BAG VINTAGE LEAF DESIGN,4,365,56,5700,5335,1,112.0
1493,14362.0,12 PENCIL SMALL TUBE WOODLAND,1,95,24,2500,2405,0,18.999999999999993
1494,14364.0,RED RETROSPOT PEG BAG,8,208,34,3500,3292,1,68.0
1495,14367.0,LUNCH BAG  BLACK SKULL.,19,1700,179,18000,16300,1,358.0
1496,14368.0,WOODEN CROQUET GARDEN SET,1,49,5,600,551,0,10.0
1497,14371.0,GRAND CHOCOLATECANDLE,1,15,2,300,285,0,4.0
1498,14373.0,CHALKBOARD KITCHEN ORGANISER,1,46,1,200,154,0,2.0
1499,14375.0,ENVELOPE 50 BLOSSOM IMAGES,1,140,40,4100,3960,0,36.800000000000004
1500,14377.0,3 TIER SWEETHEART GARDEN SHELF,2,100,5,600,500,0,10.0
1501,14379.0,REX CASH+CARRY JUMBO SHOPPER,2,99,26,2700,2601,0,20.500000000000004
1502,14381.0,IVORY SWEETHEART WIRE LETTER RACK ,1,91,30,3100,3009,0,30.099999999999994
1503,14382.0,BLUE HAPPY BIRTHDAY BUNTING,1,210,71,7200,6990,1,142.0
1504,14383.0,PINK VINTAGE SPOT BEAKER,3,196,26,2700,2504,1,52.0
1505,14385.0,LUNCH BAG  BLACK SKULL.,3,22,5,600,578,0,10.0
1506,14386.0,PACK OF 6 SANDCASTLE FLAGS ASSORTED,1,27,4,500,473,0,8.0
1507,14387.0,LUNCH BAG  BLACK SKULL.,3,473,67,6800,6327,1,134.0
1508,14388.0,LUNCH BAG  BLACK SKULL.,10,532,88,8900,8368,1,176.0
1509,14389.0,LUNCH BAG  BLACK SKULL.,5,123,33,3400,3277,0,32.19999999999999
1510,14390.0,LUNCH BAG  BLACK SKULL.,13,912,116,11700,10788,1,232.0
1511,14393.0,PAPER LANTERN 9 POINT SNOW STAR,1,26,1,200,174,0,2.0
1512,14395.0,DECORATIVE WICKER HEART LARGE,12,1003,147,14800,13797,1,294.0
1513,14396.0,DECORATIVE WICKER HEART LARGE,2,191,39,4000,3809,1,78.0
1514,14397.0,BIRDHOUSE GARDEN MARKER ,23,194,44,4500,4306,1,88.0
1515,14400.0,RED RETROSPOT PEG BAG,2,47,14,1500,1453,0,12.899999999999999
1516,14401.0,MIRRORED WALL ART LADIES,14,260,88,8900,8640,1,176.0
1517,14403.0,BIRDHOUSE GARDEN MARKER ,5,174,16,1700,1526,1,32.0
1518,14404.0,LUNCH BAG  BLACK SKULL.,7,320,50,5100,4780,1,100.0
1519,14406.0,JUMBO BAG VINTAGE DOILY ,1,30,3,400,370,0,6.0
1520,14407.0,PINK VINTAGE SPOT BEAKER,9,305,38,3900,3595,1,76.0
1521,14408.0,REX CASH+CARRY JUMBO SHOPPER,7,202,56,5700,5498,1,112.0
1522,14409.0,WRAP SUKI AND FRIENDS,7,153,25,2600,2447,1,50.0
1523,14410.0,LUNCH BAG  BLACK SKULL.,15,714,125,12600,11886,1,250.0
1524,14411.0,3 TIER CAKE TIN RED AND CREAM,1,114,7,800,686,0,14.0
1525,14412.0,SET OF 6 TEA TIME BAKING CASES,3,107,24,2500,2393,0,21.0
1526,14413.0,REX CASH+CARRY JUMBO SHOPPER,1,64,13,1400,1336,0,12.5
1527,14414.0,TOXIC AREA  DOOR HANGER ,8,92,46,4700,4608,0,48.699999999999996
1528,14415.0,LUNCH BAG  BLACK SKULL.,18,1806,209,21000,19194,1,418.0
1529,14416.0,MAGIC DRAWING SLATE PURDEY,2,23,7,800,777,0,14.0
1530,14418.0,TOXIC AREA  DOOR HANGER ,3,265,69,7000,6735,1,138.0
1531,14419.0,IVORY SWEETHEART WIRE LETTER RACK ,6,515,98,9900,9385,1,196.0
1532,14420.0,PINK VINTAGE SPOT BEAKER,2,46,16,1700,1654,0,17.100000000000005
1533,14421.0,BLUE HAPPY BIRTHDAY BUNTING,2,71,13,1400,1329,0,14.4
1534,14422.0,DECORATIVE WICKER HEART LARGE,6,623,102,10300,9677,1,204.0
1535,14423.0,LOVEBIRD HANGING DECORATION WHITE ,1,5,1,200,195,0,2.0
1536,14424.0,SET 6 SCHOOL MILK BOTTLES IN CRATE,1,6,0,100,94,0,0.0
1537,14426.0,PIG KEYRING WITH LIGHT & SOUND ,16,846,117,11800,10954,1,234.0
1538,14427.0,VINTAGE DOILY TRAVEL SEWING KIT,2,33,7,800,767,0,14.0
1539,14428.0,LUNCH BAG  BLACK SKULL.,7,609,76,7700,7091,1,152.0
1540,14431.0,GIN + TONIC DIET METAL SIGN,2,123,11,1200,1077,0,22.0
1541,14432.0,12 PENCIL SMALL TUBE WOODLAND,6,554,144,14500,13946,1,288.0
1542,14434.0,DOORMAT KEEP CALM AND COME IN,6,53,7,800,747,0,14.0
1543,14436.0,METAL SIGN EMPIRE TEA,1,19,3,400,381,0,6.0
1544,14437.0,JAM MAKING SET PRINTED,2,111,2,300,189,0,4.0
1545,14438.0,JUMBO BAG SCANDINAVIAN PAISLEY,1,14,5,600,586,0,10.0
1546,14439.0,HEART OF WICKER SMALL,1,207,17,1800,1593,1,34.0
1547,14440.0,BATH BUILDING BLOCK WORD,5,258,28,2900,2642,1,56.0
1548,14441.0,WOODEN UNION JACK BUNTING,10,369,33,3400,3031,1,66.0
1549,14442.0,SWEETHEART CAKESTAND 3 TIER,5,428,38,3900,3472,1,76.0
1550,14443.0,WRAP SUKI AND FRIENDS,7,247,51,5200,4953,1,102.0
1551,14446.0,LUNCH BAG  BLACK SKULL.,4,538,127,12800,12262,1,254.0
1552,14447.0,PICTURE DOMINOES,5,180,34,3500,3320,1,68.0
1553,14448.0,SWEETHEART CAKESTAND 3 TIER,2,54,10,1100,1046,0,10.1
1554,14449.0,LUNCH BAG  BLACK SKULL.,4,427,115,11600,11173,1,230.0
1555,14450.0,RED RETROSPOT PEG BAG,3,111,19,2000,1889,0,22.299999999999994
1556,14451.0,LUNCH BAG  BLACK SKULL.,2,214,52,5300,5086,1,104.0
1557,14452.0,DECORATIVE WICKER HEART LARGE,2,193,32,3300,3107,1,64.0
1558,14453.0,PAPER LANTERN 5 POINT STAR MOON ,1,83,12,1300,1217,0,24.0
1559,14456.0,LUNCH BAG VINTAGE LEAF DESIGN,14,1737,239,24000,22263,1,478.0
1560,14457.0,SMALL GLASS HEART TRINKET POT,1,5,2,300,295,0,4.0
1561,14459.0,WOODEN CROQUET GARDEN SET,1,127,19,2000,1873,0,19.6
1562,14460.0,"FEATHER PEN,LIGHT PINK",4,14,10,1100,1086,0,20.0
1563,14461.0,SET OF 16 VINTAGE SKY BLUE CUTLERY,3,669,79,8000,7331,1,158.0
1564,14462.0,DECORATIVE WICKER HEART LARGE,15,703,107,10800,10097,1,214.0
1565,14463.0,EDWARDIAN PARASOL NATURAL,3,35,2,300,265,0,4.0
1566,14465.0,MIRROR CORNICE,3,367,66,6700,6333,1,132.0
1567,14466.0,RECIPE BOX PANTRY YELLOW DESIGN,7,273,34,3500,3227,1,68.0
1568,14467.0,REX CASH+CARRY JUMBO SHOPPER,4,248,41,4200,3952,1,82.0
1569,14470.0,REX CASH+CARRY JUMBO SHOPPER,2,208,20,2100,1892,1,40.0
1570,14472.0,ROSE SCENT CANDLE IN JEWELLED BOX,8,777,115,11600,10823,1,230.0
1571,14473.0,SET OF 20 VINTAGE CHRISTMAS NAPKINS,2,28,3,400,372,0,6.0
1572,14474.0,DOORMAT MERRY CHRISTMAS RED ,2,199,18,1900,1701,1,36.0
1573,14475.0,LUNCH BAG  BLACK SKULL.,6,163,25,2600,2437,1,50.0
1574,14476.0,WOODEN UNION JACK BUNTING,1,62,9,1000,938,0,18.0
1575,14477.0,JUMBO BAG PEARS,5,20,8,900,880,0,16.0
1576,14479.0,WOODEN UNION JACK BUNTING,2,72,9,1000,928,0,18.0
1577,14480.0,PINK CREAM FELT CRAFT TRINKET BOX ,1,39,6,700,661,0,12.0
1578,14481.0,12 PENCILS SMALL TUBE RED RETROSPOT,2,59,18,1900,1841,0,16.099999999999998
1579,14482.0,BLUE NETTING STORAGE HANGER,6,351,69,7000,6649,1,138.0
1580,14483.0,PACK OF 6 HANDBAG GIFT BOXES,2,20,5,600,580,0,10.0
1581,14484.0,GLASS APOTHECARY BOTTLE ELIXIR,1,29,7,800,771,0,14.0
1582,14485.0,REX CASH+CARRY JUMBO SHOPPER,1,126,24,2500,2374,0,22.900000000000002
1583,14487.0,HAND WARMER UNION JACK,7,372,70,7100,6728,1,140.0
1584,14488.0,PICTURE DOMINOES,2,109,25,2600,2491,0,20.700000000000003
1585,14489.0,LUNCH BAG  BLACK SKULL.,1,53,18,1900,1847,0,12.7
1586,14491.0,FAMILY ALBUM WHITE PICTURE FRAME,2,77,10,1100,1023,0,20.0
1587,14493.0,ANT COPPER LIME BOUDICCA BRACELET,7,372,59,6000,5628,1,118.0
1588,14494.0,MOUSE TOY WITH PINK T-SHIRT,1,11,5,600,589,0,10.0
1589,14495.0,LARGE CERAMIC TOP STORAGE JAR,2,12,4,500,488,0,8.0
1590,14496.0,HOT WATER BOTTLE I AM SO POORLY,2,107,11,1200,1093,0,10.6
1591,14497.0,HEART OF WICKER SMALL,2,147,18,1900,1753,0,15.600000000000001
1592,14498.0,12 PENCIL SMALL TUBE WOODLAND,5,541,85,8600,8059,1,170.0
1593,14499.0,LUNCH BAG  BLACK SKULL.,3,380,87,8800,8420,1,174.0
1594,14500.0,VICTORIAN GLASS HANGING T-LIGHT,3,43,1,200,157,0,2.0
1595,14501.0,JAM MAKING SET PRINTED,3,24,7,800,776,0,14.0
1596,14502.0,LANTERN CREAM GAZEBO ,14,1524,211,21200,19676,1,422.0
1597,14503.0,SET OF 16 VINTAGE SKY BLUE CUTLERY,6,437,82,8300,7863,1,164.0
1598,14504.0,VINTAGE SNAP CARDS,4,372,59,6000,5628,1,118.0
1599,14505.0,LUNCH BAG VINTAGE LEAF DESIGN,11,2334,222,22300,19966,1,444.0
1600,14506.0,MIRROR CORNICE,5,1063,130,13100,12037,1,260.0
1601,14507.0,FUNKY WASHING UP GLOVES ASSORTED,7,307,49,5000,4693,1,98.0
1602,14508.0,DOORMAT RED RETROSPOT,2,195,32,3300,3105,1,64.0
1603,14511.0,SWEETHEART CAKESTAND 3 TIER,6,181,40,4100,3919,1,80.0
1604,14512.0,FELT EGG COSY WHITE RABBIT ,2,106,14,1500,1394,0,11.200000000000001
1605,14513.0,WHITE BELL HONEYCOMB PAPER GARLAND ,4,46,10,1100,1054,0,20.0
1606,14514.0,JAM MAKING SET PRINTED,3,235,35,3600,3365,1,70.0
1607,14515.0,JUMBO BAG VINTAGE DOILY ,6,282,51,5200,4918,1,102.0
1608,14517.0,T-LIGHT HOLDER SWEETHEART HANGING,2,96,12,1300,1204,0,24.0
1609,14518.0,REX CASH+CARRY JUMBO SHOPPER,1,43,8,900,857,0,16.0
1610,14520.0,POPCORN HOLDER,2,12,2,300,288,0,4.0
1611,14522.0,BALLOON WATER BOMB PACK OF 35,4,43,9,1000,957,0,18.0
1612,14523.0,MIRROR MOSAIC T-LIGHT HOLDER ROUND,1,32,7,800,768,0,14.0
1613,14524.0,BLUE HAPPY BIRTHDAY BUNTING,9,820,95,9600,8780,1,190.0
1614,14525.0,WRAP SUKI AND FRIENDS,13,968,131,13200,12232,1,262.0
1615,14527.0,TRIANGULAR POUFFE VINTAGE ,86,5996,237,23800,17804,1,474.0
1616,14528.0,CLASSIC CHROME BICYCLE BELL ,1,35,10,1100,1065,0,20.0
1617,14529.0,IVORY SWEETHEART WIRE LETTER RACK ,3,450,107,10800,10350,1,214.0
1618,14530.0,VINTAGE JINGLE BELLS WREATH,6,897,100,10100,9203,1,200.0
1619,14532.0,DOORMAT RED RETROSPOT,4,359,32,3300,2941,1,64.0
1620,14533.0,PIG KEYRING WITH LIGHT & SOUND ,9,94,32,3300,3206,0,31.900000000000002
1621,14534.0,HAND WARMER UNION JACK,25,1838,190,19100,17262,1,380.0
1622,14535.0,LUNCH BAG VINTAGE LEAF DESIGN,4,837,138,13900,13063,1,276.0
1623,14536.0,SET 20 NAPKINS FAIRY CAKES DESIGN ,1,91,12,1300,1209,0,24.0
1624,14537.0,FELTCRAFT BUTTERFLY HEARTS,1,29,4,500,471,0,8.0
1625,14538.0,WOODEN UNION JACK BUNTING,2,63,8,900,837,0,16.0
1626,14539.0,CHRISTMAS CRAFT WHITE FAIRY ,2,66,15,1600,1534,0,14.799999999999999
1627,14540.0,GINGERBREAD MAN COOKIE CUTTER,3,293,42,4300,4007,1,84.0
1628,14541.0,REX CASH+CARRY JUMBO SHOPPER,8,273,55,5600,5327,1,110.0
1629,14542.0,BLUE GIANT GARDEN THERMOMETER,1,27,2,300,273,0,4.0
1630,14543.0,WOODEN CROQUET GARDEN SET,21,723,52,5300,4577,1,104.0
1631,14544.0,WHITE SKULL HOT WATER BOTTLE ,2,275,60,6100,5825,1,120.0
1632,14546.0,LUNCH BAG  BLACK SKULL.,9,1142,161,16200,15058,1,322.0
1633,14547.0,DECORATIVE WICKER HEART LARGE,9,1053,148,14900,13847,1,296.0
1634,14548.0,WHITE HANGING HEART T-LIGHT HOLDER,2,10,1,200,190,0,2.0
1635,14549.0,MORE BUTTER METAL SIGN ,1,179,33,3400,3221,1,66.0
1636,14550.0,SET 6 PAPER TABLE LANTERN STARS ,2,104,26,2700,2596,0,23.399999999999995
1637,14551.0,GLASS APOTHECARY BOTTLE PERFUME,2,47,6,700,653,0,12.0
1638,14552.0,LUNCH BAG  BLACK SKULL.,1,108,28,2900,2792,0,26.6
1639,14553.0,LUNCH BAG VINTAGE LEAF DESIGN,5,420,58,5900,5480,1,116.0
1640,14554.0,12 PENCIL SMALL TUBE WOODLAND,4,595,101,10200,9605,1,202.0
1641,14555.0,BLACK RECORD COVER FRAME,2,63,12,1300,1237,0,10.8
1642,14557.0,SET OF 20 VINTAGE CHRISTMAS NAPKINS,2,50,16,1700,1650,0,17.500000000000004
1643,14560.0,SWEETHEART CAKESTAND 3 TIER,24,374,39,4000,3626,1,78.0
1644,14561.0,WOODEN TREE CHRISTMAS SCANDINAVIAN,3,137,37,3800,3663,0,31.2
1645,14562.0,ALARM CLOCK BAKELIKE GREEN,22,1555,173,17400,15845,1,346.0
1646,14565.0,IVORY SWEETHEART WIRE LETTER RACK ,6,503,64,6500,5997,1,128.0
1647,14566.0,JUMBO BAG APPLES,1,7,1,200,193,0,2.0
1648,14567.0,RED RETROSPOT SUGAR JAM BOWL,3,125,18,1900,1775,0,17.9
1649,14569.0,SET/6 PURPLE BUTTERFLY T-LIGHTS,1,47,5,600,553,0,10.0
1650,14570.0,BLACK DROP EARRINGS W LONG BEADS,2,97,14,1500,1403,0,16.0
1651,14572.0,DECORATIVE WICKER HEART LARGE,10,835,119,12000,11165,1,238.0
1652,14573.0,SET 7 BABUSHKA NESTING BOXES,13,1091,107,10800,9709,1,214.0
1653,14576.0,"SWISS ROLL TOWEL, CHOCOLATE  SPOTS",1,2,0,100,98,0,0.0
1654,14577.0,HAND WARMER UNION JACK,4,325,56,5700,5375,1,112.0
1655,14578.0,HOT WATER BOTTLE I AM SO POORLY,1,58,13,1400,1342,0,13.099999999999998
1656,14581.0,MINI PLAYING CARDS SPACEBOY ,1,26,9,1000,974,0,10.499999999999998
1657,14582.0,CHRISTMAS HANGING TREE WITH BELL,1,20,2,300,280,0,4.0
1658,14583.0,LUNCH BAG  BLACK SKULL.,5,658,135,13600,12942,1,270.0
1659,14584.0,MORE BUTTER METAL SIGN ,5,354,52,5300,4946,1,104.0
1660,14585.0,CHRISTMAS LIGHTS 10 REINDEER,1,57,15,1600,1543,0,13.799999999999999
1661,14586.0,12 PENCILS SMALL TUBE RED RETROSPOT,3,17,14,1500,1483,0,12.999999999999998
1662,14587.0,LUNCH BAG  BLACK SKULL.,10,916,161,16200,15284,1,322.0
1663,14589.0,DOORMAT UNION FLAG,1,23,1,200,177,0,2.0
1664,14591.0,LUNCH BAG  BLACK SKULL.,4,553,90,9100,8547,1,180.0
1665,14592.0,HAND WARMER UNION JACK,3,335,78,7900,7565,1,156.0
1666,14593.0,LUNCH BAG  BLACK SKULL.,3,313,79,8000,7687,1,158.0
1667,14594.0,REX CASH+CARRY JUMBO SHOPPER,2,177,26,2700,2523,1,52.0
1668,14595.0,WHITE SKULL HOT WATER BOTTLE ,6,296,52,5300,5004,1,104.0
1669,14597.0,DECORATIVE WICKER HEART LARGE,2,81,26,2700,2619,0,25.7
1670,14598.0,LUNCH BAG  BLACK SKULL.,1,76,21,2200,2124,0,26.7
1671,14600.0,DOORMAT RED RETROSPOT,1,134,13,1400,1266,0,14.700000000000001
1672,14601.0,LAVENDER SCENT CAKE CANDLE,1,10,3,400,390,0,6.0
1673,14603.0,SWISS ROLL TOWEL PINK  SPOTS,1,3,1,200,197,0,2.0
1674,14606.0,SET 7 BABUSHKA NESTING BOXES,128,7839,284,28500,20661,1,568.0
1675,14607.0,DOORMAT RED RETROSPOT,17,251,55,5600,5349,1,110.0
1676,14608.0,FAWN BLUE HOT WATER BOTTLE,4,84,11,1200,1116,0,22.0
1677,14609.0,BROCADE RING PURSE ,4,0,2,300,300,0,4.0
1678,14616.0,CHINESE DRAGON PAPER LANTERNS,3,10,2,300,290,0,4.0
1679,14618.0,ANTIQUE TALL SWIRLGLASS TRINKET POT,4,73,9,1000,927,0,18.0
1680,14619.0,RECYCLED ACAPULCO MAT GREEN,2,104,12,1300,1196,0,10.8
1681,14620.0,DAIRY MAID STRIPE MUG,3,92,16,1700,1608,0,15.099999999999998
1682,14621.0,LUNCH BAG  BLACK SKULL.,6,295,46,4700,4405,1,92.0
1683,14622.0,POLYESTER FILLER PAD 30CMx30CM,1,67,9,1000,933,0,18.0
1684,14623.0,SET 7 BABUSHKA NESTING BOXES,6,415,64,6500,6085,1,128.0
1685,14624.0,LUNCH BAG  BLACK SKULL.,2,26,6,700,674,0,12.0
1686,14625.0,LARGE IVORY HEART WALL ORGANISER,5,285,27,2800,2515,1,54.0
1687,14626.0,HEART OF WICKER SMALL,7,434,59,6000,5566,1,118.0
1688,14627.0,VICTORIAN SEWING BOX SMALL ,1,21,3,400,379,0,6.0
1689,14628.0,GINGERBREAD MAN COOKIE CUTTER,2,109,13,1400,1291,0,13.3
1690,14629.0,RIBBON REEL SNOWY VILLAGE,3,573,73,7400,6827,1,146.0
1691,14631.0,"FEATHER PEN,LIGHT PINK",3,97,20,2100,2003,0,18.800000000000008
1692,14632.0,DOORMAT RED RETROSPOT,1,20,3,400,380,0,6.0
1693,14633.0,WOODEN UNION JACK BUNTING,1,108,10,1100,992,0,11.3
1694,14636.0,SILVER PLATE CANDLE BOWL SMALL,2,85,13,1400,1315,0,10.4
1695,14638.0,SET OF 6 TEA TIME BAKING CASES,1,66,8,900,834,0,16.0
1696,14639.0,DECORATIVE WICKER HEART LARGE,8,839,85,8600,7761,1,170.0
1697,14640.0,SET 7 BABUSHKA NESTING BOXES,8,439,55,5600,5161,1,110.0
1698,14641.0,GIFT BAG PSYCHEDELIC APPLES,1,9,3,400,391,0,6.0
1699,14642.0,PARTY BUNTING,1,6,1,200,194,0,2.0
1700,14643.0,DANISH ROSE FOLDING CHAIR,3,50,17,1800,1750,0,18.999999999999996
1701,14644.0,GINGERBREAD MAN COOKIE CUTTER,4,138,18,1900,1762,0,15.1
1702,14645.0,LUNCH BAG  BLACK SKULL.,2,108,19,2000,1892,0,15.0
1703,14646.0,SET 7 BABUSHKA NESTING BOXES,77,5400,275,27600,22200,1,550.0
1704,14647.0,BAKING MOULD ROSE WHITE CHOCOLATE,1,71,16,1700,1629,0,11.3
1705,14649.0,SMALL HANGING IVORY/RED WOOD BIRD,4,507,91,9200,8693,1,182.0
1706,14651.0,DOORMAT MERRY CHRISTMAS RED ,2,295,47,4800,4505,1,94.0
1707,14652.0,BLUE PAISLEY TISSUE BOX,1,86,16,1700,1614,0,18.2
1708,14653.0,DECORATIVE WICKER HEART LARGE,7,786,105,10600,9814,1,210.0
1709,14655.0,JUMBO BAG VINTAGE DOILY ,5,133,26,2700,2567,0,24.7
1710,14656.0,MORE BUTTER METAL SIGN ,2,221,38,3900,3679,1,76.0
1711,14657.0,FLOWER VINE RAFFIA FOOD COVER,5,354,59,6000,5646,1,118.0
1712,14658.0,PINK PARTY BAGS,2,162,13,1400,1238,1,26.0
1713,14659.0,LUNCH BAG  BLACK SKULL.,12,785,107,10800,10015,1,214.0
1714,14660.0,DAIRY MAID STRIPE MUG,2,70,13,1400,1330,0,14.899999999999999
1715,14661.0,APOTHECARY MEASURING JAR,1,15,2,300,285,0,4.0
1716,14662.0,12 PENCIL SMALL TUBE WOODLAND,4,399,78,7900,7501,1,156.0
1717,14664.0,SET/6 PINK  BUTTERFLY T-LIGHTS,2,196,54,5500,5304,1,108.0
1718,14665.0,HAND WARMER UNION JACK,7,500,58,5900,5400,1,116.0
1719,14666.0,HANGING  BUTTERFLY T-LIGHT HOLDER,1,26,9,1000,974,0,18.0
1720,14667.0,SET 7 BABUSHKA NESTING BOXES,27,1793,195,19600,17807,1,390.0
1721,14669.0,STRAWBERRY RAFFIA FOOD COVER,3,460,83,8400,7940,1,166.0
1722,14670.0,LUNCH BAG PINK POLKADOT,2,215,58,5900,5685,1,116.0
1723,14672.0,SMALL TALL CAMPHOR WOOD TOADSTOOL,2,178,30,3100,2922,1,60.0
1724,14673.0,HOT WATER BOTTLE I AM SO POORLY,5,177,33,3400,3223,1,66.0
1725,14675.0,SET/6 PINK  BUTTERFLY T-LIGHTS,1,227,44,4500,4273,1,88.0
1726,14676.0,BROCADE RING PURSE ,8,76,28,2900,2824,0,21.2
1727,14679.0,CLASSICAL ROSE SMALL VASE,1,2,0,100,98,0,0.0
1728,14680.0,LUNCH BAG  BLACK SKULL.,23,776,134,13500,12724,1,268.0
1729,14681.0,WOODEN ROUNDERS GARDEN SET ,3,50,4,500,450,0,8.0
1730,14682.0,COLOUR GLASS T-LIGHT HOLDER HANGING,2,1,0,100,99,0,0.0
1731,14684.0,LUNCH BAG  BLACK SKULL.,5,713,168,16900,16187,1,336.0
1732,14687.0,IVORY SWEETHEART WIRE LETTER RACK ,1,34,8,900,866,0,16.0
1733,14688.0,LUNCH BAG  BLACK SKULL.,27,753,142,14300,13547,1,284.0
1734,14689.0,LUNCH BAG DOILEY PATTERN ,1,28,5,600,572,0,10.0
1735,14690.0,RED TEA TOWEL CLASSIC DESIGN,3,149,26,2700,2551,0,25.999999999999996
1736,14691.0,BLUE GIANT GARDEN THERMOMETER,5,260,36,3700,3440,1,72.0
1737,14692.0,REX CASH+CARRY JUMBO SHOPPER,5,200,37,3800,3600,1,74.0
1738,14693.0,PARTY METAL SIGN ,1,27,4,500,473,0,8.0
1739,14696.0,"ACRYLIC JEWEL ANGEL,PINK",9,327,70,7100,6773,1,140.0
1740,14697.0,REX CASH+CARRY JUMBO SHOPPER,2,71,12,1300,1229,0,11.6
1741,14698.0,ALARM CLOCK BAKELIKE GREEN,5,603,98,9900,9297,1,196.0
1742,14699.0,BEWARE OF THE CAT METAL SIGN ,1,17,4,500,483,0,8.0
1743,14700.0,LUNCH BAG  BLACK SKULL.,3,272,60,6100,5828,1,120.0
1744,14701.0,MIRRORED WALL ART LADIES,12,1087,129,13000,11913,1,258.0
1745,14702.0,CHRISTMAS CRAFT WHITE FAIRY ,18,1321,141,14200,12879,1,282.0
1746,14703.0,SPOTTY PINK DUCK DOORSTOP,1,45,13,1400,1355,0,26.0
1747,14704.0,12 PENCIL SMALL TUBE WOODLAND,9,926,154,15500,14574,1,308.0
1748,14705.0,JUMBO  BAG BAROQUE BLACK WHITE,1,1,0,100,99,0,0.0
1749,14708.0,PLASTERS IN TIN CIRCUS PARADE ,4,88,14,1500,1412,0,15.699999999999996
1750,14709.0,LUNCH BAG  BLACK SKULL.,14,544,89,9000,8456,1,178.0
1751,14710.0,12 PENCIL SMALL TUBE WOODLAND,4,288,68,6900,6612,1,136.0
1752,14711.0,LUNCH BAG  BLACK SKULL.,12,1703,148,14900,13197,1,296.0
1753,14712.0,HOT WATER BOTTLE I AM SO POORLY,3,82,13,1400,1318,0,12.600000000000001
1754,14713.0,LUNCH BAG  BLACK SKULL.,12,840,142,14300,13460,1,284.0
1755,14714.0,SET 20 NAPKINS FAIRY CAKES DESIGN ,1,32,6,700,668,0,12.0
1756,14715.0,DECORATIVE WICKER HEART LARGE,4,237,39,4000,3763,1,78.0
1757,14716.0,REX CASH+CARRY JUMBO SHOPPER,2,76,27,2800,2724,0,26.0
1758,14719.0,12 PENCIL SMALL TUBE WOODLAND,6,569,110,11100,10531,1,220.0
1759,14720.0,ASSORTED COLOUR MINI CASES,3,212,21,2200,1988,1,42.0
1760,14722.0,REX CASH+CARRY JUMBO SHOPPER,1,87,16,1700,1613,0,14.9
1761,14723.0,12 PENCIL SMALL TUBE WOODLAND,6,624,113,11400,10776,1,226.0
1762,14725.0,REX CASH+CARRY JUMBO SHOPPER,1,228,31,3200,2972,1,62.0
1763,14727.0,ANTIQUE GLASS PEDESTAL BOWL,1,70,5,600,530,0,10.0
1764,14729.0,REX CASH+CARRY JUMBO SHOPPER,1,153,36,3700,3547,1,72.0
1765,14730.0,MAGIC DRAWING SLATE DINOSAUR,8,1265,184,18500,17235,1,368.0
1766,14731.0,REX CASH+CARRY JUMBO SHOPPER,3,94,26,2700,2606,0,25.999999999999996
1767,14732.0,BROCANTE SHELF WITH HOOKS,10,508,70,7100,6592,1,140.0
1768,14733.0,LANTERN CREAM GAZEBO ,15,859,100,10100,9241,1,200.0
1769,14735.0,SET 4 PICNIC CUTLERY CHERRY ,34,759,95,9600,8841,1,190.0
1770,14737.0,WHITE BELL HONEYCOMB PAPER GARLAND ,3,61,7,800,739,0,14.0
1771,14738.0,HOT WATER BOTTLE I AM SO POORLY,9,199,29,3000,2801,1,58.0
1772,14739.0,WHITE BELL HONEYCOMB PAPER GARLAND ,8,124,32,3300,3176,0,26.400000000000006
1773,14740.0,SMALL PURPLE BABUSHKA NOTEBOOK ,4,276,47,4800,4524,1,94.0
1774,14741.0,JAM MAKING SET PRINTED,6,153,29,3000,2847,1,58.0
1775,14744.0,GINGERBREAD MAN COOKIE CUTTER,9,89,13,1400,1311,0,14.0
1776,14745.0,FELT EGG COSY WHITE RABBIT ,6,117,39,4000,3883,0,36.1
1777,14747.0,CHEST OF DRAWERS GINGHAM HEART ,2,121,9,1000,879,0,10.299999999999999
1778,14748.0,HAND WARMER UNION JACK,6,181,49,5000,4819,1,98.0
1779,14752.0,TRADTIONAL ALPHABET STAMP SET,1,12,2,300,288,0,4.0
1780,14753.0,HOT WATER BOTTLE I AM SO POORLY,1,107,15,1600,1493,0,14.100000000000001
1781,14754.0,FELT FARM ANIMAL CHICKEN,2,91,21,2200,2109,0,20.499999999999993
1782,14755.0,ALARM CLOCK BAKELIKE GREEN,12,982,102,10300,9318,1,204.0
1783,14756.0,12 PENCIL SMALL TUBE WOODLAND,1,132,17,1800,1668,0,16.900000000000002
1784,14757.0,PHOTO FRAME LINEN AND LACE LARGE,1,74,11,1200,1126,0,22.0
1785,14758.0,DOORMAT RED RETROSPOT,4,472,36,3700,3228,1,72.0
1786,14759.0,MIRROR CORNICE,3,550,51,5200,4650,1,102.0
1787,14760.0,GLASS JAR MARMALADE ,2,20,4,500,480,0,8.0
1788,14761.0,CREAM FELT EASTER EGG BASKET,2,25,4,500,475,0,8.0
1789,14762.0,LUNCH BAG  BLACK SKULL.,1,28,8,900,872,0,10.899999999999999
1790,14764.0,NATURAL SLATE RECTANGLE CHALKBOARD,2,10,4,500,490,0,8.0
1791,14765.0,REX CASH+CARRY JUMBO SHOPPER,3,116,21,2200,2084,0,20.600000000000005
1792,14766.0,FLOWER VINE RAFFIA FOOD COVER,8,374,66,6700,6326,1,132.0
1793,14768.0,TOADSTOOL MONEY BOX,3,22,2,300,278,0,4.0
1794,14769.0,LUNCH BAG VINTAGE LEAF DESIGN,10,2970,252,25300,22330,1,504.0
1795,14770.0,WELCOME  WOODEN BLOCK LETTERS,2,179,24,2500,2321,1,48.0
1796,14772.0,LANTERN CREAM GAZEBO ,1,31,4,500,469,0,8.0
1797,14775.0,12 PENCIL SMALL TUBE WOODLAND,3,63,33,3400,3337,0,27.300000000000004
1798,14776.0,12 PENCILS SMALL TUBE RED RETROSPOT,13,131,63,6400,6269,0,69.10000000000001
1799,14777.0,S/4 PINK FLOWER CANDLES IN BOWL,2,7,1,200,193,0,2.0
1800,14778.0,GINGERBREAD MAN COOKIE CUTTER,2,109,20,2100,1991,0,15.599999999999998
1801,14779.0,SMALL TALL CAMPHOR WOOD TOADSTOOL,3,279,25,2600,2321,1,50.0
1802,14780.0,SET 6 PAPER TABLE LANTERN STARS ,2,74,16,1700,1626,0,13.9
1803,14782.0,3D HEARTS  HONEYCOMB PAPER GARLAND,1,15,3,400,385,0,6.0
1804,14784.0,CREAM DELPHINIUM ARTIFICIAL FLOWER,2,57,8,900,843,0,16.0
1805,14785.0,GLITTER CHRISTMAS TREE WITH BELLS,2,2,0,100,98,0,0.0
1806,14788.0,12 PENCIL SMALL TUBE WOODLAND,2,77,17,1800,1723,0,12.4
1807,14789.0,CERAMIC HEART FAIRY CAKE MONEY BANK,1,12,2,300,288,0,4.0
1808,14790.0,LUNCH BAG  BLACK SKULL.,4,67,26,2700,2633,0,22.000000000000004
1809,14792.0,AIRLINE BAG VINTAGE TOKYO 78,2,12,1,200,188,0,2.0
1810,14793.0,HOT WATER BOTTLE I AM SO POORLY,2,50,7,800,750,0,14.0
1811,14794.0,RECYCLED ACAPULCO MAT GREEN,9,336,42,4300,3964,1,84.0
1812,14795.0,DOORMAT KEEP CALM AND COME IN,1,44,3,400,356,0,6.0
1813,14796.0,MINI PLAYING CARDS GYMKHANA,27,2322,253,25400,23078,1,506.0
1814,14798.0,GINGERBREAD MAN COOKIE CUTTER,3,17,4,500,483,0,8.0
1815,14799.0,DOORMAT FANCY FONT HOME SWEET HOME,1,63,7,800,737,0,14.0
1816,14800.0,LUNCH BAG  BLACK SKULL.,16,868,147,14800,13932,1,294.0
1817,14801.0,REX CASH+CARRY JUMBO SHOPPER,1,145,34,3500,3355,0,27.1
1818,14803.0,REX CASH+CARRY JUMBO SHOPPER,3,127,20,2100,1973,0,22.3
1819,14804.0,SINGLE HEART ZINC T-LIGHT HOLDER,1,50,6,700,650,0,12.0
1820,14805.0,FLOWER VINE RAFFIA FOOD COVER,4,272,21,2200,1928,1,42.0
1821,14806.0,MOUSE TOY WITH PINK T-SHIRT,1,20,5,600,580,0,10.0
1822,14808.0,SET 7 BABUSHKA NESTING BOXES,15,1236,113,11400,10164,1,226.0
1823,14810.0,LUNCH BAG  BLACK SKULL.,11,593,110,11100,10507,1,220.0
1824,14813.0,REX CASH+CARRY JUMBO SHOPPER,2,84,16,1700,1616,0,13.799999999999999
1825,14815.0,SET OF 6 TEA TIME BAKING CASES,2,87,29,3000,2913,0,28.5
1826,14816.0,BLUE GIANT GARDEN THERMOMETER,1,265,2,300,35,1,4.0
1827,14817.0,LUNCH BAG  BLACK SKULL.,2,222,32,3300,3078,1,64.0
1828,14818.0,SWEETHEART CAKESTAND 3 TIER,3,180,26,2700,2520,1,52.0
1829,14819.0,REGENCY SUGAR TONGS,2,53,8,900,847,0,16.0
1830,14820.0,PACK OF 6 COCKTAIL PARASOL STRAWS,4,93,14,1500,1407,0,13.600000000000001
1831,14821.0,3 HEARTS HANGING DECORATION RUSTIC,1,5,0,100,95,0,0.0
1832,14823.0,SWEETHEART CAKESTAND 3 TIER,3,296,32,3300,3004,1,64.0
1833,14824.0,JUMBO BAG VINTAGE DOILY ,4,69,15,1600,1531,0,14.999999999999998
1834,14825.0,RIBBON REEL POLKADOTS ,12,332,63,6400,6068,1,126.0
1835,14828.0,CHARLOTTE BAG DOLLY GIRL DESIGN,3,48,7,800,752,0,14.0
1836,14829.0,JAM MAKING SET PRINTED,6,98,21,2200,2102,0,19.7
1837,14830.0,ANGEL DECORATION PAINTED ZINC ,1,68,21,2200,2132,0,19.900000000000002
1838,14834.0,RECYCLED ACAPULCO MAT GREEN,8,265,36,3700,3435,1,72.0
1839,14836.0,High Resolution Image,3,16,3,400,384,0,6.0
1840,14837.0,SMALL PURPLE BABUSHKA NOTEBOOK ,5,192,59,6000,5808,1,118.0
1841,14840.0,MOUSE TOY WITH PINK T-SHIRT,1,12,3,400,388,0,6.0
1842,14841.0,12 PENCILS SMALL TUBE RED RETROSPOT,6,440,71,7200,6760,1,142.0
1843,14842.0,SET 7 BABUSHKA NESTING BOXES,8,1121,77,7800,6679,1,154.0
1844,14844.0,BLUE HAPPY BIRTHDAY BUNTING,4,406,64,6500,6094,1,128.0
1845,14847.0,LARGE DECO JEWELLERY STAND,1,48,6,700,652,0,12.0
1846,14849.0,RIBBON REEL SNOWY VILLAGE,28,954,149,15000,14046,1,298.0
1847,14850.0,JAM MAKING SET PRINTED,2,37,13,1400,1363,0,13.600000000000001
1848,14851.0,WOODEN UNION JACK BUNTING,2,64,15,1600,1536,0,14.099999999999998
1849,14852.0,LARGE IVORY HEART WALL ORGANISER,6,437,69,7000,6563,1,138.0
1850,14853.0,REGENCY MILK JUG PINK ,3,63,6,700,637,0,12.0
1851,14854.0,BLUE HAPPY BIRTHDAY BUNTING,8,379,71,7200,6821,1,142.0
1852,14855.0,PINK VINTAGE SPOT BEAKER,2,93,9,1000,907,0,10.8
1853,14856.0,WOODEN CROQUET GARDEN SET,3,206,33,3400,3194,1,66.0
1854,14857.0,BLUE GIANT GARDEN THERMOMETER,3,263,30,3100,2837,1,60.0
1855,14859.0,JAM MAKING SET PRINTED,5,182,29,3000,2818,1,58.0
1856,14860.0,CHRISTMAS CARD SCREEN PRINT ,2,10,7,800,790,0,14.0
1857,14861.0,HOT WATER BOTTLE I AM SO POORLY,1,16,4,500,484,0,8.0
1858,14862.0,BUNDLE OF 3 SCHOOL EXERCISE BOOKS  ,2,103,27,2800,2697,0,21.9
1859,14863.0,4 LILY  BOTANICAL DINNER CANDLES,1,22,4,500,478,0,8.0
1860,14865.0,HAND OPEN SHAPE GOLD,2,2,3,400,398,0,6.0
1861,14866.0,POSTAGE,13,342,54,5500,5158,1,108.0
1862,14867.0,WOODEN BOX ADVENT CALENDAR ,4,144,22,2300,2156,0,18.599999999999998
1863,14868.0,LUNCH BAG  BLACK SKULL.,9,422,71,7200,6778,1,142.0
1864,14869.0,LUNCH BAG VINTAGE LEAF DESIGN,3,216,36,3700,3484,1,72.0
1865,14870.0,FRIDGE MAGNETS LES ENFANTS ASSORTED,1,39,8,900,861,0,16.0
1866,14871.0,TREASURE ISLAND BOOK BOX,4,308,46,4700,4392,1,92.0
1867,14873.0,RED RETROSPOT PEG BAG,1,139,14,1500,1361,0,14.899999999999999
1868,14875.0,GINGERBREAD MAN COOKIE CUTTER,5,222,28,2900,2678,1,56.0
1869,14878.0,VICTORIAN SEWING BOX LARGE,9,323,58,5900,5577,1,116.0
1870,14880.0,GINGERBREAD MAN COOKIE CUTTER,3,175,24,2500,2325,1,48.0
1871,14881.0,12 PENCIL SMALL TUBE WOODLAND,1,23,11,1200,1177,0,22.0
1872,14882.0,GLITTER HEART GARLAND WITH BELLS ,2,43,5,600,557,0,10.0
1873,14883.0,JUMBO BAG VINTAGE DOILY ,7,69,30,3100,3031,0,24.39999999999999
1874,14885.0,PACK OF 72 RETROSPOT CAKE CASES,1,19,9,1000,981,0,18.0
1875,14886.0,BOX OF VINTAGE JIGSAW BLOCKS ,1,56,8,900,844,0,16.0
1876,14887.0,JUMBO BAG VINTAGE DOILY ,1,9,2,300,291,0,4.0
1877,14888.0,LUNCH BAG VINTAGE LEAF DESIGN,1,44,10,1100,1056,0,11.3
1878,14889.0,PAPER BUNTING RETROSPOT,1,22,6,700,678,0,12.0
1879,14890.0,ANT WHITE WIRE HEART SPIRAL,1,20,3,400,380,0,6.0
1880,14891.0,LETS GO SHOPPING COTTON TOTE BAG,2,54,17,1800,1746,0,16.899999999999995
1881,14893.0,VINTAGE JINGLE BELLS WREATH,2,228,40,4100,3872,1,80.0
1882,14894.0,GREY HEART HOT WATER BOTTLE,1,65,10,1100,1035,0,13.4
1883,14895.0,IVORY SWEETHEART WIRE LETTER RACK ,24,2134,183,18400,16266,1,366.0
1884,14896.0,"SWISS ROLL TOWEL, CHOCOLATE  SPOTS",2,103,20,2100,1997,0,25.1
1885,14897.0,HEART OF WICKER SMALL,4,278,28,2900,2622,1,56.0
1886,14898.0,LUNCH BAG  BLACK SKULL.,8,353,58,5900,5547,1,116.0
1887,14901.0,GINGERBREAD MAN COOKIE CUTTER,10,308,45,4600,4292,1,90.0
1888,14902.0,JUMBO BAG VINTAGE DOILY ,2,64,16,1700,1636,0,13.600000000000001
1889,14903.0,BLUE HAPPY BIRTHDAY BUNTING,10,1022,152,15300,14278,1,304.0
1890,14904.0,RED KUKUI COCONUT SEED NECKLACE,2,51,36,3700,3649,0,33.4
1891,14905.0,HEART OF WICKER LARGE,3,41,9,1000,959,0,11.5
1892,14907.0,RIBBON REEL SNOWY VILLAGE,10,584,80,8100,7516,1,160.0
1893,14908.0,IVORY WICKER HEART LARGE,1,32,5,600,568,0,10.0
1894,14910.0,GINGHAM HEART  DOORSTOP RED,7,103,19,2000,1897,0,17.400000000000002
1895,14911.0,LUNCH BAG VINTAGE LEAF DESIGN,248,31060,286,28700,2360,1,572.0
1896,14912.0,"FEATHER PEN,LIGHT PINK",3,80,15,1600,1520,0,14.200000000000001
1897,14913.0,RECYCLED PENCIL WITH RABBIT ERASER,4,105,45,4600,4495,0,43.90000000000001
1898,14915.0,YELLOW METAL CHICKEN HEART ,3,49,6,700,651,0,12.0
1899,14916.0,JAM MAKING SET PRINTED,5,142,43,4400,4258,0,42.70000000000002
1900,14918.0,FOLDING UMBRELLA PINKWHITE POLKADOT,2,157,22,2300,2143,1,44.0
1901,14920.0,WOODEN CROQUET GARDEN SET,2,214,28,2900,2686,1,56.0
1902,14921.0,CHRISTMAS CRAFT WHITE FAIRY ,2,154,37,3800,3646,1,74.0
1903,14923.0,GLITTER HANGING BUTTERFLY STRING,1,151,24,2500,2349,1,48.0
1904,14924.0,JOY LARGE WOOD LETTERS,1,156,5,600,444,1,10.0
1905,14929.0,EMPIRE DESIGN ROSETTE,1,24,3,400,376,0,6.0
1906,14930.0,LUNCH BAG VINTAGE LEAF DESIGN,3,532,64,6500,5968,1,128.0
1907,14931.0,RECIPE BOX PANTRY YELLOW DESIGN,6,791,23,2400,1609,1,46.0
1908,14932.0,DOORMAT RED RETROSPOT,1,160,10,1100,940,1,20.0
1909,14934.0,LUNCH BAG  BLACK SKULL.,3,313,44,4500,4187,1,88.0
1910,14935.0,RAIN PONCHO ,1,26,5,600,574,0,10.0
1911,14936.0,LUNCH BAG  BLACK SKULL.,9,1358,150,15100,13742,1,300.0
1912,14937.0,RED RETROSPOT SUGAR JAM BOWL,4,119,22,2300,2181,0,18.400000000000002
1913,14944.0,BLUE HAPPY BIRTHDAY BUNTING,14,519,85,8600,8081,1,170.0
1914,14946.0,PAPER LANTERN 9 POINT SNOW STAR ,1,14,1,200,186,0,2.0
1915,14947.0,FILIGREE HEART BUTTERFLY WHITE ,2,43,6,700,657,0,12.0
1916,14948.0,GINGERBREAD MAN COOKIE CUTTER,7,179,28,2900,2721,1,56.0
1917,14950.0,ALARM CLOCK BAKELIKE GREEN,2,108,9,1000,892,0,18.0
1918,14951.0,ENVELOPE 50 BLOSSOM IMAGES,1,37,10,1100,1063,0,10.6
1919,14952.0,WHITE SKULL HOT WATER BOTTLE ,15,521,75,7600,7079,1,150.0
1920,14953.0,REX CASH+CARRY JUMBO SHOPPER,1,129,32,3300,3171,0,29.099999999999998
1921,14954.0,COLUMBIAN CUBE CANDLE,1,269,43,4400,4131,1,86.0
1922,14957.0,CHILDRENS APRON APPLES DESIGN,1,20,7,800,780,0,14.0
1923,14958.0,WOODEN CROQUET GARDEN SET,3,245,23,2400,2155,1,46.0
1924,14959.0,HERB MARKER PARSLEY,5,95,33,3400,3305,0,31.300000000000008
1925,14960.0,BLUE POLKADOT GARDEN PARASOL,2,48,15,1600,1552,0,14.799999999999997
1926,14961.0,LUNCH BAG  BLACK SKULL.,12,920,138,13900,12980,1,276.0
1927,14962.0,SWEETHEART WIRE MAGAZINE RACK,1,32,2,300,268,0,4.0
1928,14963.0,12 PENCIL SMALL TUBE WOODLAND,5,450,92,9300,8850,1,184.0
1929,14964.0,REX CASH+CARRY JUMBO SHOPPER,1,44,4,500,456,0,8.0
1930,14965.0,NO JUNK MAIL METAL SIGN,2,196,42,4300,4104,1,84.0
1931,14966.0,REX CASH+CARRY JUMBO SHOPPER,1,74,17,1800,1726,0,20.6
1932,14967.0,PLAYING CARDS JUBILEE UNION JACK,1,17,4,500,483,0,8.0
1933,14968.0,REX CASH+CARRY JUMBO SHOPPER,1,71,18,1900,1829,0,20.000000000000004
1934,14970.0,DOORMAT RED RETROSPOT,4,209,18,1900,1691,1,36.0
1935,14971.0,DECORATIVE WICKER HEART LARGE,3,496,80,8100,7604,1,160.0
1936,14972.0,DOORMAT NEW ENGLAND,1,89,9,1000,911,0,18.0
1937,14973.0,GREEN DRAWER KNOB ACRYLIC EDWARDIAN,3,680,15,1600,920,1,30.0
1938,14974.0,HOT WATER BOTTLE I AM SO POORLY,1,72,10,1100,1028,0,20.0
1939,14975.0,REX CASH+CARRY JUMBO SHOPPER,1,11,8,900,889,0,16.0
1940,14976.0,BATH BUILDING BLOCK WORD,8,291,40,4100,3809,1,80.0
1941,14978.0,LUNCH BAG  BLACK SKULL.,5,975,101,10200,9225,1,202.0
1942,14981.0,TOY TIDY SPACEBOY  ,1,11,4,500,489,0,8.0
1943,14984.0,SET/6 RED SPOTTY PAPER PLATES,2,177,20,2100,1923,1,40.0
1944,14985.0,SMALL PURPLE BABUSHKA NOTEBOOK ,2,166,49,5000,4834,1,98.0
1945,14987.0,WHITE HANGING HEART T-LIGHT HOLDER,2,10,2,300,290,0,4.0
1946,14988.0,BLUE HAPPY BIRTHDAY BUNTING,1,101,20,2100,1999,0,20.900000000000002
1947,14995.0,SET OF 4 POLKADOT PLACEMATS ,2,158,34,3500,3342,1,68.0
1948,14997.0,HEART OF WICKER SMALL,4,16,12,1300,1284,0,12.9
1949,14998.0,REX CASH+CARRY JUMBO SHOPPER,2,183,40,4100,3917,1,80.0
1950,15000.0,REX CASH+CARRY JUMBO SHOPPER,1,218,41,4200,3982,1,82.0
1951,15002.0,LUNCH BAG  BLACK SKULL.,4,292,57,5800,5508,1,114.0
1952,15004.0,BLUE HAPPY BIRTHDAY BUNTING,1,489,73,7400,6911,1,146.0
1953,15005.0,LUNCH BAG VINTAGE LEAF DESIGN,35,2729,257,25800,23071,1,514.0
1954,15006.0,SET 7 BABUSHKA NESTING BOXES,1,276,63,6400,6124,1,126.0
1955,15007.0,WOODEN ROUNDERS GARDEN SET ,1,37,7,800,763,0,14.0
1956,15009.0,PAPER BUNTING WHITE LACE,3,447,82,8300,7853,1,164.0
1957,15010.0,VINTAGE JINGLE BELLS WREATH,1,63,11,1200,1137,0,11.8
1958,15012.0,LUNCH BAG  BLACK SKULL.,2,334,62,6300,5966,1,124.0
1959,15014.0,GINGERBREAD MAN COOKIE CUTTER,2,60,16,1700,1640,0,18.100000000000005
1960,15016.0,PACK OF 6 COCKTAIL PARASOL STRAWS,1,91,12,1300,1209,0,24.0
1961,15017.0,REX CASH+CARRY JUMBO SHOPPER,1,65,7,800,735,0,14.0
1962,15018.0,SET OF 16 VINTAGE SKY BLUE CUTLERY,4,241,15,1600,1359,1,30.0
1963,15019.0,SET OF 4 POLKADOT PLACEMATS ,1,155,34,3500,3345,1,68.0
1964,15021.0,LUNCH BAG  BLACK SKULL.,13,1265,187,18800,17535,1,374.0
1965,15022.0,WHITE SKULL HOT WATER BOTTLE ,4,399,66,6700,6301,1,132.0
1966,15023.0,LUNCH BAG VINTAGE LEAF DESIGN,12,2152,182,18300,16148,1,364.0
1967,15024.0,12 PENCIL SMALL TUBE WOODLAND,10,438,73,7400,6962,1,146.0
1968,15025.0,JUMBO BAG VINTAGE DOILY ,1,193,39,4000,3807,1,78.0
1969,15026.0,LUNCH BAG  BLACK SKULL.,3,132,34,3500,3368,0,31.099999999999998
1970,15027.0,WOODEN CROQUET GARDEN SET,6,146,20,2100,1954,0,17.599999999999998
1971,15028.0,PACK OF 6 SKULL PAPER CUPS,4,95,22,2300,2205,0,26.3
1972,15030.0,VICTORIAN GLASS HANGING T-LIGHT,2,20,2,300,280,0,4.0
1973,15031.0,PLASTERS IN TIN CIRCUS PARADE ,4,351,53,5400,5049,1,106.0
1974,15032.0,LUNCH BAG  BLACK SKULL.,5,104,29,3000,2896,0,29.999999999999996
1975,15033.0,MINI PLAYING CARDS GYMKHANA,11,1078,186,18700,17622,1,372.0
1976,15034.0,LUNCH BAG  BLACK SKULL.,11,1174,158,15900,14726,1,316.0
1977,15035.0,REX CASH+CARRY JUMBO SHOPPER,1,57,12,1300,1243,0,15.099999999999996
1978,15036.0,RECYCLED PENCIL WITH RABBIT ERASER,3,267,61,6200,5933,1,122.0
1979,15038.0,ROSE SCENT CANDLE IN JEWELLED BOX,7,547,68,6900,6353,1,136.0
1980,15039.0,LUNCH BAG VINTAGE LEAF DESIGN,52,4811,264,26500,21689,1,528.0
1981,15041.0,BUNDLE OF 3 SCHOOL EXERCISE BOOKS  ,1,136,35,3600,3464,0,35.6
1982,15042.0,SWEETHEART WIRE FRUIT BOWL,1,27,2,300,273,0,4.0
1983,15043.0,JUMBO BAG PINK VINTAGE PAISLEY,1,5,2,300,295,0,4.0
1984,15044.0,WHITE SKULL HOT WATER BOTTLE ,22,2156,174,17500,15344,1,348.0
1985,15045.0,FAMILY ALBUM WHITE PICTURE FRAME,3,95,9,1000,905,0,18.0
1986,15046.0,IVORY SWEETHEART WIRE LETTER RACK ,16,573,97,9800,9227,1,194.0
1987,15047.0,BLUE GIANT GARDEN THERMOMETER,1,49,13,1400,1351,0,11.399999999999999
1988,15048.0,BLUE HAPPY BIRTHDAY BUNTING,5,246,47,4800,4554,1,94.0
1989,15049.0,SET/6 RED SPOTTY PAPER PLATES,1,5,1,200,195,0,2.0
1990,15050.0,REX CASH+CARRY JUMBO SHOPPER,5,212,41,4200,3988,1,82.0
1991,15051.0,RETROSPOT GIANT TUBE MATCHES,3,321,75,7600,7279,1,150.0
1992,15052.0,LETS GO SHOPPING COTTON TOTE BAG,1,105,16,1700,1595,0,16.799999999999997
1993,15053.0,LUNCH BAG  BLACK SKULL.,3,111,34,3500,3389,0,31.700000000000006
1994,15054.0,12 PENCIL SMALL TUBE WOODLAND,2,195,59,6000,5805,1,118.0
1995,15057.0,WRAP I LOVE LONDON ,2,89,17,1800,1711,0,13.1
1996,15058.0,LUNCH BAG  BLACK SKULL.,11,790,112,11300,10510,1,224.0
1997,15059.0,IVORY SWEETHEART WIRE LETTER RACK ,11,754,111,11200,10446,1,222.0
1998,15060.0,SMALL PURPLE BABUSHKA NOTEBOOK ,4,209,56,5700,5491,1,112.0
1999,15061.0,DOORMAT RED RETROSPOT,55,1043,152,15300,14257,1,304.0
2000,15062.0,TOY TIDY PINK POLKADOT,4,117,36,3700,3583,0,31.2
2001,15063.0,GIN + TONIC DIET METAL SIGN,1,42,2,300,258,0,4.0
2002,15065.0,VINTAGE KEEPSAKE BOX TRAVELOGUE,6,799,76,7700,6901,1,152.0
2003,15066.0,HOT WATER BOTTLE I AM SO POORLY,2,249,25,2600,2351,1,50.0
2004,15067.0,SET 7 BABUSHKA NESTING BOXES,3,259,42,4300,4041,1,84.0
2005,15068.0,12 PENCILS SMALL TUBE RED RETROSPOT,2,265,52,5300,5035,1,104.0
2006,15069.0,MEDIUM CERAMIC TOP STORAGE JAR,1,316,34,3500,3184,1,68.0
2007,15070.0,PAPER CHAIN KIT 50'S CHRISTMAS ,1,2,0,100,98,0,0.0
2008,15071.0,HEART OF WICKER SMALL,2,120,12,1300,1180,0,12.9
2009,15073.0,ZINC WILLIE WINKIE  CANDLE STICK,4,195,34,3500,3305,1,68.0
2010,15074.0,GINGERBREAD MAN COOKIE CUTTER,1,92,23,2400,2308,0,20.700000000000003
2011,15075.0,SET OF 6 TEA TIME BAKING CASES,1,89,12,1300,1211,0,14.300000000000002
2012,15076.0,HERB MARKER PARSLEY,1,149,24,2500,2351,0,26.4
2013,15078.0,BLUE HAPPY BIRTHDAY BUNTING,38,1094,180,18100,17006,1,360.0
2014,15079.0,HERB MARKER PARSLEY,5,218,26,2700,2482,1,52.0
2015,15081.0,ANTIQUE HEART SHELF UNIT,6,176,18,1900,1724,1,36.0
2016,15083.0,BLUE SAVANNAH PICNIC HAMPER FOR 2,1,33,3,400,367,0,6.0
2017,15087.0,FELTCRAFT BUTTERFLY HEARTS,1,30,9,1000,970,0,18.0
2018,15088.0,WELCOME  WOODEN BLOCK LETTERS,3,320,33,3400,3080,1,66.0
2019,15089.0,ANT COPPER LIME BOUDICCA BRACELET,6,481,66,6700,6219,1,132.0
2020,15090.0,CACTI T-LIGHT CANDLES,1,81,12,1300,1219,0,13.6
2021,15091.0,TREASURE ISLAND BOOK BOX,2,59,20,2100,2041,0,16.3
2022,15092.0,RED RETROSPOT PEG BAG,2,139,13,1400,1261,0,13.299999999999999
2023,15093.0,DOORMAT RED RETROSPOT,9,315,52,5300,4985,1,104.0
2024,15095.0,GLASS BON BON JAR,5,124,26,2700,2576,0,24.000000000000004
2025,15096.0,WOODEN BOX OF DOMINOES,1,34,4,500,466,0,8.0
2026,15097.0,SET OF 6 TEA TIME BAKING CASES,1,56,15,1600,1544,0,11.9
2027,15098.0,Manual,5,40278,1,200,40078,1,2.0
2028,15099.0,I'M ON HOLIDAY METAL SIGN,1,47,15,1600,1553,0,12.200000000000001
2029,15100.0,VICTORIAN SEWING BOX LARGE,6,65,3,400,335,0,6.0
2030,15101.0,EDWARDIAN PARASOL NATURAL,3,26,4,500,474,0,8.0
2031,15103.0,GINGERBREAD MAN COOKIE CUTTER,2,197,17,1800,1603,1,34.0
2032,15104.0,SWEETHEART CAKESTAND 3 TIER,3,399,31,3200,2801,1,62.0
2033,15105.0,HOMEMADE JAM SCENTED CANDLES,7,243,55,5600,5357,1,110.0
2034,15106.0,PIG KEYRING WITH LIGHT & SOUND ,7,256,48,4900,4644,1,96.0
2035,15107.0,CHILDS BREAKFAST SET SPACEBOY ,8,118,11,1200,1082,0,22.0
2036,15108.0,JAM MAKING SET PRINTED,5,294,32,3300,3006,1,64.0
2037,15109.0,PAPER BUNTING WHITE LACE,2,182,16,1700,1518,1,32.0
2038,15110.0,ALARM CLOCK BAKELIKE GREEN,7,279,22,2300,2021,1,44.0
2039,15111.0,HOT WATER BOTTLE I AM SO POORLY,3,309,42,4300,3991,1,84.0
2040,15113.0,PIG KEYRING WITH LIGHT & SOUND ,4,220,52,5300,5080,1,104.0
2041,15114.0,12 PENCIL SMALL TUBE WOODLAND,10,305,87,8800,8495,1,174.0
2042,15115.0,12 PENCILS TALL TUBE WOODLAND,1,78,11,1200,1122,0,22.0
2043,15116.0,RED RETROSPOT SUGAR JAM BOWL,4,124,23,2400,2276,0,22.500000000000004
2044,15117.0,LUNCH BAG  BLACK SKULL.,6,177,38,3900,3723,1,76.0
2045,15118.0,GIRLS ALPHABET IRON ON PATCHES ,1,0,0,100,100,0,0.0
2046,15119.0,RIBBON REEL CHRISTMAS PRESENT ,1,108,6,700,592,0,12.0
2047,15120.0,WRAP ENGLISH ROSE ,2,107,14,1500,1393,0,28.0
2048,15121.0,RECIPE BOX PANTRY YELLOW DESIGN,2,118,15,1600,1482,0,12.9
2049,15122.0,GINGERBREAD MAN COOKIE CUTTER,6,279,39,4000,3721,1,78.0
2050,15123.0,12 PENCIL SMALL TUBE WOODLAND,2,323,47,4800,4477,1,94.0
2051,15124.0,HERB MARKER PARSLEY,2,33,9,1000,967,0,18.0
2052,15125.0,LUNCH BAG VINTAGE LEAF DESIGN,23,498,68,6900,6402,1,136.0
2053,15127.0,GIN + TONIC DIET METAL SIGN,1,29,9,1000,971,0,18.0
2054,15128.0,SET OF 4 POLKADOT PLACEMATS ,8,242,55,5600,5358,1,110.0
2055,15129.0,GLASS BON BON JAR,11,244,39,4000,3756,1,78.0
2056,15130.0,RED HEART SHAPE LOVE BUCKET ,1,53,14,1500,1447,0,11.6
2057,15132.0,GREY HEART HOT WATER BOTTLE,5,107,27,2800,2693,0,23.399999999999995
2058,15133.0,SET OF 4 POLKADOT PLACEMATS ,3,64,14,1500,1436,0,12.099999999999998
2059,15134.0,TREASURE ISLAND BOOK BOX,8,167,40,4100,3933,1,80.0
2060,15135.0,DELUXE SEWING KIT ,2,38,5,600,562,0,10.0
2061,15136.0,GINGERBREAD MAN COOKIE CUTTER,5,144,39,4000,3856,0,34.10000000000001
2062,15139.0,PACK OF 20 SPACEBOY NAPKINS,2,17,8,900,883,0,16.0
2063,15140.0,SET OF 6 TEA TIME BAKING CASES,8,213,42,4300,4087,1,84.0
2064,15142.0,CARD HOLDER LOVE BIRD SMALL,1,62,15,1600,1538,0,16.5
2065,15143.0,SET OF 3 NOTEBOOKS IN PARCEL,1,39,8,900,861,0,16.0
2066,15144.0,LUNCH BAG  BLACK SKULL.,18,631,95,9600,8969,1,190.0
2067,15145.0,WOODEN CROQUET GARDEN SET,4,228,33,3400,3172,1,66.0
2068,15146.0,SET/6 PINK  BUTTERFLY T-LIGHTS,3,143,50,5100,4957,0,48.99999999999999
2069,15147.0,12 PENCILS TALL TUBE WOODLAND,2,88,16,1700,1612,0,15.399999999999999
2070,15148.0,FELTCRAFT GIRL AMELIE KIT,1,50,10,1100,1050,0,12.300000000000002
2071,15149.0,IVORY SWEETHEART WIRE LETTER RACK ,1,136,10,1100,964,0,11.200000000000001
2072,15150.0,RIBBON REEL SNOWY VILLAGE,11,1005,152,15300,14295,1,304.0
2073,15152.0,PAPER BUNTING VINTAGE PARTY,16,982,118,11900,10918,1,236.0
2074,15153.0,HEART OF WICKER SMALL,1,102,12,1300,1198,0,11.9
2075,15154.0,LUNCH BAG VINTAGE LEAF DESIGN,2,307,48,4900,4593,1,96.0
2076,15156.0,WOODEN CROQUET GARDEN SET,3,156,33,3400,3244,1,66.0
2077,15157.0,CAKE STAND LOVEBIRD 2 TIER WHITE,5,247,70,7100,6853,1,140.0
2078,15158.0,FAWN BLUE HOT WATER BOTTLE,1,12,4,500,488,0,8.0
2079,15159.0,LUNCH BAG VINTAGE LEAF DESIGN,34,2041,199,20000,17959,1,398.0
2080,15160.0,CHICK GREY HOT WATER BOTTLE,1,6,1,200,194,0,2.0
2081,15163.0,SMALL TALL CAMPHOR WOOD TOADSTOOL,2,70,17,1800,1730,0,15.700000000000001
2082,15164.0,DECORATIVE WICKER HEART LARGE,3,303,47,4800,4497,1,94.0
2083,15165.0,HOMEMADE JAM SCENTED CANDLES,1,134,16,1700,1566,0,11.899999999999999
2084,15167.0,RED TEA TOWEL CLASSIC DESIGN,1,109,22,2300,2191,0,20.4
2085,15168.0,WOODEN ADVENT CALENDAR RED,1,16,2,300,284,0,4.0
2086,15171.0,PAPER BUNTING RETROSPOT,2,23,4,500,477,0,8.0
2087,15172.0,LUNCH BAG  BLACK SKULL.,5,229,54,5500,5271,1,108.0
2088,15174.0,T-LIGHT HOLDER SWEETHEART HANGING,1,17,6,700,683,0,12.0
2089,15175.0,VINTAGE SNAP CARDS,1,17,12,1300,1283,0,13.7
2090,15178.0,STRAWBERRY CHARLOTTE BAG,1,4,1,200,196,0,2.0
2091,15179.0,BLUE HAPPY BIRTHDAY BUNTING,7,248,47,4800,4552,1,94.0
2092,15180.0,HOT WATER BOTTLE I AM SO POORLY,1,19,2,300,281,0,4.0
2093,15181.0,SET OF 3 NOTEBOOKS IN PARCEL,5,32,8,900,868,0,16.0
2094,15182.0,GLITTER HANGING BUTTERFLY STRING,2,86,15,1600,1514,0,15.6
2095,15184.0,RIBBON REEL POLKADOTS ,2,201,30,3100,2899,1,60.0
2096,15185.0,12 PENCIL SMALL TUBE WOODLAND,1,48,9,1000,952,0,11.400000000000002
2097,15186.0,RIBBON REEL HEARTS DESIGN ,2,64,10,1100,1036,0,20.0
2098,15187.0,GINGERBREAD MAN COOKIE CUTTER,18,291,46,4700,4409,1,92.0
2099,15189.0,BLUE HAPPY BIRTHDAY BUNTING,53,1011,106,10700,9689,1,212.0
2100,15192.0,BISCUITS SMALL BOWL LIGHT BLUE,3,128,27,2800,2672,0,27.6
2101,15193.0,DOORMAT KEEP CALM AND COME IN,1,121,6,700,579,0,12.0
2102,15194.0,MIRROR CORNICE,22,792,139,14000,13208,1,278.0
2103,15195.0,METAL SIGN TAKE IT OR LEAVE IT ,1,2,0,100,98,0,0.0
2104,15197.0,WRAP I LOVE LONDON ,5,134,20,2100,1966,0,17.5
2105,15198.0,EMPIRE BIRTHDAY CARD,2,18,5,600,582,0,10.0
2106,15199.0,BLUE HAPPY BIRTHDAY BUNTING,4,59,6,700,641,0,12.0
2107,15201.0,JAM MAKING SET PRINTED,11,158,54,5500,5342,1,108.0
2108,15203.0,LUNCH BAG  BLACK SKULL.,6,178,74,7500,7322,1,148.0
2109,15204.0,SPACEBOY CHILDRENS EGG CUP,1,21,3,400,379,0,6.0
2110,15205.0,DAIRY MAID STRIPE MUG,3,140,18,1900,1760,0,20.499999999999993
2111,15206.0,ROSES REGENCY TEACUP AND SAUCER ,4,24,3,400,376,0,6.0
2112,15208.0,DOORMAT BLACK FLOCK ,6,205,23,2400,2195,1,46.0
2113,15210.0,SET/20 RED RETROSPOT PAPER NAPKINS ,1,126,10,1100,974,0,11.1
2114,15211.0,PHOTO FRAME LINEN AND LACE LARGE,2,285,26,2700,2415,1,52.0
2115,15212.0,HEART IVORY TRELLIS LARGE,2,29,4,500,471,0,8.0
2116,15213.0,JAM MAKING SET PRINTED,3,38,13,1400,1362,0,13.5
2117,15214.0,DOORMAT MERRY CHRISTMAS RED ,8,266,55,5600,5334,1,110.0
2118,15215.0,HOT WATER BOTTLE I AM SO POORLY,6,247,21,2200,1953,1,42.0
2119,15216.0,LUNCH BAG  BLACK SKULL.,1,9,0,100,91,0,0.0
2120,15218.0,JUMBO BAG RED RETROSPOT,11,513,75,7600,7087,1,150.0
2121,15219.0,SET OF 16 VINTAGE PISTACHIO CUTLERY,1,88,4,500,412,0,8.0
2122,15220.0,HEART OF WICKER SMALL,7,303,60,6100,5797,1,120.0
2123,15221.0,CAKE STAND VICTORIAN FILIGREE LARGE,2,140,3,400,260,0,6.0
2124,15222.0,LUNCH BAG SUKI  DESIGN ,1,6,2,300,294,0,4.0
2125,15223.0,PARTY METAL SIGN ,3,122,18,1900,1778,0,19.2
2126,15224.0,STRAWBERRY CERAMIC TRINKET BOX,3,56,8,900,844,0,16.0
2127,15225.0,HOT WATER BOTTLE I AM SO POORLY,1,79,10,1100,1021,0,10.599999999999998
2128,15226.0,PACK OF 12 HEARTS DESIGN TISSUES ,1,30,3,400,370,0,6.0
2129,15227.0,EASTER TIN BUNNY BOUQUET,5,265,30,3100,2835,1,60.0
2130,15228.0,RIBBON REEL SNOWY VILLAGE,5,401,63,6400,5999,1,126.0
2131,15230.0,PAPER BUNTING WHITE LACE,2,40,12,1300,1260,0,11.800000000000002
2132,15232.0,DOUGHNUT LIP GLOSS ,2,31,16,1700,1669,0,16.9
2133,15234.0,PACK OF 12 HEARTS DESIGN TISSUES ,1,23,8,900,877,0,16.0
2134,15235.0,TOXIC AREA  DOOR HANGER ,12,427,68,6900,6473,1,136.0
2135,15236.0,JAM MAKING SET PRINTED,1,24,10,1100,1076,0,20.0
2136,15237.0,PAPER BUNTING WHITE LACE,4,249,47,4800,4551,1,94.0
2137,15238.0,HOT WATER BOTTLE I AM SO POORLY,5,249,26,2700,2451,1,52.0
2138,15239.0,GINGERBREAD MAN COOKIE CUTTER,3,112,32,3300,3188,0,28.3
2139,15240.0,HOT WATER BOTTLE I AM SO POORLY,7,214,45,4600,4386,1,90.0
2140,15241.0,WRAP SUKI AND FRIENDS,9,212,57,5800,5588,1,114.0
2141,15243.0,BLUE HAPPY BIRTHDAY BUNTING,1,53,11,1200,1147,0,12.000000000000002
2142,15244.0,DOORMAT RED RETROSPOT,2,79,19,2000,1921,0,15.9
2143,15245.0,PLASTERS IN TIN CIRCUS PARADE ,3,167,49,5000,4833,1,98.0
2144,15246.0,GLITTER HANGING BUTTERFLY STRING,2,98,15,1600,1502,0,15.6
2145,15247.0,POLYESTER FILLER PAD 40x40cm,1,12,3,400,388,0,6.0
2146,15249.0,12 PENCIL SMALL TUBE WOODLAND,15,997,154,15500,14503,1,308.0
2147,15251.0,BISCUIT TIN 50'S CHRISTMAS,15,473,61,6200,5727,1,122.0
2148,15252.0,RED RETROSPOT PEG BAG,2,90,23,2400,2310,0,23.1
2149,15253.0,JAM MAKING SET PRINTED,6,91,28,2900,2809,0,27.099999999999998
2150,15254.0,HEADS AND TAILS SPORTING FUN,1,36,10,1100,1064,0,20.0
2151,15255.0,WRAP ENGLISH ROSE ,1,129,26,2700,2571,0,24.8
2152,15256.0,AREA PATROLLED METAL SIGN,1,10,1,200,190,0,2.0
2153,15257.0,SUNSET COLOUR CHUNKY KNITTED THROW,2,301,3,400,99,1,6.0
2154,15258.0,RED RETROSPOT SUGAR JAM BOWL,2,191,18,1900,1709,1,36.0
2155,15260.0,WOODEN CROQUET GARDEN SET,8,268,39,4000,3732,1,78.0
2156,15261.0,SET OF 6 TEA TIME BAKING CASES,1,22,9,1000,978,0,10.399999999999999
2157,15262.0,IVORY HANGING DECORATION  BIRD,1,32,5,600,568,0,10.0
2158,15263.0,VINTAGE UNION JACK BUNTING,1,35,5,600,565,0,10.0
2159,15264.0,HANGING JAM JAR T-LIGHT HOLDERS,1,53,12,1300,1247,0,11.899999999999999
2160,15265.0,WELCOME  WOODEN BLOCK LETTERS,2,375,41,4200,3825,1,82.0
2161,15266.0,DOORMAT SPOTTY HOME SWEET HOME,1,40,3,400,360,0,6.0
2162,15267.0,OFFICE MUG WARMER BLACK+SILVER ,5,20,7,800,780,0,14.0
2163,15269.0,REGENCY MIRROR WITH SHUTTERS,1,149,0,100,49,0,0.0
2164,15270.0,HEART OF WICKER SMALL,9,291,22,2300,2009,1,44.0
2165,15271.0,LUNCH BAG  BLACK SKULL.,16,754,116,11700,10946,1,232.0
2166,15272.0,DAIRY MAID STRIPE MUG,2,259,33,3400,3141,1,66.0
2167,15274.0,PICTURE DOMINOES,2,96,24,2500,2404,0,22.400000000000002
2168,15275.0,WOODEN TREE CHRISTMAS SCANDINAVIAN,2,139,20,2100,1961,0,22.499999999999996
2169,15276.0,GINGERBREAD MAN COOKIE CUTTER,1,125,27,2800,2675,0,27.800000000000008
2170,15277.0,"FANCY FONT BIRTHDAY CARD, ",1,21,6,700,679,0,12.0
2171,15279.0,SWEETHEART CAKESTAND 3 TIER,2,80,10,1100,1020,0,10.200000000000001
2172,15280.0,75 BLACK PETIT FOUR CASES,1,12,7,800,788,0,14.0
2173,15281.0,SET OF 16 VINTAGE SKY BLUE CUTLERY,12,604,73,7400,6796,1,146.0
2174,15286.0,HOT WATER BOTTLE KEEP CALM,1,13,1,200,187,0,2.0
2175,15287.0,LUNCH BAG  BLACK SKULL.,3,52,11,1200,1148,0,22.0
2176,15288.0,RIBBON REEL SNOWY VILLAGE,5,292,53,5400,5108,1,106.0
2177,15289.0,GINGERBREAD MAN COOKIE CUTTER,4,71,29,3000,2929,0,32.400000000000006
2178,15290.0,HAND WARMER UNION JACK,21,687,97,9800,9113,1,194.0
2179,15291.0,DOORMAT RED RETROSPOT,20,551,51,5200,4649,1,102.0
2180,15292.0,WOODEN CROQUET GARDEN SET,1,115,14,1500,1385,0,10.6
2181,15296.0,SET OF 4 POLKADOT PLACEMATS ,10,716,88,8900,8184,1,176.0
2182,15297.0,GLASS BON BON JAR,4,113,20,2100,1987,0,19.699999999999996
2183,15298.0,CHRISTMAS TOILET ROLL,14,470,91,9200,8730,1,182.0
2184,15299.0,SMALL TAHITI BEACH BAG,11,1337,6,700,637,1,12.0
2185,15300.0,GINGERBREAD MAN COOKIE CUTTER,1,80,14,1500,1420,0,13.099999999999998
2186,15301.0,BISCUIT TIN 50'S CHRISTMAS,14,754,112,11300,10546,1,224.0
2187,15303.0,WELCOME  WOODEN BLOCK LETTERS,1,119,19,2000,1881,0,15.100000000000001
2188,15304.0,REGENCY MILK JUG PINK ,10,182,13,1400,1218,1,26.0
2189,15306.0,WELCOME  WOODEN BLOCK LETTERS,3,153,29,3000,2847,1,58.0
2190,15307.0,PINK DIAMANTE PEN IN GIFT BOX,1,80,5,600,520,0,10.0
2191,15308.0,RECIPE BOX PANTRY YELLOW DESIGN,2,84,12,1300,1216,0,13.1
2192,15311.0,SET OF 4 POLKADOT PLACEMATS ,118,6267,277,27800,21533,1,554.0
2193,15312.0,IVORY SWEETHEART WIRE LETTER RACK ,5,112,24,2500,2388,0,18.100000000000005
2194,15313.0,JUMBO BAG RED RETROSPOT,1,2,0,100,98,0,0.0
2195,15314.0,JAM MAKING SET PRINTED,1,41,15,1600,1559,0,12.6
2196,15315.0,WOODEN TREE CHRISTMAS SCANDINAVIAN,3,33,19,2000,1967,0,18.099999999999998
2197,15316.0,JUMBO BAG OWLS,1,1,0,100,99,0,0.0
2198,15318.0,SET 7 BABUSHKA NESTING BOXES,1,19,17,1800,1781,0,17.299999999999997
2199,15319.0,CREAM WALL PLANTER HEART SHAPED,1,51,9,1000,949,0,18.0
2200,15320.0,12 PENCILS SMALL TUBE RED RETROSPOT,1,110,18,1900,1790,0,23.10000000000001
2201,15321.0,IVORY SWEETHEART WIRE LETTER RACK ,4,388,50,5100,4712,1,100.0
2202,15322.0,BLUE GIANT GARDEN THERMOMETER,2,150,26,2700,2550,1,52.0
2203,15325.0,ENVELOPE 50 BLOSSOM IMAGES,1,53,28,2900,2847,0,25.9
2204,15326.0,WRAP GREEN PEARS ,1,42,13,1400,1358,0,13.799999999999999
2205,15327.0,SET OF 72 RETROSPOT PAPER  DOILIES,1,43,7,800,757,0,14.0
2206,15329.0,RIBBON REEL SNOWY VILLAGE,5,239,28,2900,2661,1,56.0
2207,15330.0,"FEATHER PEN,LIGHT PINK",2,7,5,600,593,0,10.0
2208,15332.0,CHRISTMAS CRAFT HEART STOCKING ,4,99,17,1800,1701,0,15.6
2209,15333.0,FELTCRAFT DOLL MARIA,1,47,10,1100,1053,0,20.0
2210,15334.0,12 PENCIL SMALL TUBE WOODLAND,3,148,54,5500,5352,0,52.199999999999996
2211,15335.0,REX CASH+CARRY JUMBO SHOPPER,1,101,18,1900,1799,0,17.999999999999996
2212,15339.0,HAND WARMER UNION JACK,3,220,46,4700,4480,1,92.0
2213,15341.0,HOT WATER BOTTLE I AM SO POORLY,1,50,9,1000,950,0,18.0
2214,15342.0,WOODEN CROQUET GARDEN SET,2,59,13,1400,1341,0,10.9
2215,15343.0,DRAWER KNOB CRACKLE GLAZE BLUE,1,134,11,1200,1066,0,22.0
2216,15344.0,WALL MIRROR RECTANGLE DIAMANTE PINK,5,245,19,2000,1755,1,38.0
2217,15345.0,LANTERN CREAM GAZEBO ,2,180,13,1400,1220,1,26.0
2218,15346.0,TRADITIONAL WOODEN SKIPPING ROPE,1,43,9,1000,957,0,18.0
2219,15347.0,RED RETROSPOT PEG BAG,1,11,2,300,289,0,4.0
2220,15348.0,PINK CREAM FELT CRAFT TRINKET BOX ,1,19,5,600,581,0,10.0
2221,15349.0,SWEETHEART CAKESTAND 3 TIER,2,211,39,4000,3789,1,78.0
2222,15350.0,HAND WARMER BIRD DESIGN,1,13,2,300,287,0,4.0
2223,15351.0,"SMALL POP BOX,FUNKY MONKEY",10,682,106,10700,10018,1,212.0
2224,15353.0,GINGERBREAD MAN COOKIE CUTTER,2,208,32,3300,3092,1,64.0
2225,15355.0,EDWARDIAN PARASOL NATURAL,2,85,7,800,715,0,14.0
2226,15356.0,12 PENCIL SMALL TUBE WOODLAND,10,1037,173,17400,16363,1,346.0
2227,15358.0,WRAP SUKI AND FRIENDS,29,1121,186,18700,17579,1,372.0
2228,15360.0,6 RIBBONS EMPIRE  ,1,30,7,800,770,0,14.0
2229,15361.0,BLACK CHRISTMAS FLOCK DROPLET ,1,9,4,500,491,0,8.0
2230,15363.0,PAINT YOUR OWN CANVAS SET,2,55,7,800,745,0,14.0
2231,15364.0,WOODEN UNION JACK BUNTING,2,57,18,1900,1843,0,12.899999999999995
2232,15365.0,LUNCH BAG  BLACK SKULL.,9,696,70,7100,6404,1,140.0
2233,15366.0,VICTORIAN SEWING BOX LARGE,2,108,26,2700,2592,0,20.999999999999996
2234,15367.0,MAGIC DRAWING SLATE DINOSAUR,5,285,44,4500,4215,1,88.0
2235,15368.0,COFFEE MUG APPLES DESIGN,1,14,3,400,386,0,6.0
2236,15369.0,Manual,1,1592,0,100,1492,0,0.0
2237,15370.0,GINGERBREAD MAN COOKIE CUTTER,8,369,50,5100,4731,1,100.0
2238,15372.0,SET OF 6 TEA TIME BAKING CASES,1,22,13,1400,1378,0,13.6
2239,15373.0,12 PENCIL SMALL TUBE WOODLAND,13,725,69,7000,6275,1,138.0
2240,15374.0,NO SINGING METAL SIGN,1,11,0,100,89,0,0.0
2241,15376.0,LUNCH BAG VINTAGE LEAF DESIGN,3,338,54,5500,5162,1,108.0
2242,15379.0,LUNCH BAG  BLACK SKULL.,8,504,89,9000,8496,1,178.0
2243,15380.0,ALARM CLOCK BAKELIKE GREEN,6,225,19,2000,1775,1,38.0
2244,15381.0,DOLLY HONEYCOMB GARLAND,2,49,3,400,351,0,6.0
2245,15382.0,LUNCH BAG  BLACK SKULL.,8,755,132,13300,12545,1,264.0
2246,15384.0,LUNCH BAG  BLACK SKULL.,3,82,22,2300,2218,0,20.899999999999995
2247,15385.0,WRAP  VINTAGE DOILY ,1,26,5,600,574,0,10.0
2248,15386.0,ENVELOPE 50 BLOSSOM IMAGES,1,42,15,1600,1558,0,14.600000000000003
2249,15388.0,HANGING JAM JAR T-LIGHT HOLDER,1,20,4,500,480,0,8.0
2250,15389.0,SOMBRERO ,1,1,0,100,99,0,0.0
2251,15392.0,FRENCH PAISLEY CUSHION COVER ,5,181,47,4800,4619,1,94.0
2252,15393.0,EASTER TIN KEEPSAKE,2,18,5,600,582,0,10.0
2253,15394.0,SWEETHEART CAKESTAND 3 TIER,4,275,41,4200,3925,1,82.0
2254,15395.0,6 EGG HOUSE PAINTED WOOD,1,45,4,500,455,0,8.0
2255,15396.0,PINK CREAM FELT CRAFT TRINKET BOX ,1,50,6,700,650,0,12.0
2256,15397.0,ENAMEL FLOWER JUG CREAM,1,29,3,400,371,0,6.0
2257,15398.0,HOT WATER BOTTLE I AM SO POORLY,3,199,39,4000,3801,1,78.0
2258,15399.0,CHRYSANTHEMUM NOTEBOOK,3,95,25,2600,2505,0,24.900000000000006
2259,15400.0,PACK OF 6 SANDCASTLE FLAGS ASSORTED,6,26,7,800,774,0,14.0
2260,15402.0,WELCOME  WOODEN BLOCK LETTERS,2,147,24,2500,2353,0,18.700000000000003
2261,15405.0,WELCOME  WOODEN BLOCK LETTERS,1,28,3,400,372,0,6.0
2262,15406.0,REX CASH+CARRY JUMBO SHOPPER,4,205,32,3300,3095,1,64.0
2263,15407.0,12 PENCIL SMALL TUBE WOODLAND,4,596,77,7800,7204,1,154.0
2264,15408.0,WOODEN CROQUET GARDEN SET,1,152,21,2200,2048,1,42.0
2265,15410.0,BLUE GIANT GARDEN THERMOMETER,8,474,61,6200,5726,1,122.0
2266,15411.0,JUMBO BAG RED RETROSPOT,5,413,46,4700,4287,1,92.0
2267,15412.0,SWEETHEART CAKESTAND 3 TIER,1,34,3,400,366,0,6.0
2268,15414.0,BLUE GIANT GARDEN THERMOMETER,3,125,22,2300,2175,0,19.6
2269,15415.0,LUNCH BAG  BLACK SKULL.,1,83,25,2600,2517,0,20.700000000000003
2270,15416.0,BLUE HAPPY BIRTHDAY BUNTING,5,637,79,8000,7363,1,158.0
2271,15417.0,LUNCH BAG  BLACK SKULL.,1,52,13,1400,1348,0,16.2
2272,15419.0,RED RETROSPOT PEG BAG,1,10,5,600,590,0,10.0
2273,15421.0,JUMBO BAG VINTAGE DOILY ,4,141,26,2700,2559,0,26.700000000000006
2274,15422.0,RED RETROSPOT SUGAR JAM BOWL,2,18,3,400,382,0,6.0
2275,15423.0,LIPSTICK PEN FUSCHIA,1,7,1,200,193,0,2.0
2276,15424.0,ENVELOPE 50 BLOSSOM IMAGES,2,29,7,800,771,0,14.0
2277,15426.0,TOXIC AREA  DOOR HANGER ,7,800,128,12900,12100,1,256.0
2278,15427.0,TOXIC AREA  DOOR HANGER ,3,648,135,13600,12952,1,270.0
2279,15428.0,CHRISTMAS HANGING STAR WITH BELL,1,11,4,500,489,0,8.0
2280,15429.0,PAPER BUNTING VINTAGE PARTY,3,172,40,4100,3928,1,80.0
2281,15432.0,WALL ART STOP FOR TEA ,1,29,5,600,571,0,10.0
2282,15433.0,LUNCH BAG  BLACK SKULL.,3,66,28,2900,2834,0,26.200000000000003
2283,15434.0,HOT WATER BOTTLE I AM SO POORLY,6,205,32,3300,3095,1,64.0
2284,15435.0,RED RETROSPOT SUGAR JAM BOWL,1,108,16,1700,1592,0,13.2
2285,15436.0,DECORATIVE WICKER HEART LARGE,3,703,137,13800,13097,1,274.0
2286,15437.0,FELT EGG COSY WHITE RABBIT ,1,128,22,2300,2172,0,23.900000000000006
2287,15438.0,IVORY SWEETHEART WIRE LETTER RACK ,1,88,13,1400,1312,0,12.399999999999997
2288,15440.0,DECORATIVE WICKER HEART LARGE,3,144,31,3200,3056,0,35.49999999999999
2289,15442.0,EDWARDIAN PARASOL PINK,1,9,1,200,191,0,2.0
2290,15443.0,PAPER BUNTING VINTAGE PARTY,8,1158,154,15500,14342,1,308.0
2291,15444.0,SMALL HANGING IVORY/RED WOOD BIRD,2,613,100,10100,9487,1,200.0
2292,15445.0,ASSORTED EASTER GIFT TAGS,1,27,2,300,273,0,4.0
2293,15447.0,PEARL CRYSTAL PUMPKIN T-LIGHT HLDR,1,28,3,400,372,0,6.0
2294,15448.0,WOODEN CROQUET GARDEN SET,1,100,16,1700,1600,0,11.899999999999997
2295,15449.0,GINGERBREAD MAN COOKIE CUTTER,5,117,35,3600,3483,0,30.900000000000002
2296,15450.0,WOODEN TREE CHRISTMAS SCANDINAVIAN,1,65,15,1600,1535,0,15.4
2297,15452.0,BUNDLE OF 3 SCHOOL EXERCISE BOOKS  ,3,150,30,3100,2950,1,60.0
2298,15453.0,DECORATIVE WICKER HEART LARGE,7,727,127,12800,12073,1,254.0
2299,15454.0,REX CASH+CARRY JUMBO SHOPPER,1,69,14,1500,1431,0,13.100000000000001
2300,15456.0,REX CASH+CARRY JUMBO SHOPPER,3,96,33,3400,3304,0,31.599999999999998
2301,15457.0,LUNCH BAG  BLACK SKULL.,1,109,30,3100,2991,0,26.900000000000006
2302,15458.0,CHRISTMAS PUDDING TRINKET POT ,1,8,3,400,392,0,6.0
2303,15460.0,REX CASH+CARRY JUMBO SHOPPER,1,164,31,3200,3036,1,62.0
2304,15462.0,BLUE SPOT CERAMIC DRAWER KNOB,3,17,7,800,783,0,14.0
2305,15463.0,GIN + TONIC DIET METAL SIGN,1,12,4,500,488,0,8.0
2306,15464.0,SET 7 BABUSHKA NESTING BOXES,1,661,73,7400,6739,1,146.0
2307,15465.0,SWEETHEART CAKESTAND 3 TIER,24,720,53,5400,4680,1,106.0
2308,15466.0,RUSTIC STRAWBERRY JAM POT LARGE ,1,108,27,2800,2692,0,28.800000000000004
2309,15467.0,EGG FRYING PAN BLUE ,4,120,26,2700,2580,0,27.499999999999993
2310,15468.0,HOT WATER BOTTLE I AM SO POORLY,5,136,14,1500,1364,0,16.200000000000003
2311,15469.0,DOORMAT KEEP CALM AND COME IN,4,178,14,1500,1322,1,28.0
2312,15471.0,GLASS JAR MARMALADE ,1,153,38,3900,3747,1,76.0
2313,15472.0,WELCOME  WOODEN BLOCK LETTERS,1,173,41,4200,4027,1,82.0
2314,15473.0,PAPER CHAIN KIT VINTAGE CHRISTMAS,10,36,5,600,564,0,10.0
2315,15475.0,PICTURE DOMINOES,1,52,14,1500,1448,0,12.299999999999997
2316,15478.0,DECORATIVE WICKER HEART LARGE,2,162,28,2900,2738,1,56.0
2317,15480.0,DOORMAT MERRY CHRISTMAS RED ,1,191,25,2600,2409,1,50.0
2318,15482.0,HOT WATER BOTTLE I AM SO POORLY,16,482,63,6400,5918,1,126.0
2319,15483.0,BISCUITS SMALL BOWL LIGHT BLUE,4,143,45,4600,4457,0,47.599999999999994
2320,15484.0,LUNCH BAG  BLACK SKULL.,5,410,83,8400,7990,1,166.0
2321,15485.0,ALARM CLOCK BAKELIKE GREEN,3,273,42,4300,4027,1,84.0
2322,15488.0,Next Day Carriage,1,16,1,200,184,0,2.0
2323,15489.0,GINGERBREAD MAN COOKIE CUTTER,4,163,30,3100,2937,1,60.0
2324,15491.0,SET/6 POSIES PAPER CUPS,7,600,71,7200,6600,1,142.0
2325,15492.0,BUNDLE OF 3 SCHOOL EXERCISE BOOKS  ,2,88,19,2000,1912,0,16.7
2326,15493.0,SET 7 BABUSHKA NESTING BOXES,7,1337,132,13300,11963,1,264.0
2327,15494.0,SET/6 PINK  BUTTERFLY T-LIGHTS,2,298,59,6000,5702,1,118.0
2328,15497.0,CLASSICAL ROSE SMALL VASE,3,55,8,900,845,0,16.0
2329,15498.0,JUMBO BAG RED RETROSPOT,35,2517,175,17600,15083,1,350.0
2330,15500.0,SPACEBOY BIRTHDAY CARD,4,310,32,3300,2990,1,64.0
2331,15502.0,HAND WARMER UNION JACK,23,7836,116,11700,3864,1,232.0
2332,15503.0,12 PENCIL SMALL TUBE WOODLAND,1,143,42,4300,4157,0,32.2
2333,15504.0,RED FLOWER CROCHET FOOD COVER,1,29,6,700,671,0,12.0
2334,15505.0,CHRISTMAS CRAFT WHITE FAIRY ,7,233,45,4600,4367,1,90.0
2335,15506.0,LUNCH BAG  BLACK SKULL.,3,292,81,8200,7908,1,162.0
2336,15507.0,REX CASH+CARRY JUMBO SHOPPER,1,186,26,2700,2514,1,52.0
2337,15508.0,IVORY SWEETHEART WIRE LETTER RACK ,6,312,47,4800,4488,1,94.0
2338,15510.0,VINTAGE RED KITCHEN CABINET,1,125,0,100,25,0,0.0
2339,15511.0,12 PENCIL SMALL TUBE WOODLAND,5,638,76,7700,7062,1,152.0
2340,15512.0,PINK CHRISTMAS FLOCK DROPLET ,2,13,4,500,487,0,8.0
2341,15513.0,LUNCH BAG VINTAGE LEAF DESIGN,22,1294,141,14200,12906,1,282.0
2342,15514.0,SET 7 BABUSHKA NESTING BOXES,13,538,93,9400,8862,1,186.0
2343,15516.0,GLITTER HANGING BUTTERFLY STRING,3,41,7,800,759,0,14.0
2344,15517.0,DINOSAUR LUNCH BOX WITH CUTLERY,1,48,14,1500,1452,0,14.4
2345,15518.0,LUNCH BAG  BLACK SKULL.,13,548,107,10800,10252,1,214.0
2346,15520.0,FRENCH KITCHEN SIGN BLUE METAL,1,31,9,1000,969,0,18.0
2347,15521.0,SET OF 16 VINTAGE SKY BLUE CUTLERY,13,800,90,9100,8300,1,180.0
2348,15522.0,LUNCH BAG VINTAGE LEAF DESIGN,2,54,29,3000,2946,0,26.999999999999993
2349,15523.0,JUMBO BAG PINK POLKADOT,1,36,5,600,564,0,10.0
2350,15524.0,CHEST NATURAL WOOD 20 DRAWERS,1,110,0,100,10,0,0.0
2351,15525.0,MINI PLAYING CARDS GYMKHANA,4,496,85,8600,8104,1,170.0
2352,15526.0,FOOT STOOL HOME SWEET HOME ,2,21,2,300,279,0,4.0
2353,15527.0,LUNCH BAG  BLACK SKULL.,10,616,85,8600,7984,1,170.0
2354,15528.0,FOLDING UMBRELLA PINKWHITE POLKADOT,1,67,13,1400,1333,0,12.399999999999999
2355,15529.0,LUNCH BAG VINTAGE LEAF DESIGN,12,1160,204,20500,19340,1,408.0
2356,15530.0,SET/6 PINK  BUTTERFLY T-LIGHTS,4,307,56,5700,5393,1,112.0
2357,15531.0,PAPER BUNTING VINTAGE PARTY,2,692,103,10400,9708,1,206.0
2358,15532.0,MIRROR CORNICE,6,1036,113,11400,10364,1,226.0
2359,15533.0,GINGERBREAD MAN COOKIE CUTTER,5,340,47,4800,4460,1,94.0
2360,15535.0,MORE BUTTER METAL SIGN ,7,381,38,3900,3519,1,76.0
2361,15537.0,REX CASH+CARRY JUMBO SHOPPER,1,92,13,1400,1308,0,11.499999999999998
2362,15539.0,12 PENCILS SMALL TUBE RED RETROSPOT,1,55,22,2300,2245,0,19.500000000000004
2363,15540.0,VINTAGE DOILY TRAVEL SEWING KIT,1,25,8,900,875,0,16.0
2364,15541.0,JUMBO BAG VINTAGE DOILY ,1,60,15,1600,1540,0,11.4
2365,15543.0,MINI CAKE STAND  HANGING STRAWBERY,1,61,16,1700,1639,0,13.6
2366,15544.0,WRAP SUKI AND FRIENDS,11,416,111,11200,10784,1,222.0
2367,15545.0,HERB MARKER ROSEMARY,2,218,39,4000,3782,1,78.0
2368,15547.0,SET 7 BABUSHKA NESTING BOXES,14,1827,213,21400,19573,1,426.0
2369,15549.0,DOUGHNUT LIP GLOSS ,4,381,58,5900,5519,1,116.0
2370,15550.0,LUNCH BAG  BLACK SKULL.,4,171,31,3200,3029,1,62.0
2371,15551.0,WELCOME  WOODEN BLOCK LETTERS,1,113,14,1500,1387,0,13.899999999999999
2372,15552.0,REX CASH+CARRY JUMBO SHOPPER,1,30,7,800,770,0,14.0
2373,15553.0,BANQUET BIRTHDAY  CARD  ,1,134,30,3100,2966,0,26.599999999999994
2374,15554.0,CHILDS BREAKFAST SET CIRCUS PARADE,1,67,7,800,733,0,14.0
2375,15555.0,LUNCH BAG VINTAGE LEAF DESIGN,20,1563,236,23700,22137,1,472.0
2376,15556.0,GREEN POLKADOT BOWL,1,55,17,1800,1745,0,13.600000000000003
2377,15557.0,GLITTER CHRISTMAS TREE WITH BELLS,1,71,9,1000,929,0,10.2
2378,15561.0,LUNCH BAG DOILEY PATTERN ,5,143,18,1900,1757,0,15.499999999999998
2379,15562.0,AFGHAN SLIPPER SOCK PAIR,1,3,0,100,97,0,0.0
2380,15563.0,12 PENCIL SMALL TUBE WOODLAND,7,224,55,5600,5376,1,110.0
2381,15565.0,GIN + TONIC DIET METAL SIGN,2,36,3,400,364,0,6.0
2382,15567.0,MEDIUM CERAMIC TOP STORAGE JAR,1,22,3,400,378,0,6.0
2383,15568.0,SET OF 4 KNICK KNACK TINS LONDON ,3,135,25,2600,2465,0,26.099999999999998
2384,15569.0,S/4 VALENTINE DECOUPAGE HEART BOX,5,67,19,2000,1933,0,17.099999999999998
2385,15570.0,SET 7 BABUSHKA NESTING BOXES,13,1240,140,14100,12860,1,280.0
2386,15571.0,GINGERBREAD MAN COOKIE CUTTER,4,153,29,3000,2847,1,58.0
2387,15572.0,LUNCH BAG  BLACK SKULL.,7,783,96,9700,8917,1,192.0
2388,15573.0,BLACK FEATHER CHRISTMAS DECORATION,2,297,52,5300,5003,1,104.0
2389,15574.0,RIBBON REEL SNOWY VILLAGE,4,422,83,8400,7978,1,166.0
2390,15576.0,WOODEN CROQUET GARDEN SET,1,161,22,2300,2139,1,44.0
2391,15577.0,REX CASH+CARRY JUMBO SHOPPER,3,119,22,2300,2181,0,20.999999999999993
2392,15578.0,PACK OF 60 SPACEBOY CAKE CASES,1,31,8,900,869,0,16.0
2393,15579.0,DOORMAT RED RETROSPOT,2,206,29,3000,2794,1,58.0
2394,15581.0,60 TEATIME FAIRY CAKE CASES,14,3610,73,7400,3790,1,146.0
2395,15582.0,PINK PARTY BAGS,3,105,25,2600,2495,0,19.7
2396,15584.0,12 PENCIL SMALL TUBE WOODLAND,5,383,65,6600,6217,1,130.0
2397,15585.0,SMALL HANGING IVORY/RED WOOD BIRD,1,70,16,1700,1630,0,17.0
2398,15587.0,VINYL RECORD FRAME SILVER,4,26,5,600,574,0,10.0
2399,15589.0,GINGERBREAD MAN COOKIE CUTTER,4,128,17,1800,1672,0,15.299999999999997
2400,15590.0,Manual,1,30,0,100,70,0,0.0
2401,15592.0,CARD HOLDER LOVE BIRD SMALL,1,37,12,1300,1263,0,14.399999999999999
2402,15593.0,ZINC WILLIE WINKIE  CANDLE STICK,1,16,2,300,284,0,4.0
2403,15594.0,LANTERN CREAM GAZEBO ,6,329,53,5400,5071,1,106.0
2404,15596.0,RED RETROSPOT SUGAR JAM BOWL,9,366,47,4800,4434,1,94.0
2405,15597.0,DECORATIVE WICKER HEART LARGE,2,38,14,1500,1462,0,14.899999999999999
2406,15598.0,MULTI COLOUR SILVER T-LIGHT HOLDER,3,38,8,900,862,0,16.0
2407,15599.0,ENVELOPE 50 BLOSSOM IMAGES,2,98,30,3100,3002,0,25.9
2408,15601.0,LUNCH BAG VINTAGE LEAF DESIGN,17,1126,177,17800,16674,1,354.0
2409,15602.0,LANTERN CREAM GAZEBO ,15,158,31,3200,3042,1,62.0
2410,15603.0,JAM JAR WITH GREEN LID,1,1,0,100,99,0,0.0
2411,15604.0,LARGE CERAMIC TOP STORAGE JAR,1,26,8,900,874,0,16.0
2412,15605.0,DOORMAT RED RETROSPOT,5,307,31,3200,2893,1,62.0
2413,15606.0,SET 7 BABUSHKA NESTING BOXES,11,326,49,5000,4674,1,98.0
2414,15607.0,SKULLS TAPE,1,15,8,900,885,0,16.0
2415,15608.0,SWEETHEART CAKESTAND 3 TIER,4,195,30,3100,2905,1,60.0
2416,15609.0,CHEST OF DRAWERS GINGHAM HEART ,2,93,8,900,807,0,16.0
2417,15610.0,RED RETROSPOT SHOPPER BAG,1,11,3,400,389,0,6.0
2418,15611.0,SET 6 PAPER TABLE LANTERN STARS ,15,258,22,2300,2042,1,44.0
2419,15612.0,RED WOOLLY HOTTIE WHITE HEART.,2,36,2,300,264,0,4.0
2420,15615.0,LUNCH BAG  BLACK SKULL.,27,1110,167,16800,15690,1,334.0
2421,15618.0,DECORATIVE WICKER HEART LARGE,5,126,28,2900,2774,0,21.8
2422,15619.0,SET OF TEA COFFEE SUGAR TINS PANTRY,1,13,2,300,287,0,4.0
2423,15620.0,WHITE SKULL HOT WATER BOTTLE ,6,384,55,5600,5216,1,110.0
2424,15621.0,4 PINK DINNER CANDLE SILVER FLOCK,6,40,10,1100,1060,0,11.0
2425,15622.0,LUNCH BAG  BLACK SKULL.,16,944,90,9100,8156,1,180.0
2426,15623.0,PINK/BLUE STRING CURTAIN ,1,81,9,1000,919,0,18.0
2427,15624.0,WOODEN UNION JACK BUNTING,4,124,20,2100,1976,0,14.6
2428,15625.0,GINGERBREAD MAN COOKIE CUTTER,8,109,38,3900,3791,0,35.5
2429,15626.0,MINI PLAYING CARDS FUN FAIR ,2,80,23,2400,2320,0,25.50000000000001
2430,15628.0,CHRISTMAS CRAFT WHITE FAIRY ,10,358,76,7700,7342,1,152.0
2431,15630.0,BLUE GIANT GARDEN THERMOMETER,3,175,31,3200,3025,1,62.0
2432,15632.0,12 PENCIL SMALL TUBE WOODLAND,10,486,84,8500,8014,1,168.0
2433,15634.0,HOT WATER BOTTLE I AM SO POORLY,1,55,9,1000,945,0,18.0
2434,15636.0,WOODEN PICTURE FRAME WHITE FINISH,2,79,17,1800,1721,0,15.100000000000001
2435,15637.0,CREAM WALL PLANTER HEART SHAPED,1,45,8,900,855,0,16.0
2436,15638.0,MINI CAKE STAND WITH HANGING CAKES,1,9,0,100,91,0,0.0
2437,15639.0,WRAP SUKI AND FRIENDS,1,107,12,1300,1193,0,13.799999999999999
2438,15640.0,WRAP SUKI AND FRIENDS,17,1421,174,17500,16079,1,348.0
2439,15641.0,DECORATIVE WICKER HEART LARGE,4,227,59,6000,5773,1,118.0
2440,15643.0,BLUE HAPPY BIRTHDAY BUNTING,6,208,19,2000,1792,1,38.0
2441,15644.0,LUNCH BAG  BLACK SKULL.,4,424,106,10700,10276,1,212.0
2442,15645.0,REX CASH+CARRY JUMBO SHOPPER,1,153,24,2500,2347,1,48.0
2443,15646.0,SWEETHEART CAKESTAND 3 TIER,4,105,21,2200,2095,0,16.200000000000003
2444,15648.0,SWEETHEART CAKESTAND 3 TIER,4,129,12,1300,1171,0,14.1
2445,15649.0,CHILLI LIGHTS,2,8,0,100,92,0,0.0
2446,15651.0,WRAP I LOVE LONDON ,3,69,16,1700,1631,0,13.6
2447,15652.0,DRAWER KNOB CRACKLE GLAZE BLUE,1,80,8,900,820,0,12.0
2448,15653.0,WOOD STOCKING CHRISTMAS SCANDISPOT,2,5,3,400,395,0,6.0
2449,15654.0,SKULL SHOULDER BAG,2,64,10,1100,1036,0,10.8
2450,15655.0,WRAP ENGLISH ROSE ,2,134,17,1800,1666,0,18.000000000000004
2451,15656.0,SWEETHEART CAKESTAND 3 TIER,4,207,26,2700,2493,1,52.0
2452,15657.0,SET OF 4 PANTRY JELLY MOULDS,1,1,0,100,99,0,0.0
2453,15658.0,WELCOME  WOODEN BLOCK LETTERS,8,358,29,3000,2642,1,58.0
2454,15659.0,DOORMAT RED RETROSPOT,1,60,6,700,640,0,12.0
2455,15660.0,RED RETROSPOT PEG BAG,12,221,47,4800,4579,1,94.0
2456,15661.0,KITCHEN METAL SIGN,2,4,2,300,296,0,4.0
2457,15663.0,DIAMOND LAS VEGAS NECKLACE 45CM,1,22,4,500,478,0,8.0
2458,15664.0,BLUE GIANT GARDEN THERMOMETER,2,74,10,1100,1026,0,20.0
2459,15665.0,LUNCH BAG  BLACK SKULL.,2,262,60,6100,5838,1,120.0
2460,15667.0,GLASS APOTHECARY BOTTLE PERFUME,1,20,6,700,680,0,12.0
2461,15668.0,ANTIQUE SILVER T-LIGHT GLASS,1,1,0,100,99,0,0.0
2462,15669.0,JAM MAKING SET PRINTED,5,111,18,1900,1789,0,19.599999999999998
2463,15670.0,FELT EGG COSY CHICKEN,1,37,4,500,463,0,8.0
2464,15671.0,WOODEN UNION JACK BUNTING,10,205,42,4300,4095,1,84.0
2465,15673.0,LUNCH BAG VINTAGE LEAF DESIGN,4,457,76,7700,7243,1,152.0
2466,15674.0,LANTERN CREAM GAZEBO ,8,1065,70,7100,6035,1,140.0
2467,15675.0,COLOURING PENCILS BROWN TUBE,3,60,13,1400,1340,0,11.500000000000002
2468,15676.0,12 PENCIL SMALL TUBE WOODLAND,5,706,101,10200,9494,1,202.0
2469,15677.0,ZINC WILLIE WINKIE  CANDLE STICK,1,118,19,2000,1882,0,17.999999999999996
2470,15678.0,NATURAL SLATE RECTANGLE CHALKBOARD,1,24,6,700,676,0,12.0
2471,15679.0,12 PENCIL SMALL TUBE WOODLAND,4,121,53,5400,5279,0,54.00000000000002
2472,15680.0,SWEETHEART CAKESTAND 3 TIER,3,188,39,4000,3812,1,78.0
2473,15681.0,HERB MARKER PARSLEY,6,135,32,3300,3165,0,34.10000000000001
2474,15683.0,RETROSPOT TEA SET CERAMIC 11 PC ,1,21,5,600,579,0,10.0
2475,15687.0,HAND WARMER UNION JACK,11,716,78,7900,7184,1,156.0
2476,15689.0,SET 6 SCHOOL MILK BOTTLES IN CRATE,2,31,4,500,469,0,8.0
2477,15690.0,LOVEBIRD HANGING DECORATION WHITE ,2,12,12,1300,1288,0,24.0
2478,15691.0,PACK OF 6 BIRDY GIFT TAGS,1,3,0,100,97,0,0.0
2479,15692.0,CARD HOLDER LOVE BIRD SMALL,1,22,5,600,578,0,10.0
2480,15694.0,ALARM CLOCK BAKELIKE GREEN,15,372,41,4200,3828,1,82.0
2481,15695.0,CHARLIE+LOLA PINK HOT WATER BOTTLE,2,63,10,1100,1037,0,12.9
2482,15696.0,DECORATIVE WICKER HEART LARGE,12,821,89,9000,8179,1,178.0
2483,15699.0,PLACE SETTING WHITE HEART,1,111,9,1000,889,0,18.0
2484,15700.0,S/12 VANILLA  BOTANICAL T-LIGHTS,3,258,44,4500,4242,1,88.0
2485,15701.0,BLUE HAPPY BIRTHDAY BUNTING,4,697,107,10800,10103,1,214.0
2486,15703.0,WOODEN UNION JACK BUNTING,1,14,3,400,386,0,6.0
2487,15704.0,HEART OF WICKER SMALL,4,377,55,5600,5223,1,110.0
2488,15705.0,DOORMAT RED RETROSPOT,1,36,3,400,364,0,6.0
2489,15706.0,TREASURE ISLAND BOOK BOX,7,309,26,2700,2391,1,52.0
2490,15707.0,RIBBON REEL SNOWY VILLAGE,4,488,98,9900,9412,1,196.0
2491,15708.0,DECORATIVE WICKER HEART LARGE,11,1213,121,12200,10987,1,242.0
2492,15709.0,BLUE HAPPY BIRTHDAY BUNTING,1,14,3,400,386,0,6.0
2493,15712.0,DOORMAT RED RETROSPOT,5,194,26,2700,2506,1,52.0
2494,15713.0,SWEETHEART CAKESTAND 3 TIER,3,111,9,1000,889,0,18.0
2495,15714.0,REX CASH+CARRY JUMBO SHOPPER,2,107,21,2200,2093,0,19.0
2496,15716.0,BLUE HAPPY BIRTHDAY BUNTING,4,270,55,5600,5330,1,110.0
2497,15717.0,SINGLE HEART ZINC T-LIGHT HOLDER,1,17,3,400,383,0,6.0
2498,15719.0,LUNCH BAG VINTAGE LEAF DESIGN,14,2063,230,23100,21037,1,460.0
2499,15720.0,RIBBON REEL SNOWY VILLAGE,1,315,69,7000,6685,1,138.0
2500,15721.0,WHITE SKULL HOT WATER BOTTLE ,1,187,44,4500,4313,1,88.0
2501,15722.0,MORE BUTTER METAL SIGN ,6,235,40,4100,3865,1,80.0
2502,15723.0,HOT WATER BOTTLE I AM SO POORLY,1,106,23,2400,2294,0,23.6
2503,15724.0,TOY TIDY SPACEBOY  ,3,43,6,700,657,0,12.0
2504,15725.0,GARDENERS KNEELING PAD KEEP CALM ,1,84,13,1400,1316,0,18.1
2505,15727.0,MIRRORED WALL ART LADIES,7,980,126,12700,11720,1,252.0
2506,15728.0,HOT WATER BOTTLE I AM SO POORLY,1,16,2,300,284,0,4.0
2507,15729.0,IVORY SWEETHEART WIRE LETTER RACK ,2,24,3,400,376,0,6.0
2508,15730.0,LUNCH BAG  BLACK SKULL.,4,213,36,3700,3487,1,72.0
2509,15732.0,WORLD WAR 2 GLIDERS ASSTD DESIGNS,2,26,7,800,774,0,14.0
2510,15733.0,SET OF 4 NAPKIN CHARMS HEARTS,1,43,5,600,557,0,10.0
2511,15734.0,LUNCH BAG VINTAGE LEAF DESIGN,2,125,14,1500,1375,0,13.599999999999998
2512,15737.0,LUNCH BAG  BLACK SKULL.,12,328,44,4500,4172,1,88.0
2513,15738.0,GREEN POLKADOT BOWL,19,372,84,8500,8128,1,168.0
2514,15739.0,SET 6 SCHOOL MILK BOTTLES IN CRATE,1,20,6,700,680,0,12.0
2515,15740.0,CARD HOLDER LOVE BIRD SMALL,1,22,3,400,378,0,6.0
2516,15743.0,DOORMAT RED RETROSPOT,4,412,47,4800,4388,1,94.0
2517,15744.0,WOODEN TREE CHRISTMAS SCANDINAVIAN,1,0,1,200,200,0,2.0
2518,15745.0,HOT WATER BOTTLE I AM SO POORLY,6,277,34,3500,3223,1,68.0
2519,15746.0,FRENCH PAISLEY CUSHION COVER ,2,41,16,1700,1659,0,14.200000000000001
2520,15747.0,LUNCH BAG  BLACK SKULL.,3,228,42,4300,4072,1,84.0
2521,15748.0,PLAYING CARDS KEEP CALM & CARRY ON,1,78,12,1300,1222,0,11.399999999999999
2522,15749.0,GIN + TONIC DIET METAL SIGN,4,46,6,700,654,0,12.0
2523,15750.0,LUNCH BAG  BLACK SKULL.,9,717,122,12300,11583,1,244.0
2524,15752.0,LUNCH BAG  BLACK SKULL.,8,722,167,16800,16078,1,334.0
2525,15753.0,AGED GLASS SILVER T-LIGHT HOLDER,1,0,0,100,100,0,0.0
2526,15754.0,RIBBON REEL POLKADOTS ,4,77,16,1700,1623,0,16.299999999999997
2527,15755.0,GARLAND WOODEN HAPPY EASTER,8,474,76,7700,7226,1,152.0
2528,15756.0,TOXIC AREA  DOOR HANGER ,4,475,85,8600,8125,1,170.0
2529,15757.0,SET OF 4 KNICK KNACK TINS LONDON ,2,122,22,2300,2178,0,22.2
2530,15758.0,FAWN BLUE HOT WATER BOTTLE,1,39,4,500,461,0,8.0
2531,15759.0,"FANCY FONT BIRTHDAY CARD, ",3,36,5,600,564,0,10.0
2532,15762.0,LUNCH BAG  BLACK SKULL.,2,148,17,1800,1652,0,16.8
2533,15763.0,WOODEN CROQUET GARDEN SET,3,431,32,3300,2869,1,64.0
2534,15764.0,LUNCH BAG  BLACK SKULL.,10,532,83,8400,7868,1,166.0
2535,15766.0,SET OF 16 VINTAGE PISTACHIO CUTLERY,1,35,7,800,765,0,14.0
2536,15768.0,BUNDLE OF 3 SCHOOL EXERCISE BOOKS  ,4,253,15,1600,1347,1,30.0
2537,15769.0,HOT WATER BOTTLE I AM SO POORLY,29,300,69,7000,6700,1,138.0
2538,15773.0,JIGSAW TREE WITH BIRDHOUSE,1,13,5,600,587,0,10.0
2539,15774.0,GREY HEART HOT WATER BOTTLE,1,120,15,1600,1480,0,12.300000000000002
2540,15775.0,VINTAGE CREAM DOG FOOD CONTAINER,1,17,2,300,283,0,4.0
2541,15776.0,DRAWER KNOB CRACKLE GLAZE BLUE,1,75,8,900,825,0,16.0
2542,15777.0,PINK SPOTS CHOCOLATE NESTING BOXES ,5,88,10,1100,1012,0,12.1
2543,15780.0,RED RETROSPOT PEG BAG,3,120,13,1400,1280,0,26.0
2544,15781.0,LARGE IVORY HEART WALL ORGANISER,4,85,10,1100,1015,0,12.6
2545,15782.0,HOT WATER BOTTLE I AM SO POORLY,4,283,25,2600,2317,1,50.0
2546,15783.0,VINTAGE RED ENAMEL TRIM JUG ,1,48,6,700,652,0,12.0
2547,15785.0,PACK OF 6 COCKTAIL PARASOL STRAWS,8,282,42,4300,4018,1,84.0
2548,15786.0,SET 7 BABUSHKA NESTING BOXES,5,788,120,12100,11312,1,240.0
2549,15787.0,12 PENCIL SMALL TUBE WOODLAND,3,445,89,9000,8555,1,178.0
2550,15789.0,MR ROBOT SOFT TOY,1,24,15,1600,1576,0,14.100000000000001
2551,15790.0,CHRISTMAS TOILET ROLL,1,119,17,1800,1681,0,18.7
2552,15791.0,SMALL JEWELLERY STAND,3,252,43,4400,4148,1,86.0
2553,15793.0,RABBIT NIGHT LIGHT,4,53,6,700,647,0,12.0
2554,15795.0,PICTURE DOMINOES,1,128,22,2300,2172,0,18.399999999999995
2555,15796.0,HOT WATER BOTTLE I AM SO POORLY,10,563,56,5700,5137,1,112.0
2556,15797.0,Manual,4,33,4,500,467,0,8.0
2557,15799.0,HEART DECORATION RUSTIC HANGING ,3,222,53,5400,5178,1,106.0
2558,15800.0,HAND WARMER UNION JACK,2,322,60,6100,5778,1,120.0
2559,15801.0,MEDIUM CERAMIC TOP STORAGE JAR,4,210,39,4000,3790,1,78.0
2560,15802.0,Manual,3,1354,1,200,1154,1,2.0
2561,15803.0,STAR WOODEN CHRISTMAS DECORATION,1,13,4,500,487,0,8.0
2562,15804.0,ALARM CLOCK BAKELIKE GREEN,19,1121,109,11000,9879,1,218.0
2563,15805.0,LUNCH BAG  BLACK SKULL.,20,845,124,12500,11655,1,248.0
2564,15806.0,BLUE HAPPY BIRTHDAY BUNTING,3,62,17,1800,1738,0,17.099999999999998
2565,15807.0,SWEETHEART CAKESTAND 3 TIER,3,123,27,2800,2677,0,23.999999999999996
2566,15808.0,WHITE SKULL HOT WATER BOTTLE ,5,754,91,9200,8446,1,182.0
2567,15809.0,DOORMAT KEEP CALM AND COME IN,6,176,25,2600,2424,1,50.0
2568,15810.0,LUNCH BAG  BLACK SKULL.,7,299,60,6100,5801,1,120.0
2569,15811.0,CHRISTMAS CRAFT WHITE FAIRY ,9,491,68,6900,6409,1,136.0
2570,15812.0,WOODEN CROQUET GARDEN SET,5,207,22,2300,2093,1,44.0
2571,15813.0,JAM MAKING SET PRINTED,2,150,20,2100,1950,1,40.0
2572,15814.0,GINGERBREAD MAN COOKIE CUTTER,6,250,36,3700,3450,1,72.0
2573,15815.0,WRAP SUKI AND FRIENDS,5,105,23,2400,2295,0,24.099999999999994
2574,15819.0,RECYCLED PENCIL WITH RABBIT ERASER,4,246,65,6600,6354,1,130.0
2575,15820.0,REX CASH+CARRY JUMBO SHOPPER,1,38,10,1100,1062,0,20.0
2576,15821.0,LUNCH BAG VINTAGE LEAF DESIGN,2,229,35,3600,3371,1,70.0
2577,15822.0,REX CASH+CARRY JUMBO SHOPPER,2,111,19,2000,1889,0,16.600000000000005
2578,15823.0,Bank Charges,2,85,10,1100,1015,0,20.0
2579,15825.0,HEART OF WICKER SMALL,1,176,10,1100,924,1,20.0
2580,15826.0,RIBBON REEL SNOWY VILLAGE,4,223,33,3400,3177,1,66.0
2581,15827.0,GINGERBREAD MAN COOKIE CUTTER,20,629,64,6500,5871,1,128.0
2582,15829.0,MORE BUTTER METAL SIGN ,2,53,31,3200,3147,0,24.7
2583,15830.0,ALARM CLOCK BAKELIKE GREEN,2,122,26,2700,2578,0,20.400000000000006
2584,15831.0,LUNCH BAG  BLACK SKULL.,4,186,30,3100,2914,1,60.0
2585,15832.0,DAIRY MAID STRIPE MUG,1,124,29,3000,2876,0,27.999999999999996
2586,15834.0,ALARM CLOCK BAKELIKE GREEN,6,1249,114,11500,10251,1,228.0
2587,15835.0,VINTAGE RED ENAMEL TRIM PLATE,4,153,27,2800,2647,1,54.0
2588,15836.0,VICTORIAN GLASS HANGING T-LIGHT,2,112,6,700,588,0,12.0
2589,15837.0,JAM MAKING SET PRINTED,1,98,13,1400,1302,0,11.299999999999999
2590,15838.0,12 PENCIL SMALL TUBE WOODLAND,21,335,75,7600,7265,1,150.0
2591,15839.0,LUNCH BAG  BLACK SKULL.,5,148,35,3600,3452,0,28.700000000000003
2592,15840.0,WOODEN TREE CHRISTMAS SCANDINAVIAN,3,57,13,1400,1343,0,13.9
2593,15841.0,FRENCH PAISLEY CUSHION COVER ,6,69,20,2100,2031,0,22.3
2594,15843.0,SET OF 16 VINTAGE PISTACHIO CUTLERY,1,57,3,400,343,0,6.0
2595,15844.0,SWALLOW WOODEN CHRISTMAS DECORATION,1,19,7,800,781,0,14.0
2596,15845.0,PAPER BUNTING WHITE LACE,10,390,69,7000,6610,1,138.0
2597,15847.0,GREY HEART HOT WATER BOTTLE,2,73,12,1300,1227,0,24.0
2598,15850.0,LUNCH BAG VINTAGE LEAF DESIGN,2,151,53,5400,5249,1,106.0
2599,15852.0,REGENCY CAKESTAND 3 TIER,2,73,11,1200,1127,0,22.0
2600,15853.0,SET OF 36 DOILIES SPACEBOY DESIGN ,1,44,15,1600,1556,0,17.7
2601,15854.0,SNACK TRAY PAISLEY PARK,12,411,70,7100,6689,1,140.0
2602,15855.0,REX CASH+CARRY JUMBO SHOPPER,5,150,39,4000,3850,1,78.0
2603,15856.0,TOXIC AREA  DOOR HANGER ,31,1183,208,20900,19717,1,416.0
2604,15857.0,ROLL WRAP 50'S CHRISTMAS,1,13,8,900,887,0,16.0
2605,15858.0,WRAP SUKI AND FRIENDS,5,440,90,9100,8660,1,180.0
2606,15860.0,SET 4 PICNIC CUTLERY CHERRY ,8,488,71,7200,6712,1,142.0
2607,15861.0,LUNCH BAG VINTAGE LEAF DESIGN,9,1186,188,18900,17714,1,376.0
2608,15862.0,WHITE SKULL HOT WATER BOTTLE ,4,402,81,8200,7798,1,162.0
2609,15863.0,HOT WATER BOTTLE I AM SO POORLY,2,66,8,900,834,0,16.0
2610,15864.0,SET 6 SCHOOL MILK BOTTLES IN CRATE,8,67,14,1500,1433,0,13.9
2611,15865.0,BUNDLE OF 3 SCHOOL EXERCISE BOOKS  ,3,224,21,2200,1976,1,42.0
2612,15866.0, 4 PURPLE FLOCK DINNER CANDLES,1,174,28,2900,2726,1,56.0
2613,15867.0,WRAP SUKI AND FRIENDS,16,1589,168,16900,15311,1,336.0
2614,15869.0,SMALL HANGING GLASS+ZINC LANTERN,2,32,8,900,868,0,16.0
2615,15870.0,SET OF 6 TEA TIME BAKING CASES,1,136,38,3900,3764,0,30.299999999999994
2616,15872.0,CHARLIE & LOLA WASTEPAPER BIN BLUE,2,265,63,6400,6135,1,126.0
2617,15874.0,12 PENCIL SMALL TUBE WOODLAND,9,759,65,6600,5841,1,130.0
2618,15877.0,12 PENCIL SMALL TUBE WOODLAND,3,242,64,6500,6258,1,128.0
2619,15880.0,HAND WARMER UNION JACK,2,229,51,5200,4971,1,102.0
2620,15881.0,REX CASH+CARRY JUMBO SHOPPER,8,103,18,1900,1797,0,14.299999999999999
2621,15882.0,ROSE SCENT CANDLE IN JEWELLED BOX,5,45,9,1000,955,0,12.200000000000001
2622,15883.0,REX CASH+CARRY JUMBO SHOPPER,2,144,25,2600,2456,0,23.1
2623,15885.0,ANTIQUE TALL SWIRLGLASS TRINKET POT,3,102,9,1000,898,0,18.0
2624,15886.0,REX CASH+CARRY JUMBO SHOPPER,1,35,6,700,665,0,12.0
2625,15888.0,PACK OF 20 SPACEBOY NAPKINS,2,32,7,800,768,0,14.0
2626,15889.0,CHRISTMAS TOILET ROLL,2,268,49,5000,4732,1,98.0
2627,15891.0,PLASTERS IN TIN CIRCUS PARADE ,1,164,32,3300,3136,1,64.0
2628,15894.0,REX CASH+CARRY JUMBO SHOPPER,2,82,23,2400,2318,0,17.600000000000005
2629,15895.0,MONSTERS STENCIL CRAFT,1,21,6,700,679,0,12.0
2630,15897.0,SET 2 PANTRY DESIGN TEA TOWELS,2,50,13,1400,1350,0,12.5
2631,15898.0,HOT WATER BOTTLE I AM SO POORLY,6,287,45,4600,4313,1,90.0
2632,15899.0,SMALL POLKADOT CHOCOLATE GIFT BAG ,1,16,1,200,184,0,2.0
2633,15900.0,SET 6 PAPER TABLE LANTERN STARS ,1,103,30,3100,2997,0,23.8
2634,15901.0,RECYCLED PENCIL WITH RABBIT ERASER,3,243,59,6000,5757,1,118.0
2635,15903.0,HOT WATER BOTTLE I AM SO POORLY,8,166,37,3800,3634,1,74.0
2636,15904.0,FRENCH PAISLEY CUSHION COVER ,1,88,17,1800,1712,0,15.2
2637,15906.0,12 PENCIL SMALL TUBE WOODLAND,8,515,70,7100,6585,1,140.0
2638,15907.0,12 PENCILS SMALL TUBE RED RETROSPOT,3,644,117,11800,11156,1,234.0
2639,15909.0,PACK OF 6 HANDBAG GIFT BOXES,1,13,3,400,387,0,6.0
2640,15910.0,PAPER BUNTING VINTAGE PARTY,8,483,112,11300,10817,1,224.0
2641,15912.0,GLITTER HANGING BUTTERFLY STRING,2,39,10,1100,1061,0,10.5
2642,15916.0,LUNCH BAG  BLACK SKULL.,10,613,83,8400,7787,1,166.0
2643,15917.0,PICNIC BASKET WICKER LARGE,1,61,6,700,639,0,12.0
2644,15918.0,DINOSAUR LUNCH BOX WITH CUTLERY,2,100,21,2200,2100,0,20.7
2645,15919.0,TOXIC AREA  DOOR HANGER ,2,352,65,6600,6248,1,130.0
2646,15920.0, 4 PURPLE FLOCK DINNER CANDLES,4,129,32,3300,3171,0,28.099999999999998
2647,15921.0,RECYCLED ACAPULCO MAT RED,1,94,11,1200,1106,0,22.0
2648,15922.0,ANTIQUE TALL SWIRLGLASS TRINKET POT,2,51,8,900,849,0,16.0
2649,15923.0,REX CASH+CARRY JUMBO SHOPPER,1,59,11,1200,1141,0,12.299999999999997
2650,15925.0,SET OF 36 PAISLEY FLOWER DOILIES,1,34,5,600,566,0,10.0
2651,15930.0,BLUE HAPPY BIRTHDAY BUNTING,1,84,12,1300,1216,0,24.0
2652,15932.0,TOY TIDY DOLLY GIRL DESIGN,11,184,65,6600,6416,1,130.0
2653,15933.0,JAM MAKING SET PRINTED,3,158,42,4300,4142,1,84.0
2654,15935.0,CARD PARTY GAMES ,2,327,6,700,373,1,12.0
2655,15937.0,BUNDLE OF 3 SCHOOL EXERCISE BOOKS  ,1,16,4,500,484,0,8.0
2656,15938.0,SET OF 12  VINTAGE POSTCARD SET,5,41,11,1200,1159,0,22.0
2657,15939.0,SET/6 PINK  BUTTERFLY T-LIGHTS,16,140,42,4300,4160,0,43.09999999999999
2658,15940.0,Manual,2,12,0,100,88,0,0.0
2659,15942.0,COFFEE MUG CAT + BIRD DESIGN,1,37,8,900,863,0,16.0
2660,15944.0,ROSES REGENCY TEACUP AND SAUCER ,1,30,3,400,370,0,6.0
2661,15945.0,FAIRY CAKE NOTEBOOK A5 SIZE,1,5,1,200,195,0,2.0
2662,15947.0,SET OF 6 TEA TIME BAKING CASES,1,116,14,1500,1384,0,14.2
2663,15948.0,BUNDLE OF 3 SCHOOL EXERCISE BOOKS  ,2,151,31,3200,3049,1,62.0
2664,15949.0,MISTLETOE HEART WREATH GREEN,2,34,11,1200,1166,0,22.0
2665,15950.0,SET 7 BABUSHKA NESTING BOXES,5,366,55,5600,5234,1,110.0
2666,15951.0,TOY TIDY PINK POLKADOT,3,170,26,2700,2530,1,52.0
2667,15952.0,REX CASH+CARRY JUMBO SHOPPER,4,298,43,4400,4102,1,86.0
2668,15953.0,BISCUITS SMALL BOWL LIGHT BLUE,10,289,52,5300,5011,1,104.0
2669,15955.0,LUNCH BAG  BLACK SKULL.,16,530,87,8800,8270,1,174.0
2670,15957.0,PACK OF 6 COCKTAIL PARASOL STRAWS,1,117,23,2400,2283,0,23.200000000000006
2671,15958.0,RECYCLED ACAPULCO MAT BLUE,1,27,4,500,473,0,8.0
2672,15963.0,JAM MAKING SET PRINTED,2,67,14,1500,1433,0,14.7
2673,15965.0,WHITE SKULL HOT WATER BOTTLE ,4,279,60,6100,5821,1,120.0
2674,15967.0,REX CASH+CARRY JUMBO SHOPPER,2,240,44,4500,4260,1,88.0
2675,15969.0,FRENCH PAISLEY CUSHION COVER ,4,162,10,1100,938,1,20.0
2676,15970.0,BLUE 3 PIECE POLKADOT CUTLERY SET,1,28,5,600,572,0,10.0
2677,15971.0,WALL TIDY RETROSPOT ,12,81,19,2000,1919,0,17.7
2678,15973.0,TWO DOOR CURIO CABINET,3,39,3,400,361,0,6.0
2679,15974.0,S/12 VANILLA  BOTANICAL T-LIGHTS,8,498,83,8400,7902,1,166.0
2680,15975.0,SET OF 6 TEA TIME BAKING CASES,1,51,12,1300,1249,0,10.100000000000001
2681,15976.0,LUNCH BAG  BLACK SKULL.,2,235,49,5000,4765,1,98.0
2682,15977.0,REX CASH+CARRY JUMBO SHOPPER,2,194,34,3500,3306,1,68.0
2683,15978.0,JAM MAKING SET PRINTED,1,96,28,2900,2804,0,26.099999999999998
2684,15980.0,HOT WATER BOTTLE I AM SO POORLY,3,89,23,2400,2311,0,20.599999999999994
2685,15981.0,LUNCH BAG VINTAGE LEAF DESIGN,8,214,47,4800,4586,1,94.0
2686,15983.0,CHRISTMAS CRAFT WHITE FAIRY ,4,237,60,6100,5863,1,120.0
2687,15984.0,IVORY SWEETHEART WIRE LETTER RACK ,11,753,117,11800,11047,1,234.0
2688,15985.0,HERB MARKER PARSLEY,3,67,21,2200,2133,0,19.599999999999994
2689,15986.0,WOODEN TREE CHRISTMAS SCANDINAVIAN,1,12,7,800,788,0,14.0
2690,15987.0,LUNCH BAG  BLACK SKULL.,7,301,69,7000,6699,1,138.0
2691,15988.0,TREASURE ISLAND BOOK BOX,1,93,16,1700,1607,0,13.199999999999996
2692,15990.0,GINGERBREAD MAN COOKIE CUTTER,2,158,29,3000,2842,1,58.0
2693,15992.0,3 TIER CAKE TIN GREEN AND CREAM,1,18,1,200,182,0,2.0
2694,15993.0,MINI PLAYING CARDS GYMKHANA,10,1271,194,19500,18229,1,388.0
2695,15994.0,TREASURE ISLAND BOOK BOX,1,118,17,1800,1682,0,16.799999999999997
2696,15996.0,MIRROR CORNICE,7,525,71,7200,6675,1,142.0
2697,15998.0,LUNCH BAG VINTAGE LEAF DESIGN,6,1295,174,17500,16205,1,348.0
2698,16000.0,CLASSIC BICYCLE CLIPS ,3,30,4,500,470,0,8.0
2699,16003.0,MIRROR CORNICE,5,516,49,5000,4484,1,98.0
2700,16005.0,LUNCH BAG  BLACK SKULL.,4,517,104,10500,9983,1,208.0
2701,16006.0,HANGING JAM JAR T-LIGHT HOLDER,1,12,3,400,388,0,6.0
2702,16007.0,12 PENCIL SMALL TUBE WOODLAND,4,687,150,15100,14413,1,300.0
2703,16008.0,REX CASH+CARRY JUMBO SHOPPER,3,69,16,1700,1631,0,15.6
2704,16009.0,LUNCH BAG  BLACK SKULL.,4,298,47,4800,4502,1,94.0
2705,16010.0,SPOTTY PINK DUCK DOORSTOP,3,191,42,4300,4109,1,84.0
2706,16011.0,HEART OF WICKER SMALL,16,448,102,10300,9852,1,204.0
2707,16012.0,12 PENCIL SMALL TUBE WOODLAND,3,243,46,4700,4457,1,92.0
2708,16013.0,GLASS BON BON JAR,54,444,82,8300,7856,1,164.0
2709,16014.0,LUNCH BAG  BLACK SKULL.,4,413,72,7300,6887,1,144.0
2710,16015.0,12 PENCIL SMALL TUBE WOODLAND,4,236,81,8200,7964,1,162.0
2711,16016.0,12 PENCIL SMALL TUBE WOODLAND,10,728,103,10400,9672,1,206.0
2712,16017.0,HAND WARMER UNION JACK,1,85,13,1400,1315,0,14.7
2713,16018.0,REX CASH+CARRY JUMBO SHOPPER,2,92,15,1600,1508,0,11.799999999999997
2714,16019.0,WRAP SUKI AND FRIENDS,10,556,80,8100,7544,1,160.0
2715,16020.0,SET OF 6 TEA TIME BAKING CASES,3,112,23,2400,2288,0,21.200000000000003
2716,16022.0,LETS GO SHOPPING COTTON TOTE BAG,1,251,38,3900,3649,1,76.0
2717,16023.0,MINI PLAYING CARDS GYMKHANA,3,316,50,5100,4784,1,100.0
2718,16024.0,PLASTERS IN TIN CIRCUS PARADE ,1,71,33,3400,3329,0,33.8
2719,16025.0,ZINC WILLIE WINKIE  CANDLE STICK,1,55,13,1400,1345,0,11.6
2720,16026.0,HERB MARKER PARSLEY,1,41,18,1900,1859,0,17.2
2721,16027.0,WOODEN CROQUET GARDEN SET,7,298,8,900,602,1,16.0
2722,16029.0,JAM MAKING SET PRINTED,76,24111,124,12500,11611,1,248.0
2723,16030.0,WRAP SUKI AND FRIENDS,1,67,14,1500,1433,0,14.4
2724,16031.0,HAND WARMER UNION JACK,2,278,46,4700,4422,1,92.0
2725,16033.0,60 TEATIME FAIRY CAKE CASES,27,3852,254,25500,21648,1,508.0
2726,16034.0,BLUE HAPPY BIRTHDAY BUNTING,3,56,11,1200,1144,0,13.299999999999999
2727,16036.0,JUMBO BAG VINTAGE DOILY ,2,117,25,2600,2483,0,28.899999999999988
2728,16037.0,FELT FARM ANIMAL CHICKEN,3,121,18,1900,1779,0,19.799999999999997
2729,16038.0,CHERRY BLOSSOM TABLE CLOCK ,4,96,15,1600,1504,0,14.700000000000001
2730,16040.0,LUNCH BAG  BLACK SKULL.,3,254,36,3700,3446,1,72.0
2731,16041.0,GARDENERS KNEELING PAD KEEP CALM ,3,32,2,300,268,0,4.0
2732,16042.0,TREASURE ISLAND BOOK BOX,7,235,38,3900,3665,1,76.0
2733,16043.0,WRAP ENGLISH ROSE ,4,175,18,1900,1725,1,36.0
2734,16045.0,WRAP BILLBOARD FONTS DESIGN,4,237,43,4400,4163,1,86.0
2735,16048.0,HAND WARMER BIRD DESIGN,3,25,5,600,575,0,10.0
2736,16049.0,LUNCH BAG  BLACK SKULL.,3,630,138,13900,13270,1,276.0
2737,16050.0,JAM MAKING SET PRINTED,1,25,6,700,675,0,12.0
2738,16052.0,SET OF 4 KNICK KNACK TINS LONDON ,1,84,19,2000,1916,0,14.4
2739,16053.0,60 TEATIME FAIRY CAKE CASES,2,242,47,4800,4558,1,94.0
2740,16054.0,TREASURE ISLAND BOOK BOX,1,279,35,3600,3321,1,70.0
2741,16055.0,RELAX LARGE WOOD LETTERS,1,71,3,400,329,0,6.0
2742,16056.0,HOT WATER BOTTLE I AM SO POORLY,1,256,33,3400,3144,1,66.0
2743,16057.0,BLUE HAPPY BIRTHDAY BUNTING,10,567,63,6400,5833,1,126.0
2744,16059.0,DECORATIVE WICKER HEART LARGE,6,559,81,8200,7641,1,162.0
2745,16061.0,CABIN BAG VINTAGE RETROSPOT,1,29,0,100,71,0,0.0
2746,16062.0,WRAP BILLBOARD FONTS DESIGN,4,174,31,3200,3026,1,62.0
2747,16063.0,JAM MAKING SET PRINTED,1,51,10,1100,1049,0,20.0
2748,16065.0,HERB MARKER PARSLEY,1,138,36,3700,3562,0,42.79999999999999
2749,16066.0,CHRISTMAS CRAFT WHITE FAIRY ,5,316,48,4900,4584,1,96.0
2750,16070.0,JAM MAKING SET PRINTED,2,69,17,1800,1731,0,17.4
2751,16071.0,GLASS BON BON JAR,1,57,12,1300,1243,0,10.199999999999998
2752,16072.0,BREAD BIN DINER STYLE PINK,1,193,12,1300,1107,1,24.0
2753,16073.0,GLASS JAR ENGLISH CONFECTIONERY,2,5,1,200,195,0,2.0
2754,16076.0,SPOTTY PINK DUCK DOORSTOP,11,329,76,7700,7371,1,152.0
2755,16078.0,PICNIC BASKET WICKER SMALL,1,4,0,100,96,0,0.0
2756,16079.0,ROLL WRAP 50'S CHRISTMAS,3,62,9,1000,938,0,11.399999999999999
2757,16080.0,WOODLAND CHARLOTTE BAG,3,19,6,700,681,0,12.0
2758,16081.0,HAND WARMER UNION JACK,5,635,108,10900,10265,1,216.0
2759,16083.0,SET/6 PINK  BUTTERFLY T-LIGHTS,2,48,16,1700,1652,0,15.399999999999999
2760,16084.0,SET/6 PINK  BUTTERFLY T-LIGHTS,1,100,21,2200,2100,0,16.8
2761,16085.0,MINI PLAYING CARDS GYMKHANA,5,398,80,8100,7702,1,160.0
2762,16086.0,MIRROR MOSAIC VOTIVE HOLDER,6,127,22,2300,2173,0,18.7
2763,16091.0,PINK VINTAGE PAISLEY PICNIC BAG,2,51,10,1100,1049,0,20.0
2764,16092.0,GINGERBREAD MAN COOKIE CUTTER,5,116,28,2900,2784,0,23.299999999999997
2765,16093.0,SANDALWOOD FAN,1,0,0,100,100,0,0.0
2766,16094.0,WOODEN CROQUET GARDEN SET,6,243,34,3500,3257,1,68.0
2767,16096.0,SWEETHEART CAKESTAND 3 TIER,1,159,4,500,341,1,8.0
2768,16097.0,WOODEN CROQUET GARDEN SET,1,53,7,800,747,0,14.0
2769,16098.0,S/15 SILVER GLASS BAUBLES IN BAG,7,296,38,3900,3604,1,76.0
2770,16099.0,12 PENCILS SMALL TUBE RED RETROSPOT,3,72,23,2400,2328,0,17.2
2771,16101.0,LUNCH BAG  BLACK SKULL.,3,214,43,4400,4186,1,86.0
2772,16102.0,HOT WATER BOTTLE I AM SO POORLY,3,148,29,3000,2852,0,28.80000000000001
2773,16103.0,RECYCLED ACAPULCO MAT GREEN,6,221,26,2700,2479,1,52.0
2774,16104.0,REX CASH+CARRY JUMBO SHOPPER,1,97,19,2000,1903,0,13.9
2775,16105.0,WRAP ENGLISH ROSE ,1,15,7,800,785,0,14.0
2776,16106.0,VINTAGE DOILY TRAVEL SEWING KIT,1,9,4,500,491,0,8.0
2777,16107.0,FAWN BLUE HOT WATER BOTTLE,7,135,19,2000,1865,0,15.3
2778,16108.0,GINGERBREAD MAN COOKIE CUTTER,2,95,25,2600,2505,0,22.10000000000001
2779,16109.0,BLUE CAT BISCUIT BARREL PINK HEART,2,28,9,1000,972,0,18.0
2780,16110.0,SET OF 72 RETROSPOT PAPER  DOILIES,3,802,135,13600,12798,1,270.0
2781,16112.0,STRAWBERRY CHARLOTTE BAG,4,8,9,1000,992,0,18.0
2782,16113.0,REX CASH+CARRY JUMBO SHOPPER,1,79,12,1300,1221,0,17.300000000000004
2783,16114.0,RECIPE BOX PANTRY YELLOW DESIGN,1,26,4,500,474,0,8.0
2784,16115.0,ALARM CLOCK BAKELIKE GREEN,8,669,115,11600,10931,1,230.0
2785,16116.0,SET OF 6 VINTAGE NOTELETS KIT,2,158,19,2000,1842,1,38.0
2786,16117.0,JAM MAKING SET PRINTED,1,73,16,1700,1627,0,14.399999999999999
2787,16119.0,SET OF 3 NOTEBOOKS IN PARCEL,2,34,7,800,766,0,14.0
2788,16120.0,BLACK PIRATE TREASURE CHEST,5,56,20,2100,2044,0,16.200000000000003
2789,16121.0,WRAP SUKI AND FRIENDS,2,416,98,9900,9484,1,196.0
2790,16122.0,FELTCRAFT GIRL AMELIE KIT,4,60,22,2300,2240,0,16.8
2791,16123.0,FRIDGE MAGNETS LES ENFANTS ASSORTED,1,49,8,900,851,0,16.0
2792,16124.0,BLUE GIANT GARDEN THERMOMETER,2,150,10,1100,950,1,20.0
2793,16125.0,JAM MAKING SET PRINTED,1,41,6,700,659,0,12.0
2794,16126.0,EASTER TIN BUNNY BOUQUET,4,427,60,6100,5673,1,120.0
2795,16127.0,VINTAGE UNION JACK CUSHION COVER,1,124,20,2100,1976,0,17.000000000000004
2796,16128.0,GINGERBREAD MAN COOKIE CUTTER,5,215,45,4600,4385,1,90.0
2797,16131.0,WOODEN CROQUET GARDEN SET,6,253,40,4100,3847,1,80.0
2798,16133.0,SMALL PURPLE BABUSHKA NOTEBOOK ,46,1169,145,14600,13431,1,290.0
2799,16134.0,RED RETROSPOT SUGAR JAM BOWL,3,76,17,1800,1724,0,20.400000000000002
2800,16135.0,I'M ON HOLIDAY METAL SIGN,1,72,10,1100,1028,0,11.9
2801,16136.0,SET OF 4 NAPKIN CHARMS HEARTS,3,98,23,2400,2302,0,16.100000000000005
2802,16138.0,ROUND CAKE TIN VINTAGE RED,1,7,0,100,93,0,0.0
2803,16139.0,SET OF 6 TEA TIME BAKING CASES,3,85,18,1900,1815,0,14.300000000000002
2804,16140.0,12 PENCIL SMALL TUBE WOODLAND,4,75,21,2200,2125,0,15.699999999999998
2805,16141.0,ANTIQUE SILVER BAUBLE LAMP  ,1,140,16,1700,1560,0,13.900000000000002
2806,16142.0,WRAP SUKI AND FRIENDS,1,106,19,2000,1894,0,17.6
2807,16143.0,HEART OF WICKER SMALL,7,486,59,6000,5514,1,118.0
2808,16144.0,REGENCY CAKESTAND 3 TIER,1,10,0,100,90,0,0.0
2809,16145.0,LUNCH BAG  BLACK SKULL.,18,518,108,10900,10382,1,216.0
2810,16146.0,PAPER BUNTING WHITE LACE,3,60,15,1600,1540,0,16.4
2811,16147.0,GREY HEART HOT WATER BOTTLE,1,86,12,1300,1214,0,24.0
2812,16148.0,ANTIQUE SILVER TEA GLASS ETCHED,1,1,0,100,99,0,0.0
2813,16149.0,WOODEN TREE CHRISTMAS SCANDINAVIAN,2,22,10,1100,1078,0,10.200000000000003
2814,16150.0,DECORATIVE WICKER HEART LARGE,10,422,66,6700,6278,1,132.0
2815,16152.0,RED RETROSPOT SUGAR JAM BOWL,1,173,16,1700,1527,1,32.0
2816,16153.0,LUNCH BAG  BLACK SKULL.,5,266,45,4600,4334,1,90.0
2817,16156.0,PAPER BUNTING VINTAGE PARTY,13,444,70,7100,6656,1,140.0
2818,16157.0,GLASS BON BON JAR,4,66,13,1400,1334,0,12.0
2819,16159.0,FELT FARM ANIMAL CHICKEN,1,26,8,900,874,0,16.0
2820,16160.0,LUNCH BAG VINTAGE LEAF DESIGN,4,38,11,1200,1162,0,22.0
2821,16161.0,PIG KEYRING WITH LIGHT & SOUND ,26,1636,175,17600,15964,1,350.0
2822,16162.0,CREAM SWEETHEART MINI CHEST,1,18,1,200,182,0,2.0
2823,16163.0,JAM MAKING SET PRINTED,3,32,3,400,368,0,6.0
2824,16164.0,RIBBON REEL SNOWY VILLAGE,4,102,20,2100,1998,0,19.8
2825,16168.0,BLUE GIANT GARDEN THERMOMETER,28,329,50,5100,4771,1,100.0
2826,16169.0,LUNCH BAG  BLACK SKULL.,4,175,43,4400,4225,1,86.0
2827,16170.0,PIG KEYRING WITH LIGHT & SOUND ,7,262,68,6900,6638,1,136.0
2828,16171.0,SET OF 4 KNICK KNACK TINS LONDON ,1,10,1,200,190,0,2.0
2829,16172.0,"ELEPHANT, BIRTHDAY CARD, ",5,133,36,3700,3567,0,33.000000000000014
2830,16173.0,HOT WATER BOTTLE I AM SO POORLY,7,347,45,4600,4253,1,90.0
2831,16174.0,LUNCH BAG  BLACK SKULL.,3,85,12,1300,1215,0,12.300000000000002
2832,16175.0,WOODEN UNION JACK BUNTING,4,208,30,3100,2892,1,60.0
2833,16177.0,MEDIUM PARLOUR PICTURE FRAME ,1,81,7,800,719,0,14.0
2834,16178.0,RETROSPOT SMALL TUBE MATCHES,1,25,4,500,475,0,8.0
2835,16179.0,"FANCY FONT BIRTHDAY CARD, ",1,41,4,500,459,0,8.0
2836,16180.0,LUNCH BAG  BLACK SKULL.,10,430,80,8100,7670,1,160.0
2837,16181.0,ASSORTED CREEPY CRAWLIES,1,26,6,700,674,0,12.0
2838,16182.0,SLATE TILE NATURAL HANGING,4,59,15,1600,1541,0,14.599999999999996
2839,16183.0,LOVE HOT WATER BOTTLE,1,52,7,800,748,0,14.0
2840,16184.0,RECYCLED ACAPULCO MAT GREEN,7,183,22,2300,2117,1,44.0
2841,16185.0,GINGERBREAD MAN COOKIE CUTTER,2,102,14,1500,1398,0,11.0
2842,16186.0,12 PENCIL SMALL TUBE WOODLAND,13,402,97,9800,9398,1,194.0
2843,16187.0,DECORATIVE WICKER HEART LARGE,17,644,116,11700,11056,1,232.0
2844,16188.0,PLASTERS IN TIN CIRCUS PARADE ,4,148,33,3400,3252,0,33.9
2845,16189.0,CLEAR DRAWER KNOB ACRYLIC EDWARDIAN,2,43,7,800,757,0,14.0
2846,16190.0,RETROSPOT TEA SET CERAMIC 11 PC ,1,43,3,400,357,0,6.0
2847,16191.0,GINGERBREAD MAN COOKIE CUTTER,25,341,76,7700,7359,1,152.0
2848,16193.0,DOUGHNUT LIP GLOSS ,1,44,11,1200,1156,0,11.299999999999999
2849,16198.0,LA JARDIN BOTANIQUE CUSHION COVER,1,62,7,800,738,0,14.0
2850,16200.0,12 PENCIL SMALL TUBE WOODLAND,2,464,85,8600,8136,1,170.0
2851,16201.0,LUNCH BAG  BLACK SKULL.,5,234,58,5900,5666,1,116.0
2852,16202.0,BOX OF VINTAGE JIGSAW BLOCKS ,1,62,12,1300,1238,0,24.0
2853,16203.0,GINGERBREAD MAN COOKIE CUTTER,5,104,21,2200,2096,0,17.500000000000004
2854,16204.0,PACK OF 6 SKULL PAPER CUPS,1,117,27,2800,2683,0,25.600000000000005
2855,16205.0,LUNCH BAG  BLACK SKULL.,4,218,52,5300,5082,1,104.0
2856,16206.0,MIRRORED WALL ART LADIES,4,147,37,3800,3653,0,27.7
2857,16207.0,REX CASH+CARRY JUMBO SHOPPER,1,80,9,1000,920,0,10.200000000000001
2858,16208.0,PACK OF 6 COCKTAIL PARASOL STRAWS,2,208,35,3600,3392,1,70.0
2859,16209.0,GARDENERS KNEELING PAD KEEP CALM ,5,114,29,3000,2886,0,23.2
2860,16210.0,DOORMAT RED RETROSPOT,18,462,62,6300,5838,1,124.0
2861,16211.0,SET OF 6 TEA TIME BAKING CASES,2,91,12,1300,1209,0,24.0
2862,16212.0,LUNCH BAG  BLACK SKULL.,3,190,24,2500,2310,1,48.0
2863,16213.0,CREAM SWEETHEART MINI CHEST,1,22,3,400,378,0,6.0
2864,16214.0,GINGERBREAD MAN COOKIE CUTTER,3,199,26,2700,2501,1,52.0
2865,16215.0,SET 6 SCHOOL MILK BOTTLES IN CRATE,1,60,6,700,640,0,12.0
2866,16216.0,RETROSPOT LAMP,1,332,17,1800,1468,1,34.0
2867,16217.0,JAM MAKING SET PRINTED,4,81,10,1100,1019,0,10.299999999999999
2868,16218.0,LUNCH BAG  BLACK SKULL.,8,157,47,4800,4643,1,94.0
2869,16221.0,LUNCH BAG VINTAGE LEAF DESIGN,3,218,47,4800,4582,1,94.0
2870,16222.0,SET OF 36 DOILIES SPACEBOY DESIGN ,1,441,65,6600,6159,1,130.0
2871,16224.0,ALARM CLOCK BAKELIKE GREEN,4,235,44,4500,4265,1,88.0
2872,16225.0,IVORY SWEETHEART WIRE LETTER RACK ,5,320,68,6900,6580,1,136.0
2873,16226.0,STRAWBRY SCENTED VOTIVE CANDLE,3,14,3,400,386,0,6.0
2874,16227.0,HOME SWEET HOME MUG,2,22,3,400,378,0,6.0
2875,16229.0,BLUE GIANT GARDEN THERMOMETER,2,158,25,2600,2442,1,50.0
2876,16230.0,SET 6 PAPER TABLE LANTERN STARS ,2,68,18,1900,1832,0,17.800000000000004
2877,16232.0,60 TEATIME FAIRY CAKE CASES,5,93,21,2200,2107,0,21.599999999999998
2878,16233.0,VICTORIAN SEWING BOX LARGE,5,116,13,1400,1284,0,11.000000000000004
2879,16235.0,RECIPE BOX PANTRY YELLOW DESIGN,6,230,21,2200,1970,1,42.0
2880,16236.0,SET OF 4 KNICK KNACK TINS LONDON ,1,57,10,1100,1043,0,11.0
2881,16239.0,DECORATIVE WICKER HEART LARGE,3,50,10,1100,1050,0,11.1
2882,16240.0,DOORMAT MERRY CHRISTMAS RED ,5,576,66,6700,6124,1,132.0
2883,16241.0,LUNCH BAG VINTAGE LEAF DESIGN,13,1469,189,19000,17531,1,378.0
2884,16242.0,LUNCH BAG  BLACK SKULL.,8,715,116,11700,10985,1,232.0
2885,16243.0,REX CASH+CARRY JUMBO SHOPPER,2,297,32,3300,3003,1,64.0
2886,16244.0,BLUE HAPPY BIRTHDAY BUNTING,2,233,48,4900,4667,1,96.0
2887,16245.0,BLUE HAPPY BIRTHDAY BUNTING,5,310,46,4700,4390,1,92.0
2888,16247.0,VINTAGE UNION JACK APRON,1,43,7,800,757,0,14.0
2889,16248.0,SET OF 6 NATIVITY MAGNETS ,1,14,3,400,386,0,6.0
2890,16249.0,WOODEN CROQUET GARDEN SET,5,240,32,3300,3060,1,64.0
2891,16250.0,RED RETROSPOT PEG BAG,2,74,13,1400,1326,0,10.600000000000003
2892,16252.0,BLUE POLKADOT CUP,1,67,12,1300,1233,0,24.0
2893,16253.0,SMALL PURPLE BABUSHKA NOTEBOOK ,3,211,61,6200,5989,1,122.0
2894,16255.0,60 TEATIME FAIRY CAKE CASES,10,775,109,11000,10225,1,218.0
2895,16256.0,SET 20 NAPKINS FAIRY CAKES DESIGN ,2,35,6,700,665,0,12.0
2896,16257.0,CARRIAGE,1,46,1,200,154,0,2.0
2897,16258.0,ALARM CLOCK BAKELIKE GREEN,5,409,64,6500,6091,1,128.0
2898,16260.0,LANDMARK FRAME COVENT GARDEN ,1,96,9,1000,904,0,18.0
2899,16261.0,SMALL HANGING IVORY/RED WOOD BIRD,4,415,59,6000,5585,1,118.0
2900,16262.0,OCEAN SCENT CANDLE IN JEWELLED BOX,1,17,1,200,183,0,2.0
2901,16265.0,WRAP SUKI AND FRIENDS,11,968,108,10900,9932,1,216.0
2902,16266.0,LUNCH BAG VINTAGE LEAF DESIGN,7,240,30,3100,2860,1,60.0
2903,16268.0,JAM MAKING SET PRINTED,2,191,25,2600,2409,1,50.0
2904,16270.0,CHILDS GARDEN BRUSH BLUE,1,174,30,3100,2926,1,60.0
2905,16271.0,MAGIC DRAWING SLATE DINOSAUR,6,226,66,6700,6474,1,132.0
2906,16272.0,JUMBO BAG SPACEBOY DESIGN,1,43,12,1300,1257,0,10.2
2907,16274.0,WOODEN TREE CHRISTMAS SCANDINAVIAN,1,286,33,3400,3114,1,66.0
2908,16275.0,DOORMAT KEEP CALM AND COME IN,1,144,16,1700,1556,0,17.700000000000003
2909,16276.0,ICE CREAM SUNDAE LIP GLOSS,1,11,3,400,389,0,6.0
2910,16278.0,REGENCY CAKESTAND 3 TIER,3,242,11,1200,958,1,22.0
2911,16279.0,WRAP SUKI AND FRIENDS,4,247,50,5100,4853,1,100.0
2912,16281.0,GINGERBREAD MAN COOKIE CUTTER,1,40,10,1100,1060,0,20.0
2913,16282.0,SET 20 NAPKINS FAIRY CAKES DESIGN ,1,30,6,700,670,0,12.0
2914,16283.0,WATERING CAN GREEN DINOSAUR,7,406,82,8300,7894,1,164.0
2915,16284.0,12 PENCIL SMALL TUBE WOODLAND,2,230,54,5500,5270,1,108.0
2916,16287.0,SET OF 3 NOTEBOOKS IN PARCEL,1,17,3,400,383,0,6.0
2917,16292.0,SET OF 6 TEA TIME BAKING CASES,2,51,10,1100,1049,0,20.0
2918,16293.0,PIG KEYRING WITH LIGHT & SOUND ,12,500,58,5900,5400,1,116.0
2919,16295.0,WELCOME  WOODEN BLOCK LETTERS,4,297,42,4300,4003,1,84.0
2920,16297.0,SPACEBOY LUNCH BOX ,4,62,13,1400,1338,0,26.0
2921,16298.0,PAPER LANTERN 5 POINT STAR MOON ,3,109,13,1400,1291,0,12.6
2922,16302.0,DOLLY GIRL CHILDRENS BOWL,2,20,5,600,580,0,10.0
2923,16303.0,LUNCH BAG  BLACK SKULL.,4,472,82,8300,7828,1,164.0
2924,16305.0,LUNCH BAG VINTAGE LEAF DESIGN,1,37,14,1500,1463,0,12.000000000000002
2925,16306.0,WOODEN UNION JACK BUNTING,9,73,19,2000,1927,0,19.500000000000004
2926,16308.0,SMALL CHINESE STYLE SCISSOR,4,1,2,300,299,0,4.0
2927,16309.0,12 PENCIL SMALL TUBE WOODLAND,3,121,24,2500,2379,0,20.6
2928,16311.0,SET 6 PAPER TABLE LANTERN STARS ,2,91,22,2300,2209,0,18.8
2929,16313.0,SET OF 36 PAISLEY FLOWER DOILIES,2,49,6,700,651,0,12.0
2930,16315.0,CAT BOWL VINTAGE CREAM,1,74,8,900,826,0,16.0
2931,16316.0,DOUGHNUT LIP GLOSS ,12,897,72,7300,6403,1,144.0
2932,16317.0,RED RETROSPOT PEG BAG,3,205,38,3900,3695,1,76.0
2933,16318.0,PICTURE DOMINOES,1,47,8,900,853,0,16.0
2934,16319.0,SET 10 LIGHTS NIGHT OWL,1,16,1,200,184,0,2.0
2935,16320.0,WRAP SUKI AND FRIENDS,2,138,24,2500,2362,0,32.6
2936,16321.0,PAPER BUNTING WHITE LACE,7,56,8,900,844,0,16.0
2937,16322.0,WELCOME  WOODEN BLOCK LETTERS,2,90,18,1900,1810,0,18.6
2938,16323.0,PARTY BUNTING,1,4,0,100,96,0,0.0
2939,16324.0,PINK TALL PORCELAIN T-LIGHT HOLDER ,3,251,62,6300,6049,1,124.0
2940,16325.0,WOODEN UNION JACK BUNTING,5,71,10,1100,1029,0,10.799999999999999
2941,16326.0,LUNCH BAG VINTAGE LEAF DESIGN,15,1581,136,13700,12119,1,272.0
2942,16327.0,LUNCH BAG  BLACK SKULL.,6,666,131,13200,12534,1,262.0
2943,16330.0,CUT GLASS HEXAGON T-LIGHT HOLDER,4,113,22,2300,2187,0,22.599999999999998
2944,16332.0,PIG KEYRING WITH LIGHT & SOUND ,8,427,72,7300,6873,1,144.0
2945,16333.0,BALLOON WATER BOMB PACK OF 35,22,47,24,2500,2453,0,25.60000000000001
2946,16337.0,36 PENCILS TUBE RED RETROSPOT,1,30,5,600,570,0,10.0
2947,16338.0,SET 6 PAPER TABLE LANTERN STARS ,1,41,6,700,659,0,12.0
2948,16339.0,FELTCRAFT BUTTERFLY HEARTS,1,105,9,1000,895,0,10.499999999999998
2949,16340.0,DOUGHNUT LIP GLOSS ,1,232,70,7100,6868,1,140.0
2950,16341.0,LUNCH BAG  BLACK SKULL.,6,149,45,4600,4451,0,45.40000000000001
2951,16342.0,3 TIER SWEETHEART GARDEN SHELF,4,84,7,800,716,0,14.0
2952,16343.0,RETROSPOT GIANT TUBE MATCHES,2,128,23,2400,2272,0,22.499999999999996
2953,16344.0,ENAMEL FLOWER JUG CREAM,1,11,0,100,89,0,0.0
2954,16345.0,WOODEN TREE CHRISTMAS SCANDINAVIAN,1,163,19,2000,1837,1,38.0
2955,16347.0,SET 7 BABUSHKA NESTING BOXES,2,346,48,4900,4554,1,96.0
2956,16348.0,TOXIC AREA  DOOR HANGER ,7,673,97,9800,9127,1,194.0
2957,16349.0,WOODEN CROQUET GARDEN SET,1,53,3,400,347,0,6.0
2958,16350.0,DECORATIVE WICKER HEART LARGE,5,212,30,3100,2888,1,60.0
2959,16351.0,JUMBO BAG PINK POLKADOT,1,15,4,500,485,0,8.0
2960,16352.0,HERB MARKER PARSLEY,2,54,12,1300,1246,0,13.1
2961,16353.0,RED RETROSPOT PEG BAG,23,283,50,5100,4817,1,100.0
2962,16354.0,SET OF 6 TEA TIME BAKING CASES,2,122,22,2300,2178,0,17.999999999999993
2963,16356.0,MORE BUTTER METAL SIGN ,4,69,16,1700,1631,0,17.6
2964,16357.0,HAND WARMER UNION JACK,3,155,19,2000,1845,1,38.0
2965,16358.0,LUNCH BAG  BLACK SKULL.,5,208,56,5700,5492,1,112.0
2966,16359.0,HERB MARKER PARSLEY,12,791,31,3200,2409,1,62.0
2967,16360.0,SET OF 4 POLKADOT PLACEMATS ,8,1571,201,20200,18629,1,402.0
2968,16361.0,RIBBON REEL POLKADOTS ,4,327,56,5700,5373,1,112.0
2969,16362.0,REX CASH+CARRY JUMBO SHOPPER,9,264,45,4600,4336,1,90.0
2970,16363.0,VINTAGE GLASS T-LIGHT HOLDER,1,14,2,300,286,0,4.0
2971,16364.0,WOODEN CROQUET GARDEN SET,2,183,31,3200,3017,1,62.0
2972,16365.0,RED RETROSPOT PEG BAG,9,262,26,2700,2438,1,52.0
2973,16366.0,WRAP BILLBOARD FONTS DESIGN,1,50,9,1000,950,0,11.099999999999998
2974,16367.0,LUNCH BAG VINTAGE LEAF DESIGN,2,303,62,6300,5997,1,124.0
2975,16368.0,REX CASH+CARRY JUMBO SHOPPER,2,183,40,4100,3917,1,80.0
2976,16369.0,RIBBON REEL POLKADOTS ,3,274,62,6300,6026,1,124.0
2977,16370.0,BLUE HAPPY BIRTHDAY BUNTING,4,657,105,10600,9943,1,210.0
2978,16372.0,12 PENCIL SMALL TUBE WOODLAND,2,257,46,4700,4443,1,92.0
2979,16374.0,12 PENCIL SMALL TUBE WOODLAND,2,284,50,5100,4816,1,100.0
2980,16376.0,SET 7 BABUSHKA NESTING BOXES,3,325,62,6300,5975,1,124.0
2981,16377.0,BROCADE RING PURSE ,1,2,2,300,298,0,4.0
2982,16378.0,12 PENCIL SMALL TUBE WOODLAND,3,41,9,1000,959,0,18.0
2983,16379.0,LUNCH BAG VINTAGE LEAF DESIGN,5,226,51,5200,4974,1,102.0
2984,16380.0,CHRISTMAS CRAFT WHITE FAIRY ,1,57,16,1700,1643,0,18.5
2985,16383.0,12 PENCILS SMALL TUBE RED RETROSPOT,2,232,47,4800,4568,1,94.0
2986,16384.0,FELT FARM ANIMAL CHICKEN,2,115,17,1800,1685,0,19.700000000000003
2987,16385.0,ANT COPPER LIME BOUDICCA BRACELET,3,150,30,3100,2950,1,60.0
2988,16386.0,REX CASH+CARRY JUMBO SHOPPER,2,145,45,4600,4455,0,48.09999999999999
2989,16387.0,CUSHION COVER PINK UNION JACK,1,12,2,300,288,0,4.0
2990,16389.0,SMALL HAMMERED SILVER CANDLEPOT ,5,96,18,1900,1804,0,15.099999999999998
2991,16392.0,REX CASH+CARRY JUMBO SHOPPER,1,89,23,2400,2311,0,24.299999999999997
2992,16393.0,12 PENCIL SMALL TUBE WOODLAND,20,716,146,14700,13984,1,292.0
2993,16394.0,12 PENCILS TALL TUBE WOODLAND,9,112,54,5500,5388,0,52.999999999999986
2994,16395.0,LUNCH BAG  BLACK SKULL.,5,416,95,9600,9184,1,190.0
2995,16398.0,SWEETHEART CAKESTAND 3 TIER,4,508,45,4600,4092,1,90.0
2996,16399.0,LUNCH BAG  BLACK SKULL.,2,201,42,4300,4099,1,84.0
2997,16400.0,HAND WARMER UNION JACK,1,87,16,1700,1613,0,14.600000000000001
2998,16401.0,LUNCH BAG  BLACK SKULL.,20,289,90,9100,8811,1,180.0
2999,16402.0,JAM MAKING SET PRINTED,2,160,29,3000,2840,1,58.0
3000,16403.0,FAIRY CAKES NOTEBOOK A6 SIZE,2,24,9,1000,976,0,18.0
3001,16404.0,HOT WATER BOTTLE I AM SO POORLY,1,118,12,1300,1182,0,24.0
3002,16405.0,T-LIGHT GLASS FLUTED ANTIQUE,2,11,2,300,289,0,4.0
3003,16406.0,HERB MARKER PARSLEY,1,111,33,3400,3289,0,34.0
3004,16407.0,GARLAND WOODEN HAPPY EASTER,10,509,84,8500,7991,1,168.0
3005,16409.0,SET/6 PINK  BUTTERFLY T-LIGHTS,5,628,108,10900,10272,1,216.0
3006,16411.0,GINGERBREAD MAN COOKIE CUTTER,2,91,27,2800,2709,0,23.2
3007,16412.0,LUNCH BAG  BLACK SKULL.,1,72,22,2300,2228,0,15.400000000000002
3008,16413.0,12 PENCIL SMALL TUBE WOODLAND,1,78,15,1600,1522,0,14.5
3009,16414.0,RED RETROSPOT ROUND CAKE TINS,2,49,4,500,451,0,8.0
3010,16415.0,JUMBO BAG VINTAGE DOILY ,1,98,29,3000,2902,0,24.499999999999996
3011,16416.0,12 PENCIL SMALL TUBE WOODLAND,4,221,36,3700,3479,1,72.0
3012,16418.0,REX CASH+CARRY JUMBO SHOPPER,3,383,48,4900,4517,1,96.0
3013,16419.0,REX CASH+CARRY JUMBO SHOPPER,7,232,27,2800,2568,1,54.0
3014,16422.0,PACK OF 6 SKULL PAPER CUPS,75,1248,146,14700,13452,1,292.0
3015,16423.0,CHRISTMAS METAL TAGS ASSORTED ,1,34,8,900,866,0,16.0
3016,16424.0,HANGING JAM JAR T-LIGHT HOLDER,2,28,3,400,372,0,6.0
3017,16425.0,WRAP ENGLISH ROSE ,1,87,11,1200,1113,0,10.100000000000001
3018,16426.0,LUNCH BAG  BLACK SKULL.,10,776,147,14800,14024,1,294.0
3019,16427.0,SMALL MARSHMALLOWS PINK BOWL,2,13,5,600,587,0,10.0
3020,16428.0,ROSES REGENCY TEACUP AND SAUCER ,1,2,0,100,98,0,0.0
3021,16429.0,SET/4 WHITE RETRO STORAGE CUBES ,1,39,1,200,161,0,2.0
3022,16430.0,HAND WARMER UNION JACK,1,26,4,500,474,0,8.0
3023,16431.0,GREEN POLKADOT BOWL,3,152,37,3800,3648,1,74.0
3024,16432.0,GIN + TONIC DIET METAL SIGN,1,25,4,500,475,0,8.0
3025,16433.0,REX CASH+CARRY JUMBO SHOPPER,1,32,8,900,868,0,16.0
3026,16434.0,HEART OF WICKER SMALL,7,355,60,6100,5745,1,120.0
3027,16438.0,SET/6 PINK  BUTTERFLY T-LIGHTS,5,289,67,6800,6511,1,134.0
3028,16440.0,12 PENCIL SMALL TUBE WOODLAND,5,625,113,11400,10775,1,226.0
3029,16441.0,DECORATIVE WICKER HEART LARGE,2,79,13,1400,1321,0,12.799999999999997
3030,16442.0,RIBBON REEL POLKADOTS ,3,389,80,8100,7711,1,160.0
3031,16444.0,REX CASH+CARRY JUMBO SHOPPER,5,215,45,4600,4385,1,90.0
3032,16445.0,MORE BUTTER METAL SIGN ,1,165,33,3400,3235,1,66.0
3033,16446.0,PANTRY PASTRY BRUSH,3,7,2,300,293,0,4.0
3034,16447.0,NUMBER TILE COTTAGE GARDEN 1,1,106,18,1900,1794,0,19.999999999999996
3035,16448.0,WHITE HANGING HEART T-LIGHT HOLDER,1,58,11,1200,1142,0,11.600000000000001
3036,16449.0,SWEETHEART CAKESTAND 3 TIER,3,145,21,2200,2055,0,23.299999999999997
3037,16450.0,WOODLAND CHARLOTTE BAG,1,16,6,700,684,0,12.0
3038,16451.0,CHARLOTTE BAG DOLLY GIRL DESIGN,1,36,9,1000,964,0,18.0
3039,16454.0,MIDNIGHT BLUE DROP CRYSTAL NECKLACE,3,19,1,200,181,0,2.0
3040,16455.0,REX CASH+CARRY JUMBO SHOPPER,7,208,49,5000,4792,1,98.0
3041,16456.0,LUNCH BAG  BLACK SKULL.,5,236,56,5700,5464,1,112.0
3042,16457.0,HEART IVORY TRELLIS LARGE,1,24,4,500,476,0,8.0
3043,16458.0,HOT WATER BOTTLE I AM SO POORLY,18,356,97,9800,9444,1,194.0
3044,16460.0,BLUE HAPPY BIRTHDAY BUNTING,3,226,62,6300,6074,1,124.0
3045,16461.0,BLACK MINI TAPE MEASURE ,1,134,21,2200,2066,0,16.200000000000003
3046,16462.0,WHITE WOOD GARDEN PLANT LADDER,4,34,3,400,366,0,6.0
3047,16463.0,RED RETROSPOT PEG BAG,7,170,44,4500,4330,1,88.0
3048,16464.0,RIBBON REEL SNOWY VILLAGE,3,592,107,10800,10208,1,214.0
3049,16466.0,DECORATIVE WICKER HEART LARGE,7,427,63,6400,5973,1,126.0
3050,16468.0,STOOL HOME SWEET HOME ,1,14,0,100,86,0,0.0
3051,16469.0,LUNCH BAG  BLACK SKULL.,4,528,77,7800,7272,1,154.0
3052,16470.0,12 PENCIL SMALL TUBE WOODLAND,5,328,79,8000,7672,1,158.0
3053,16471.0,SET/6 PINK  BUTTERFLY T-LIGHTS,1,29,6,700,671,0,12.0
3054,16473.0,LARGE WHITE/PINK ROSE ART FLOWER,4,48,10,1100,1052,0,20.0
3055,16474.0,LUNCH BAG  BLACK SKULL.,11,811,144,14500,13689,1,288.0
3056,16475.0,GARDENERS KNEELING PAD KEEP CALM ,4,143,17,1800,1657,0,14.4
3057,16477.0,LUNCH BAG  BLACK SKULL.,7,339,70,7100,6761,1,140.0
3058,16478.0,CHRISTMAS TREE HEART DECORATION,3,50,7,800,750,0,14.0
3059,16479.0,REX CASH+CARRY JUMBO SHOPPER,2,111,15,1600,1489,0,16.200000000000003
3060,16480.0,HOT WATER BOTTLE I AM SO POORLY,1,176,29,3000,2824,1,58.0
3061,16482.0,PACK OF 6 HANDBAG GIFT BOXES,1,24,10,1100,1076,0,20.0
3062,16483.0,WOODEN CROQUET GARDEN SET,1,83,10,1100,1017,0,10.4
3063,16484.0,LUNCH BAG  BLACK SKULL.,3,86,12,1300,1214,0,10.199999999999998
3064,16485.0,HEART OF WICKER SMALL,1,129,21,2200,2071,0,24.100000000000005
3065,16488.0,12 PENCILS TALL TUBE WOODLAND,4,132,14,1500,1368,0,18.400000000000002
3066,16491.0,GLITTER HANGING BUTTERFLY STRING,1,99,17,1800,1701,0,18.4
3067,16493.0,ENVELOPE 50 BLOSSOM IMAGES,6,104,32,3300,3196,0,28.4
3068,16494.0,EASTER TIN BUNNY BOUQUET,1,74,31,3200,3126,0,22.900000000000002
3069,16495.0,SILVER HANGING T-LIGHT HOLDER,3,312,53,5400,5088,1,106.0
3070,16496.0,HAND WARMER UNION JACK,4,274,48,4900,4626,1,96.0
3071,16497.0,VINTAGE JINGLE BELLS WREATH,6,497,63,6400,5903,1,126.0
3072,16498.0,REGENCY SUGAR TONGS,3,40,9,1000,960,0,18.0
3073,16499.0,ALARM CLOCK BAKELIKE GREEN,5,106,10,1100,994,0,11.3
3074,16500.0,VINTAGE DOILY TRAVEL SEWING KIT,6,188,7,800,612,1,14.0
3075,16503.0,LUNCH BAG  BLACK SKULL.,5,361,42,4300,3939,1,84.0
3076,16504.0,REX CASH+CARRY JUMBO SHOPPER,1,106,36,3700,3594,0,37.29999999999999
3077,16505.0,ROLL WRAP VINTAGE CHRISTMAS,1,5,2,300,295,0,4.0
3078,16506.0,HEART OF WICKER LARGE,2,6,1,200,194,0,2.0
3079,16509.0,ROSES REGENCY TEACUP AND SAUCER ,1,99,6,700,601,0,12.0
3080,16510.0,FAMILY ALBUM WHITE PICTURE FRAME,1,69,7,800,731,0,14.0
3081,16511.0,12 PENCIL SMALL TUBE WOODLAND,3,512,85,8600,8088,1,170.0
3082,16513.0,GINGERBREAD MAN COOKIE CUTTER,4,90,22,2300,2210,0,20.100000000000005
3083,16515.0,S/12 VANILLA  BOTANICAL T-LIGHTS,5,293,55,5600,5307,1,110.0
3084,16516.0,REGENCY CAKE SLICE,1,12,2,300,288,0,4.0
3085,16517.0,T-LIGHT HOLDER SWEETHEART HANGING,1,49,7,800,751,0,14.0
3086,16518.0,"FEATHER PEN,LIGHT PINK",3,97,20,2100,2003,0,21.700000000000003
3087,16519.0,BLUE GIANT GARDEN THERMOMETER,2,86,5,600,514,0,10.0
3088,16520.0,LUNCH BAG  BLACK SKULL.,4,433,75,7600,7167,1,150.0
3089,16523.0,LUNCH BAG  BLACK SKULL.,28,1102,131,13200,12098,1,262.0
3090,16525.0,RED RETROSPOT PEG BAG,29,727,84,8500,7773,1,168.0
3091,16526.0,PINK  POLKADOT CUP,1,84,7,800,716,0,14.0
3092,16527.0,OCEAN SCENT CANDLE IN JEWELLED BOX,1,40,10,1100,1060,0,20.0
3093,16528.0,CREAM SWEETHEART MINI CHEST,1,54,9,1000,946,0,18.0
3094,16529.0,SILVER HOOP EARRINGS WITH FLOWER,1,93,17,1800,1707,0,14.5
3095,16531.0,BUNDLE OF 3 SCHOOL EXERCISE BOOKS  ,7,215,41,4200,3985,1,82.0
3096,16532.0,PARTY CHARMS 50 PIECES,3,13,2,300,287,0,4.0
3097,16533.0,TOXIC AREA  DOOR HANGER ,5,472,89,9000,8528,1,178.0
3098,16535.0,SET OF 6 TEA TIME BAKING CASES,1,93,14,1500,1407,0,15.399999999999999
3099,16536.0,SILVER CHRISTMAS TREE BAUBLE STAND ,2,210,29,3000,2790,1,58.0
3100,16539.0,WOODEN TREE CHRISTMAS SCANDINAVIAN,4,175,20,2100,1925,1,40.0
3101,16542.0,SMALL PARISIENNE HEART PHOTO FRAME ,1,15,2,300,285,0,4.0
3102,16545.0,RED RETROSPOT BUTTER DISH,1,11,1,200,189,0,2.0
3103,16546.0,FELT EGG COSY WHITE RABBIT ,3,53,16,1700,1647,0,15.1
3104,16549.0,LUNCH BAG VINTAGE LEAF DESIGN,10,1997,233,23400,21403,1,466.0
3105,16550.0,CHRISTMAS TOILET ROLL,9,670,116,11700,11030,1,232.0
3106,16551.0,DIAMANTE RING ASSORTED IN BOX.,3,62,16,1700,1638,0,14.1
3107,16552.0,12 PENCIL SMALL TUBE WOODLAND,2,69,8,900,831,0,16.0
3108,16553.0,JAM MAKING SET PRINTED,14,196,45,4600,4404,1,90.0
3109,16554.0,SWEETHEART CAKESTAND 3 TIER,7,253,31,3200,2947,1,62.0
3110,16555.0,PARTY METAL SIGN ,2,48,9,1000,952,0,18.0
3111,16556.0,12 PENCILS SMALL TUBE RED RETROSPOT,7,803,97,9800,8997,1,194.0
3112,16557.0,VICTORIAN GLASS HANGING T-LIGHT,2,75,4,500,425,0,8.0
3113,16558.0,PAPER BUNTING VINTAGE PARTY,24,1440,166,16700,15260,1,332.0
3114,16560.0,BANQUET BIRTHDAY  CARD  ,3,224,32,3300,3076,1,64.0
3115,16561.0,SET 6 PAPER TABLE LANTERN STARS ,2,88,17,1800,1712,0,16.0
3116,16563.0,SPACEBOY BIRTHDAY CARD,1,64,9,1000,936,0,18.0
3117,16565.0,EDWARDIAN PARASOL BLACK,1,15,0,100,85,0,0.0
3118,16566.0,SET/12 TAPER CANDLES,6,49,8,900,851,0,11.700000000000001
3119,16567.0,PAPERWEIGHT VINTAGE PAISLEY,2,75,14,1500,1425,0,15.700000000000003
3120,16569.0,WRAP  VINTAGE DOILY ,1,12,3,400,388,0,6.0
3121,16570.0,TREASURE ISLAND BOOK BOX,15,437,71,7200,6763,1,142.0
3122,16571.0,CARD HOLDER LOVE BIRD SMALL,5,237,59,6000,5763,1,118.0
3123,16572.0,GINGERBREAD MAN COOKIE CUTTER,4,220,32,3300,3080,1,64.0
3124,16573.0,SWEETHEART CAKESTAND 3 TIER,4,170,24,2500,2330,1,48.0
3125,16574.0,WOODEN TREE CHRISTMAS SCANDINAVIAN,1,39,13,1400,1361,0,13.100000000000001
3126,16579.0,PINK FOXGLOVE ARTIIFCIAL FLOWER,1,2,0,100,98,0,0.0
3127,16581.0,WRAP ENGLISH ROSE ,2,16,6,700,684,0,12.0
3128,16582.0,BLACK RECORD COVER FRAME,1,9,4,500,491,0,8.0
3129,16583.0,KINGS CHOICE BISCUIT TIN,1,35,8,900,865,0,16.0
3130,16584.0,RECIPE BOX PANTRY YELLOW DESIGN,3,83,17,1800,1717,0,13.600000000000001
3131,16586.0,SWEETHEART CAKESTAND 3 TIER,1,37,4,500,463,0,8.0
3132,16587.0,CREAM SWEETHEART MINI CHEST,1,87,7,800,713,0,14.0
3133,16589.0,RIBBON REEL SNOWY VILLAGE,3,61,18,1900,1839,0,16.9
3134,16591.0,HOT WATER BOTTLE I AM SO POORLY,1,44,5,600,556,0,10.0
3135,16592.0,HAND WARMER UNION JACK,19,494,107,10800,10306,1,214.0
3136,16593.0,DOORMAT WELCOME SUNRISE,3,130,15,1600,1470,0,12.7
3137,16594.0,REX CASH+CARRY JUMBO SHOPPER,1,159,28,2900,2741,1,56.0
3138,16595.0,LUNCH BAG  BLACK SKULL.,1,148,38,3900,3752,0,39.8
3139,16596.0,MEDIUM PARLOUR PICTURE FRAME ,2,49,7,800,751,0,14.0
3140,16597.0,LARGE YELLOW BABUSHKA NOTEBOOK ,1,11,3,400,389,0,6.0
3141,16598.0,HOT WATER BOTTLE I AM SO POORLY,2,27,7,800,773,0,14.0
3142,16600.0,GINGHAM HEART  DOORSTOP RED,6,88,29,3000,2912,0,35.8
3143,16601.0,SET 7 BABUSHKA NESTING BOXES,1,95,18,1900,1805,0,13.7
3144,16602.0,GARDENERS KNEELING PAD KEEP CALM ,2,78,16,1700,1622,0,15.900000000000004
3145,16603.0,12 PENCILS TALL TUBE WOODLAND,2,73,16,1700,1627,0,19.000000000000004
3146,16607.0,PAPER BUNTING VINTAGE PARTY,16,1043,73,7400,6357,1,146.0
3147,16609.0,WRAP SUKI AND FRIENDS,9,999,123,12400,11401,1,246.0
3148,16610.0,ZINC T-LIGHT HOLDER STAR LARGE,1,7,2,300,293,0,4.0
3149,16611.0,PINK CREAM FELT CRAFT TRINKET BOX ,2,46,7,800,754,0,14.0
3150,16612.0,LUNCH BAG DOILEY PATTERN ,4,213,33,3400,3187,1,66.0
3151,16613.0,PICTURE DOMINOES,1,86,19,2000,1914,0,15.800000000000002
3152,16614.0,DOORMAT RED RETROSPOT,1,123,14,1500,1377,0,12.600000000000001
3153,16616.0,LANTERN CREAM GAZEBO ,2,93,19,2000,1907,0,14.299999999999999
3154,16617.0,T-LIGHT HOLDER SWEETHEART HANGING,1,19,2,300,281,0,4.0
3155,16618.0,RIBBON REEL SNOWY VILLAGE,6,365,46,4700,4335,1,92.0
3156,16619.0,PAINT YOUR OWN CANVAS SET,2,48,9,1000,952,0,18.0
3157,16620.0,PACK OF 12 HEARTS DESIGN TISSUES ,2,26,7,800,774,0,14.0
3158,16621.0,GINGERBREAD MAN COOKIE CUTTER,4,133,14,1500,1367,0,15.3
3159,16623.0,HEART IVORY TRELLIS LARGE,1,15,2,300,285,0,4.0
3160,16624.0,LUNCH BAG  BLACK SKULL.,2,147,26,2700,2553,0,21.800000000000004
3161,16625.0,PINK RETRO BIG FLOWER BAG,1,62,11,1200,1138,0,22.0
3162,16626.0,LUNCH BAG  BLACK SKULL.,20,749,89,9000,8251,1,178.0
3163,16627.0,RED RETROSPOT PEG BAG,1,101,11,1200,1099,0,11.100000000000001
3164,16628.0,LUNCH BAG  BLACK SKULL.,6,288,58,5900,5612,1,116.0
3165,16629.0,REX CASH+CARRY JUMBO SHOPPER,2,156,34,3500,3344,1,68.0
3166,16633.0,12 PENCIL SMALL TUBE WOODLAND,7,713,77,7800,7087,1,154.0
3167,16634.0,CREAM SWEETHEART MINI CHEST,2,40,4,500,460,0,8.0
3168,16637.0,GINGERBREAD MAN COOKIE CUTTER,5,195,40,4100,3905,1,80.0
3169,16638.0,PIG KEYRING WITH LIGHT & SOUND ,11,361,45,4600,4239,1,90.0
3170,16639.0,WELCOME  WOODEN BLOCK LETTERS,4,183,27,2800,2617,1,54.0
3171,16641.0,STAR DECORATION RUSTIC,1,25,7,800,775,0,14.0
3172,16642.0,PIG KEYRING WITH LIGHT & SOUND ,3,120,19,2000,1880,0,15.299999999999994
3173,16643.0,HOT WATER BOTTLE I AM SO POORLY,1,98,16,1700,1602,0,13.499999999999998
3174,16644.0,LUNCH BAG  BLACK SKULL.,2,95,30,3100,3005,0,31.199999999999996
3175,16647.0,RETROSPOT TEA SET CERAMIC 11 PC ,2,45,8,900,855,0,16.0
3176,16648.0,GINGERBREAD MAN COOKIE CUTTER,2,27,11,1200,1173,0,11.1
3177,16650.0,DOORMAT KEEP CALM AND COME IN,1,54,13,1400,1346,0,11.6
3178,16652.0,WOODEN CROQUET GARDEN SET,11,503,61,6200,5697,1,122.0
3179,16653.0,GINGERBREAD MAN COOKIE CUTTER,3,260,39,4000,3740,1,78.0
3180,16654.0,RED RETROSPOT SUGAR JAM BOWL,5,129,18,1900,1771,0,13.9
3181,16655.0,BLUE HAPPY BIRTHDAY BUNTING,6,672,112,11300,10628,1,224.0
3182,16656.0,ALARM CLOCK BAKELIKE GREEN,21,189,41,4200,4011,1,82.0
3183,16657.0,12 PENCIL SMALL TUBE WOODLAND,4,327,99,10000,9673,1,198.0
3184,16658.0,BLUE ORGANDY ROUND LAMPSHADE W BEA,1,24,3,400,376,0,6.0
3185,16659.0,SET/20 STRAWBERRY PAPER NAPKINS ,1,1,1,200,199,0,2.0
3186,16660.0,HANGING JAM JAR T-LIGHT HOLDER,5,43,9,1000,957,0,18.0
3187,16665.0,BLACK AND WHITE DOG BOWL,1,48,4,500,452,0,8.0
3188,16666.0,"FEATHER PEN,LIGHT PINK",1,24,14,1500,1476,0,12.799999999999997
3189,16667.0,GINGERBREAD MAN COOKIE CUTTER,2,189,29,3000,2811,1,58.0
3190,16668.0,SET 12 KIDS COLOUR  CHALK STICKS,6,25,11,1200,1175,0,22.0
3191,16669.0,TOXIC AREA  DOOR HANGER ,4,440,72,7300,6860,1,144.0
3192,16670.0,LUNCH BAG  BLACK SKULL.,17,781,119,12000,11219,1,238.0
3193,16671.0,PAPER CHAIN KIT 50'S CHRISTMAS ,3,16,3,400,384,0,6.0
3194,16672.0,ALARM CLOCK BAKELIKE GREEN,23,431,58,5900,5469,1,116.0
3195,16674.0,CHRISTMAS TOILET ROLL,2,197,46,4700,4503,1,92.0
3196,16676.0,WOODEN UNION JACK BUNTING,5,464,47,4800,4336,1,94.0
3197,16678.0,GREY HEART HOT WATER BOTTLE,17,325,86,8700,8375,1,172.0
3198,16679.0,PAIR BUTTERFLY HAIR CLIPS,1,20,1,200,180,0,2.0
3199,16680.0,PINK DINER WALL CLOCK,1,30,5,600,570,0,10.0
3200,16681.0,WRAP I LOVE LONDON ,6,85,22,2300,2215,0,22.799999999999997
3201,16682.0,LUNCH BAG  BLACK SKULL.,5,53,16,1700,1647,0,13.5
3202,16684.0,WRAP SUKI AND FRIENDS,31,709,113,11400,10691,1,226.0
3203,16685.0,ENVELOPE 50 BLOSSOM IMAGES,2,139,32,3300,3161,0,28.499999999999996
3204,16686.0,LANTERN CREAM GAZEBO ,9,1610,187,18800,17190,1,374.0
3205,16688.0,12 PENCILS TALL TUBE WOODLAND,4,172,32,3300,3128,1,64.0
3206,16689.0,CHRISTMAS CARD SCREEN PRINT ,3,53,9,1000,947,0,18.0
3207,16690.0,RETROSPOT TEA SET CERAMIC 11 PC ,3,58,5,600,542,0,10.0
3208,16692.0,POSTAGE,2,165,1,200,35,1,2.0
3209,16693.0,SWEETHEART CAKESTAND 3 TIER,2,260,35,3600,3340,1,70.0
3210,16696.0,REGENCY MILK JUG PINK ,4,39,5,600,561,0,10.0
3211,16697.0,REX CASH+CARRY JUMBO SHOPPER,1,97,11,1200,1103,0,11.0
3212,16698.0,PAPER CHAIN KIT RETROSPOT,2,11,3,400,389,0,6.0
3213,16700.0,LUNCH BAG VINTAGE LEAF DESIGN,17,659,129,13000,12341,1,258.0
3214,16701.0,WHITE SKULL HOT WATER BOTTLE ,18,334,79,8000,7666,1,158.0
3215,16705.0,LUNCH BAG  BLACK SKULL.,29,1284,124,12500,11216,1,248.0
3216,16706.0,RIBBON REEL POLKADOTS ,3,345,61,6200,5855,1,122.0
3217,16708.0,SET 6 PAPER TABLE LANTERN STARS ,1,90,16,1700,1610,0,13.599999999999998
3218,16709.0,WOODEN CROQUET GARDEN SET,5,429,43,4400,3971,1,86.0
3219,16710.0,LUNCH BAG  BLACK SKULL.,10,947,166,16700,15753,1,332.0
3220,16711.0,GLASS APOTHECARY BOTTLE PERFUME,5,76,11,1200,1124,0,12.3
3221,16712.0,LUNCH BAG  BLACK SKULL.,11,1327,174,17500,16173,1,348.0
3222,16713.0,LUNCH BAG VINTAGE LEAF DESIGN,21,1978,191,19200,17222,1,382.0
3223,16714.0,SET/6 PINK  BUTTERFLY T-LIGHTS,4,453,48,4900,4447,1,96.0
3224,16715.0,WOODEN TREE CHRISTMAS SCANDINAVIAN,1,8,9,1000,992,0,18.0
3225,16716.0,3 HOOK PHOTO SHELF ANTIQUE WHITE,3,22,1,200,178,0,2.0
3226,16717.0,DECORATIVE WICKER HEART LARGE,9,878,109,11000,10122,1,218.0
3227,16718.0,HERB MARKER PARSLEY,1,105,23,2400,2295,0,20.800000000000008
3228,16719.0,ALARM CLOCK BAKELIKE GREEN,8,793,87,8800,8007,1,174.0
3229,16720.0,12 PENCIL SMALL TUBE WOODLAND,1,62,15,1600,1538,0,11.699999999999998
3230,16721.0,HERB MARKER PARSLEY,1,87,19,2000,1913,0,17.2
3231,16722.0,LUNCH BAG  BLACK SKULL.,16,279,99,10000,9721,1,198.0
3232,16723.0,JUMBO BAG VINTAGE DOILY ,2,295,26,2700,2405,1,52.0
3233,16725.0,PIG KEYRING WITH LIGHT & SOUND ,8,556,73,7400,6844,1,146.0
3234,16726.0,12 PENCIL SMALL TUBE WOODLAND,5,402,81,8200,7798,1,162.0
3235,16727.0,RIBBON REEL POLKADOTS ,1,76,24,2500,2424,0,22.100000000000005
3236,16728.0,MINI PLAYING CARDS GYMKHANA,4,619,117,11800,11181,1,234.0
3237,16729.0,LUNCH BAG  BLACK SKULL.,26,1559,208,20900,19341,1,416.0
3238,16730.0,REX CASH+CARRY JUMBO SHOPPER,4,115,49,5000,4885,0,43.400000000000006
3239,16732.0,BUNDLE OF 3 SCHOOL EXERCISE BOOKS  ,1,94,18,1900,1806,0,15.900000000000002
3240,16734.0,WOODEN CROQUET GARDEN SET,3,187,30,3100,2913,1,60.0
3241,16735.0,12 PENCIL SMALL TUBE WOODLAND,7,320,58,5900,5580,1,116.0
3242,16737.0,SILVER HANGING T-LIGHT HOLDER,1,1,0,100,99,0,0.0
3243,16738.0,POLYESTER FILLER PAD 30CMx30CM,1,1,0,100,99,0,0.0
3244,16739.0,HEART IVORY TRELLIS LARGE,2,48,10,1100,1052,0,10.1
3245,16742.0,ROSES REGENCY TEACUP AND SAUCER ,2,472,0,100,372,0,0.0
3246,16743.0,SET/6 PINK  BUTTERFLY T-LIGHTS,8,283,88,8900,8617,1,176.0
3247,16744.0,SET 7 BABUSHKA NESTING BOXES,7,604,118,11900,11296,1,236.0
3248,16745.0,LUNCH BAG  BLACK SKULL.,18,689,148,14900,14211,1,296.0
3249,16746.0,LUNCH BAG  BLACK SKULL.,19,1252,162,16300,15048,1,324.0
3250,16747.0,CHRISTMAS LIGHTS 10 REINDEER,4,122,25,2600,2478,0,21.2
3251,16748.0,LUNCH BAG  BLACK SKULL.,5,118,34,3500,3382,0,29.299999999999986
3252,16750.0,REX CASH+CARRY JUMBO SHOPPER,5,362,46,4700,4338,1,92.0
3253,16751.0,SPACEBOY BIRTHDAY CARD,1,35,12,1300,1265,0,10.8
3254,16752.0,SET OF 3 NOTEBOOKS IN PARCEL,1,122,4,500,378,0,8.0
3255,16753.0,MIRRORED WALL ART LADIES,1,72,18,1900,1828,0,14.100000000000001
3256,16754.0,WORLD WAR 2 GLIDERS ASSTD DESIGNS,1,1,0,100,99,0,0.0
3257,16755.0,ALARM CLOCK BAKELIKE GREEN,5,479,90,9100,8621,1,180.0
3258,16756.0,FLOWERS CHANDELIER T-LIGHT HOLDER,1,47,6,700,653,0,12.0
3259,16757.0,PLEASE ONE PERSON METAL SIGN,1,9,3,400,391,0,6.0
3260,16758.0,RED RETROSPOT PEG BAG,1,88,14,1500,1412,0,28.0
3261,16759.0,DOUGHNUT LIP GLOSS ,4,140,22,2300,2160,0,22.299999999999994
3262,16761.0,PACK OF 20 SPACEBOY NAPKINS,1,15,7,800,785,0,14.0
3263,16762.0,GINGERBREAD MAN COOKIE CUTTER,3,290,49,5000,4710,1,98.0
3264,16763.0,60 TEATIME FAIRY CAKE CASES,2,124,11,1200,1076,0,11.799999999999999
3265,16764.0,LUNCH BAG  BLACK SKULL.,18,1708,216,21700,19992,1,432.0
3266,16765.0,VINTAGE UNION JACK BUNTING,1,8,0,100,92,0,0.0
3267,16766.0,GINGERBREAD MAN COOKIE CUTTER,2,96,20,2100,2004,0,15.499999999999998
3268,16767.0,LUNCH BAG  BLACK SKULL.,11,357,103,10400,10043,1,206.0
3269,16768.0,HERB MARKER PARSLEY,5,233,32,3300,3067,1,64.0
3270,16769.0,WELCOME  WOODEN BLOCK LETTERS,1,187,19,2000,1813,1,38.0
3271,16770.0,DECORATIVE WICKER HEART LARGE,6,333,71,7200,6867,1,142.0
3272,16771.0,DECORATIVE WICKER HEART SMALL,5,728,112,11300,10572,1,224.0
3273,16773.0,ROSE 1 WICK MORRIS BOXED CANDLE,1,72,13,1400,1328,0,11.900000000000002
3274,16774.0,DAISIES  HONEYCOMB GARLAND ,5,120,26,2700,2580,0,28.700000000000003
3275,16775.0,DECORATIVE WICKER HEART LARGE,11,733,77,7800,7067,1,154.0
3276,16776.0,REX CASH+CARRY JUMBO SHOPPER,1,147,36,3700,3553,0,37.800000000000004
3277,16777.0,LUNCH BAG  BLACK SKULL.,2,180,25,2600,2420,1,50.0
3278,16778.0,PACK OF 6 COCKTAIL PARASOL STRAWS,2,37,9,1000,963,0,18.0
3279,16779.0,WHITE SKULL HOT WATER BOTTLE ,28,811,145,14600,13789,1,290.0
3280,16780.0,DECORATIVE WICKER HEART LARGE,2,155,30,3100,2945,1,60.0
3281,16781.0,HEART IVORY TRELLIS LARGE,2,101,8,900,799,0,16.0
3282,16782.0,LUNCH BAG  BLACK SKULL.,19,723,93,9400,8677,1,186.0
3283,16784.0,BLACK RECORD COVER FRAME,1,13,1,200,187,0,2.0
3284,16788.0,LUNCH BAG  BLACK SKULL.,2,358,69,7000,6642,1,138.0
3285,16789.0,VICTORIAN GLASS HANGING T-LIGHT,1,14,3,400,386,0,6.0
3286,16790.0,12 PENCILS SMALL TUBE RED RETROSPOT,8,228,50,5100,4872,1,100.0
3287,16791.0,LUNCH BAG  BLACK SKULL.,8,943,132,13300,12357,1,264.0
3288,16792.0,SMALL WHITE RETROSPOT MUG IN BOX ,2,48,4,500,452,0,8.0
3289,16793.0,SET OF 6 TEA TIME BAKING CASES,1,38,6,700,662,0,12.0
3290,16794.0,LUNCH BAG  BLACK SKULL.,12,515,122,12300,11785,1,244.0
3291,16795.0,WHITE BELL HONEYCOMB PAPER GARLAND ,1,145,30,3100,2955,0,29.70000000000001
3292,16796.0,PAINTED METAL HEART WITH HOLLY BELL,1,31,9,1000,969,0,18.0
3293,16800.0,DECORATIVE WICKER HEART LARGE,1,605,70,7100,6495,1,140.0
3294,16801.0,DOORMAT WELCOME SUNRISE,5,733,56,5700,4967,1,112.0
3295,16803.0,SET OF 6 TEA TIME BAKING CASES,1,50,14,1500,1450,0,10.6
3296,16804.0,REX CASH+CARRY JUMBO SHOPPER,3,192,29,3000,2808,1,58.0
3297,16805.0,12 PENCILS SMALL TUBE RED RETROSPOT,2,174,48,4900,4726,1,96.0
3298,16806.0,REX CASH+CARRY JUMBO SHOPPER,4,294,53,5400,5106,1,106.0
3299,16807.0,PACK OF 6 COCKTAIL PARASOL STRAWS,3,172,34,3500,3328,1,68.0
3300,16808.0,BAKING MOULD HEART WHITE CHOCOLATE,2,53,10,1100,1047,0,10.500000000000002
3301,16809.0,LUNCH BAG  BLACK SKULL.,6,231,64,6500,6269,1,128.0
3302,16810.0,ROSE COTTAGE KEEPSAKE BOX ,2,69,9,1000,931,0,18.0
3303,16811.0,LUNCH BAG  BLACK SKULL.,2,66,14,1500,1434,0,15.5
3304,16812.0,ROSE COTTAGE KEEPSAKE BOX ,1,83,10,1100,1017,0,20.0
3305,16813.0,LUNCH BAG  BLACK SKULL.,10,785,172,17300,16515,1,344.0
3306,16814.0,LANTERN CREAM GAZEBO ,22,1068,134,13500,12432,1,268.0
3307,16816.0,FELT EGG COSY WHITE RABBIT ,4,63,15,1600,1537,0,12.700000000000001
3308,16817.0,WOODEN CROQUET GARDEN SET,13,360,45,4600,4240,1,90.0
3309,16818.0,DECORATIVE WICKER HEART LARGE,13,506,88,8900,8394,1,176.0
3310,16820.0,WOODEN CROQUET GARDEN SET,1,97,14,1500,1403,0,13.200000000000001
3311,16823.0,REX CASH+CARRY JUMBO SHOPPER,1,124,22,2300,2176,0,15.499999999999998
3312,16824.0,GINGERBREAD MAN COOKIE CUTTER,2,87,12,1300,1213,0,11.2
3313,16825.0,DOORMAT RED RETROSPOT,2,92,15,1600,1508,0,13.2
3314,16826.0,TREASURE ISLAND BOOK BOX,1,87,12,1300,1213,0,11.199999999999998
3315,16828.0,CLAM SHELL SMALL ,2,30,4,500,470,0,8.0
3316,16829.0,REGENCY SUGAR TONGS,1,33,7,800,767,0,14.0
3317,16830.0,JUMBO BAG VINTAGE DOILY ,1,48,13,1400,1352,0,10.499999999999996
3318,16832.0,ROSE COTTAGE KEEPSAKE BOX ,3,97,8,900,803,0,16.0
3319,16833.0,LUNCH BAG  BLACK SKULL.,4,150,28,2900,2750,1,56.0
3320,16834.0,12 PENCILS TALL TUBE WOODLAND,1,36,10,1100,1064,0,11.7
3321,16835.0,DOORMAT SPOTTY HOME SWEET HOME,2,42,5,600,558,0,10.0
3322,16836.0,CHRISTMAS STAR WISH LIST CHALKBOARD,2,23,7,800,777,0,14.0
3323,16837.0,MIRROR CORNICE,12,696,81,8200,7504,1,162.0
3324,16838.0,ALUMINIUM HEART,3,287,13,1400,1113,1,26.0
3325,16839.0,DOORMAT MERRY CHRISTMAS RED ,39,898,135,13600,12702,1,270.0
3326,16841.0,HEART OF WICKER SMALL,7,153,60,6100,5947,1,120.0
3327,16842.0,MAGIC DRAWING SLATE PURDEY,4,202,28,2900,2698,1,56.0
3328,16843.0,LUNCH BAG  BLACK SKULL.,17,711,149,15000,14289,1,298.0
3329,16846.0,PINK CREAM FELT CRAFT TRINKET BOX ,1,29,6,700,671,0,12.0
3330,16847.0,SET OF 20 VINTAGE CHRISTMAS NAPKINS,1,39,8,900,861,0,16.0
3331,16848.0,SET OF 20 VINTAGE CHRISTMAS NAPKINS,1,23,8,900,877,0,16.0
3332,16849.0,COLOUR GLASS. STAR T-LIGHT HOLDER,1,40,5,600,560,0,10.0
3333,16850.0,CAMOUFLAGE EAR MUFF HEADPHONES,1,40,11,1200,1160,0,11.5
3334,16851.0,CHRISTMAS STAR WISH LIST CHALKBOARD,3,39,12,1300,1261,0,24.0
3335,16852.0,FAMILY ALBUM WHITE PICTURE FRAME,2,74,4,500,426,0,8.0
3336,16855.0,HEART OF WICKER SMALL,2,71,11,1200,1129,0,22.0
3337,16856.0,HEART OF WICKER LARGE,1,5,0,100,95,0,0.0
3338,16858.0,RED RETROSPOT SUGAR JAM BOWL,2,66,6,700,634,0,12.0
3339,16859.0,WRAP SUKI AND FRIENDS,5,229,35,3600,3371,1,70.0
3340,16861.0,PAPER BUNTING RETROSPOT,3,18,6,700,682,0,12.0
3341,16863.0,PACK OF 6 COCKTAIL PARASOL STRAWS,4,46,16,1700,1654,0,11.499999999999998
3342,16866.0,REX CASH+CARRY JUMBO SHOPPER,3,41,5,600,559,0,10.0
3343,16869.0,LUNCH BAG  BLACK SKULL.,5,299,65,6600,6301,1,130.0
3344,16871.0,SET 7 BABUSHKA NESTING BOXES,7,507,68,6900,6393,1,136.0
3345,16872.0,VINTAGE GLASS T-LIGHT HOLDER,3,67,3,400,333,0,6.0
3346,16873.0,MINI PLAYING CARDS GYMKHANA,10,1019,131,13200,12181,1,262.0
3347,16875.0,LUNCH BAG  BLACK SKULL.,9,450,64,6500,6050,1,128.0
3348,16877.0,DECORATIVE WICKER HEART LARGE,6,401,73,7400,6999,1,146.0
3349,16878.0,REX CASH+CARRY JUMBO SHOPPER,2,9,3,400,391,0,6.0
3350,16880.0,CHRISTMAS TOILET ROLL,7,665,82,8300,7635,1,164.0
3351,16881.0,ASSORTED COLOURS SILK FAN,1,0,0,100,100,0,0.0
3352,16882.0,WOODEN TREE CHRISTMAS SCANDINAVIAN,3,107,20,2100,1993,0,17.1
3353,16883.0,BLUE GIANT GARDEN THERMOMETER,2,139,21,2200,2061,0,18.400000000000002
3354,16884.0,REX CASH+CARRY JUMBO SHOPPER,2,51,15,1600,1549,0,14.800000000000002
3355,16885.0,WHITE SKULL HOT WATER BOTTLE ,3,348,47,4800,4452,1,94.0
3356,16887.0,LUNCH BAG  BLACK SKULL.,1,72,16,1700,1628,0,19.0
3357,16889.0,LUNCH BAG  BLACK SKULL.,3,418,66,6700,6282,1,132.0
3358,16891.0,PAPER BUNTING VINTAGE PARTY,5,634,91,9200,8566,1,182.0
3359,16892.0,DECORATIVE WICKER HEART SMALL,7,341,48,4900,4559,1,96.0
3360,16893.0,REX CASH+CARRY JUMBO SHOPPER,1,116,27,2800,2684,0,23.300000000000008
3361,16895.0,LUNCH BAG  BLACK SKULL.,1,167,39,4000,3833,1,78.0
3362,16897.0,RECIPE BOX PANTRY YELLOW DESIGN,3,226,27,2800,2574,1,54.0
3363,16898.0,DOUGHNUT LIP GLOSS ,4,334,76,7700,7366,1,152.0
3364,16899.0,LUNCH BAG  BLACK SKULL.,6,423,60,6100,5677,1,120.0
3365,16900.0,DECORATIVE WICKER HEART LARGE,5,854,45,4600,3746,1,90.0
3366,16902.0,WOODEN UNION JACK BUNTING,1,170,26,2700,2530,1,52.0
3367,16903.0,REX CASH+CARRY JUMBO SHOPPER,1,140,31,3200,3060,0,31.8
3368,16904.0,LUNCH BAG VINTAGE LEAF DESIGN,16,1950,218,21900,19950,1,436.0
3369,16905.0,CHRISTMAS CRAFT WHITE FAIRY ,8,760,94,9500,8740,1,188.0
3370,16906.0,REX CASH+CARRY JUMBO SHOPPER,4,304,50,5100,4796,1,100.0
3371,16907.0,IVORY SWEETHEART WIRE LETTER RACK ,5,571,73,7400,6829,1,146.0
3372,16909.0,PACK OF 12 HEARTS DESIGN TISSUES ,2,65,12,1300,1235,0,10.500000000000002
3373,16910.0,HAND WARMER UNION JACK,8,1188,192,19300,18112,1,384.0
3374,16912.0,RIBBON REEL SNOWY VILLAGE,14,435,55,5600,5165,1,110.0
3375,16913.0,EIGHT PIECE SNAKE  SET,1,16,4,500,484,0,8.0
3376,16914.0,REX CASH+CARRY JUMBO SHOPPER,1,100,21,2200,2100,0,18.699999999999996
3377,16915.0,REX CASH+CARRY JUMBO SHOPPER,6,302,29,3000,2698,1,58.0
3378,16916.0,12 PENCIL SMALL TUBE WOODLAND,2,317,69,7000,6683,1,138.0
3379,16917.0,WOODEN CROQUET GARDEN SET,1,34,5,600,566,0,10.0
3380,16918.0,12 PENCIL SMALL TUBE WOODLAND,7,270,58,5900,5630,1,116.0
3381,16919.0,TOXIC AREA  DOOR HANGER ,11,913,131,13200,12287,1,262.0
3382,16921.0,SPOTTY PINK DUCK DOORSTOP,1,94,28,2900,2806,0,28.499999999999996
3383,16923.0,LANTERN CREAM GAZEBO ,26,2161,195,19600,17439,1,390.0
3384,16924.0,GINGERBREAD MAN COOKIE CUTTER,4,271,44,4500,4229,1,88.0
3385,16926.0,CHRISTMAS PUDDING TRINKET POT ,1,97,6,700,603,0,12.0
3386,16927.0,DOORMAT RED RETROSPOT,3,17,3,400,383,0,6.0
3387,16928.0,SWEETHEART CAKESTAND 3 TIER,19,428,103,10400,9972,1,206.0
3388,16929.0,LUNCH BAG  BLACK SKULL.,7,160,40,4100,3940,1,80.0
3389,16930.0,REX CASH+CARRY JUMBO SHOPPER,3,87,31,3200,3113,0,25.000000000000004
3390,16931.0,LUNCH BAG VINTAGE LEAF DESIGN,21,1853,236,23700,21847,1,472.0
3391,16932.0,REX CASH+CARRY JUMBO SHOPPER,1,115,28,2900,2785,0,23.700000000000003
3392,16933.0,REX CASH+CARRY JUMBO SHOPPER,5,156,25,2600,2444,1,50.0
3393,16934.0,HOT WATER BOTTLE I AM SO POORLY,2,249,32,3300,3051,1,64.0
3394,16936.0,LUNCH BAG  BLACK SKULL.,1,106,30,3100,2994,0,29.3
3395,16938.0,LUNCH BAG  BLACK SKULL.,5,686,108,10900,10214,1,216.0
3396,16940.0,LUNCH BAG  BLACK SKULL.,3,634,132,13300,12666,1,264.0
3397,16942.0,LUNCH BAG  BLACK SKULL.,10,849,113,11400,10551,1,226.0
3398,16943.0,BLUE GIANT GARDEN THERMOMETER,3,225,17,1800,1575,1,34.0
3399,16945.0,LUNCH BAG  BLACK SKULL.,19,555,118,11900,11345,1,236.0
3400,16947.0,12 PENCILS TALL TUBE WOODLAND,1,54,10,1100,1046,0,20.0
3401,16948.0,PACK OF 6 SKULL PAPER CUPS,3,21,8,900,879,0,10.1
3402,16949.0,ENVELOPE 50 BLOSSOM IMAGES,7,508,32,3300,2792,1,64.0
3403,16950.0,SILVER CHRISTMAS TREE BAUBLE STAND ,3,129,20,2100,1971,0,23.099999999999994
3404,16951.0,PACK OF 6 SKULL PAPER CUPS,4,126,44,4500,4374,0,42.300000000000004
3405,16952.0,DOORMAT RED RETROSPOT,2,83,7,800,717,0,14.0
3406,16953.0,JUMBO BAG RED RETROSPOT,1,2,0,100,98,0,0.0
3407,16954.0,GINGERBREAD MAN COOKIE CUTTER,9,180,29,3000,2820,1,58.0
3408,16955.0,CHEST OF DRAWERS GINGHAM HEART ,5,106,15,1600,1494,0,10.8
3409,16956.0,RED RETROSPOT PEG BAG,2,84,10,1100,1016,0,10.8
3410,16957.0,PARTY METAL SIGN ,2,53,7,800,747,0,14.0
3411,16959.0,BROWN CHECK CAT DOORSTOP ,1,21,2,300,279,0,4.0
3412,16960.0,LUNCH BAG  BLACK SKULL.,3,203,52,5300,5097,1,104.0
3413,16961.0,CREAM WALL PLANTER HEART SHAPED,1,37,7,800,763,0,14.0
3414,16963.0,RETROSPOT TEA SET CERAMIC 11 PC ,1,23,4,500,477,0,8.0
3415,16965.0,CITRUS GARLAND FELT FLOWERS ,1,60,15,1600,1540,0,12.200000000000001
3416,16966.0,Manual,10,42,16,1700,1658,0,15.800000000000002
3417,16967.0,PICTURE DOMINOES,1,23,13,1400,1377,0,26.0
3418,16968.0,RETROSPOT CANDLE  MEDIUM,2,86,13,1400,1314,0,17.899999999999995
3419,16969.0,SWEETHEART CAKESTAND 3 TIER,3,100,24,2500,2400,0,21.900000000000002
3420,16971.0,GARDENERS KNEELING PAD KEEP CALM ,2,443,18,1900,1457,1,36.0
3421,16976.0,REGENCY CAKESTAND 3 TIER,1,12,0,100,88,0,0.0
3422,16978.0,RED RETROSPOT PEG BAG,1,114,19,2000,1886,0,20.499999999999996
3423,16979.0,DOORMAT RED RETROSPOT,8,327,49,5000,4673,1,98.0
3424,16980.0,REX CASH+CARRY JUMBO SHOPPER,2,201,42,4300,4099,1,84.0
3425,16982.0,JAM MAKING SET PRINTED,1,53,14,1500,1447,0,12.000000000000002
3426,16983.0,12 PENCIL SMALL TUBE WOODLAND,8,351,71,7200,6849,1,142.0
3427,16984.0,MAGIC DRAWING SLATE DINOSAUR,5,1502,158,15900,14398,1,316.0
3428,16985.0,DOORMAT RED RETROSPOT,11,506,63,6400,5894,1,126.0
3429,16986.0,JUMBO  BAG BAROQUE BLACK WHITE,2,5,1,200,195,0,2.0
3430,16987.0,WOODEN CROQUET GARDEN SET,7,612,59,6000,5388,1,118.0
3431,16988.0,GLASS  SONGBIRD STORAGE JAR,1,41,3,400,359,0,6.0
3432,16989.0,HERB MARKER PARSLEY,6,18,6,700,682,0,12.0
3433,16990.0,JUMBO  BAG BAROQUE BLACK WHITE,1,1,0,100,99,0,0.0
3434,16992.0,RETROSPOT GIANT TUBE MATCHES,6,366,48,4900,4534,1,96.0
3435,16995.0,ANTIQUE SILVER TEA GLASS ENGRAVED,1,1,0,100,99,0,0.0
3436,16996.0,LUNCH BAG SUKI DESIGN ,9,122,22,2300,2178,0,20.7
3437,16997.0,JUMBO BAG SCANDINAVIAN PAISLEY,3,23,7,800,777,0,14.0
3438,16998.0,Manual,6,19,2,300,281,0,4.0
3439,16999.0,ASSORTED COLOUR MINI CASES,2,55,14,1500,1445,0,14.600000000000001
3440,17001.0,LUNCH BAG VINTAGE LEAF DESIGN,11,516,79,8000,7484,1,158.0
3441,17002.0,WOODEN CROQUET GARDEN SET,4,174,29,3000,2826,1,58.0
3442,17004.0,JUMBO BAG VINTAGE DOILY ,2,116,23,2400,2284,0,22.400000000000002
3443,17006.0,HOT WATER BOTTLE I AM SO POORLY,4,164,23,2400,2236,1,46.0
3444,17007.0,WOODEN CROQUET GARDEN SET,7,174,33,3400,3226,1,66.0
3445,17010.0,TRADTIONAL ALPHABET STAMP SET,2,33,6,700,667,0,12.0
3446,17011.0,PACK OF 6 SANDCASTLE FLAGS ASSORTED,1,26,7,800,774,0,14.0
3447,17014.0,REX CASH+CARRY JUMBO SHOPPER,4,221,39,4000,3779,1,78.0
3448,17015.0,CHRISTMAS CRAFT WHITE FAIRY ,3,307,107,10800,10493,1,214.0
3449,17017.0,12 PENCILS SMALL TUBE RED RETROSPOT,27,461,122,12300,11839,1,244.0
3450,17018.0,DOORMAT RED RETROSPOT,2,99,7,800,701,0,14.0
3451,17019.0,12 PENCIL SMALL TUBE WOODLAND,4,496,97,9800,9304,1,194.0
3452,17022.0,WOODEN TREE CHRISTMAS SCANDINAVIAN,1,6,3,400,394,0,6.0
3453,17024.0,COLUMBIAN CANDLE RECTANGLE,3,4,1,200,196,0,2.0
3454,17025.0,VICTORIAN GLASS HANGING T-LIGHT,3,18,3,400,382,0,6.0
3455,17026.0,CHRISTMAS GINGHAM HEART,2,16,1,200,184,0,2.0
3456,17027.0,IVORY SWEETHEART WIRE LETTER RACK ,7,418,78,7900,7482,1,156.0
3457,17029.0,JUMBO BAG RED RETROSPOT,2,3,0,100,97,0,0.0
3458,17030.0,POLYESTER FILLER PAD 45x30cm,1,29,5,600,571,0,10.0
3459,17031.0,LUNCH BAG  BLACK SKULL.,2,35,11,1200,1165,0,11.799999999999995
3460,17033.0,PACK OF 6 COCKTAIL PARASOL STRAWS,3,63,15,1600,1537,0,14.5
3461,17034.0,GLASS BON BON JAR,4,105,16,1700,1595,0,13.100000000000001
3462,17035.0,RECYCLED ACAPULCO MAT GREEN,3,109,17,1800,1691,0,16.000000000000004
3463,17037.0,PINK VINTAGE SPOT BEAKER,2,213,41,4200,3987,1,82.0
3464,17038.0,HAND WARMER UNION JACK,1,97,12,1300,1203,0,14.100000000000001
3465,17040.0,SWEETHEART CAKESTAND 3 TIER,1,49,9,1000,951,0,18.0
3466,17041.0,PACK OF 6 COCKTAIL PARASOL STRAWS,4,138,41,4200,4062,0,35.1
3467,17042.0,REX CASH+CARRY JUMBO SHOPPER,5,178,47,4800,4622,1,94.0
3468,17043.0,SET 7 BABUSHKA NESTING BOXES,4,320,51,5200,4880,1,102.0
3469,17044.0,RETROSPOT HEART HOT WATER BOTTLE,3,38,5,600,562,0,10.0
3470,17045.0,HOT WATER BOTTLE I AM SO POORLY,3,109,12,1300,1191,0,24.0
3471,17046.0,LUNCH BAG VINTAGE LEAF DESIGN,1,47,14,1500,1453,0,10.9
3472,17047.0,SMALL JEWELLERY STAND,3,229,33,3400,3171,1,66.0
3473,17048.0,SWEETHEART CAKESTAND 3 TIER,6,209,23,2400,2191,1,46.0
3474,17049.0,DECORATIVE WICKER HEART LARGE,11,1285,138,13900,12615,1,276.0
3475,17050.0,DOUGHNUT LIP GLOSS ,6,878,139,14000,13122,1,278.0
3476,17051.0,DINOSAUR LUNCH BOX WITH CUTLERY,1,78,22,2300,2222,0,21.500000000000004
3477,17052.0,PINK VINTAGE SPOT BEAKER,1,171,46,4700,4529,1,92.0
3478,17053.0,PIGGY BANK RETROSPOT ,2,60,7,800,740,0,14.0
3479,17054.0,SWEETHEART CAKESTAND 3 TIER,6,397,41,4200,3803,1,82.0
3480,17058.0,BLUE GIANT GARDEN THERMOMETER,3,233,32,3300,3067,1,64.0
3481,17059.0,12 PENCIL SMALL TUBE WOODLAND,5,1371,184,18500,17129,1,368.0
3482,17060.0,SMALL REGAL  SILVER CANDLEPOT ,1,8,1,200,192,0,2.0
3483,17061.0,BLUE HAPPY BIRTHDAY BUNTING,12,512,53,5400,4888,1,106.0
3484,17062.0,BLUE GIANT GARDEN THERMOMETER,5,153,34,3500,3347,1,68.0
3485,17063.0,LUNCH BAG  BLACK SKULL.,11,227,45,4600,4373,1,90.0
3486,17064.0,GINGHAM HEART  DOORSTOP RED,3,228,34,3500,3272,1,68.0
3487,17065.0,Manual,1,112,0,100,12,0,0.0
3488,17068.0,LUNCH BAG  BLACK SKULL.,22,742,127,12800,12058,1,254.0
3489,17069.0,LUNCH BAG VINTAGE LEAF DESIGN,13,428,74,7500,7072,1,148.0
3490,17070.0,BLUE GIANT GARDEN THERMOMETER,1,165,36,3700,3535,1,72.0
3491,17071.0,HAND WARMER UNION JACK,14,501,68,6900,6399,1,136.0
3492,17073.0,BLUE HAPPY BIRTHDAY BUNTING,4,543,82,8300,7757,1,164.0
3493,17075.0,BLUE GIANT GARDEN THERMOMETER,5,316,42,4300,3984,1,84.0
3494,17076.0,BROWN  PIRATE TREASURE CHEST ,3,146,14,1500,1354,0,15.6
3495,17078.0,REX CASH+CARRY JUMBO SHOPPER,2,16,13,1400,1384,0,13.299999999999999
3496,17079.0,PARTY BUNTING,1,9,1,200,191,0,2.0
3497,17080.0,SET 6 SCHOOL MILK BOTTLES IN CRATE,3,31,3,400,369,0,6.0
3498,17081.0,REX CASH+CARRY JUMBO SHOPPER,2,242,30,3100,2858,1,60.0
3499,17082.0,DOORMAT RED RETROSPOT,2,342,47,4800,4458,1,94.0
3500,17083.0,GREEN POLKADOT BOWL,3,107,24,2500,2393,0,24.5
3501,17084.0,SET 4 PICNIC CUTLERY CHERRY ,2,468,74,7500,7032,1,148.0
3502,17085.0,DECORATIVE WICKER HEART LARGE,6,522,92,9300,8778,1,184.0
3503,17086.0,WRAP SUKI AND FRIENDS,6,207,43,4400,4193,1,86.0
3504,17088.0,LUNCH BAG  BLACK SKULL.,4,438,60,6100,5662,1,120.0
3505,17090.0,SET OF 6 TEA TIME BAKING CASES,8,174,36,3700,3526,1,72.0
3506,17091.0,LUNCH BAG  BLACK SKULL.,10,637,90,9100,8463,1,180.0
3507,17092.0,HAND WARMER UNION JACK,4,282,62,6300,6018,1,124.0
3508,17094.0,WOODLAND CHARLOTTE BAG,2,38,10,1100,1062,0,20.0
3509,17095.0,BLUE GIANT GARDEN THERMOMETER,6,501,41,4200,3699,1,82.0
3510,17096.0,HOT WATER BOTTLE I AM SO POORLY,7,235,25,2600,2365,1,50.0
3511,17097.0,ALARM CLOCK BAKELIKE GREEN,9,563,89,9000,8437,1,178.0
3512,17100.0,12 PENCIL SMALL TUBE WOODLAND,2,126,31,3200,3074,0,29.400000000000006
3513,17101.0,TREASURE ISLAND BOOK BOX,4,121,20,2100,1979,0,23.4
3514,17102.0,CAKE STAND 3 TIER MAGIC GARDEN,1,12,0,100,88,0,0.0
3515,17105.0,HEART OF WICKER SMALL,2,175,41,4200,4025,1,82.0
3516,17107.0,LUNCH BAG  BLACK SKULL.,7,1401,161,16200,14799,1,322.0
3517,17109.0,HELLO SAILOR BLUE SOAP HOLDER,8,283,60,6100,5817,1,120.0
3518,17110.0,BLUE GIANT GARDEN THERMOMETER,1,62,5,600,538,0,10.0
3519,17111.0,BUNDLE OF 3 SCHOOL EXERCISE BOOKS  ,1,55,16,1700,1645,0,13.199999999999998
3520,17114.0,DECORATIVE WICKER HEART LARGE,10,696,62,6300,5604,1,124.0
3521,17115.0,SWEETHEART CAKESTAND 3 TIER,5,201,25,2600,2399,1,50.0
3522,17117.0,FAMILY ALBUM WHITE PICTURE FRAME,1,35,5,600,565,0,10.0
3523,17118.0,LUNCH BAG  BLACK SKULL.,1,13,4,500,487,0,8.0
3524,17119.0,CHRYSANTHEMUM NOTEBOOK,3,131,20,2100,1969,0,19.700000000000003
3525,17120.0,RETROSPOT TEA SET CERAMIC 11 PC ,1,79,8,900,821,0,16.0
3526,17122.0,DECORATIVE WICKER HEART LARGE,1,13,4,500,487,0,8.0
3527,17123.0,HEART IVORY TRELLIS LARGE,1,15,4,500,485,0,8.0
3528,17124.0,REX CASH+CARRY JUMBO SHOPPER,1,109,18,1900,1791,0,15.8
3529,17125.0,REX CASH+CARRY JUMBO SHOPPER,1,138,18,1900,1762,0,22.100000000000005
3530,17126.0,LUNCH BAG  BLACK SKULL.,7,495,111,11200,10705,1,222.0
3531,17128.0,MIRRORED DISCO BALL ,1,55,8,900,845,0,16.0
3532,17131.0,IVORY SWEETHEART WIRE LETTER RACK ,5,471,61,6200,5729,1,122.0
3533,17133.0,AREA PATROLLED METAL SIGN,7,57,13,1400,1343,0,13.499999999999998
3534,17134.0,SWEETHEART CAKESTAND 3 TIER,2,130,14,1500,1370,0,13.300000000000002
3535,17135.0,TOY TIDY PINK POLKADOT,7,262,27,2800,2538,1,54.0
3536,17138.0,PINK PARTY BAGS,1,117,11,1200,1083,0,12.4
3537,17139.0,LUNCH BAG VINTAGE LEAF DESIGN,15,1854,174,17500,15646,1,348.0
3538,17140.0,REX CASH+CARRY JUMBO SHOPPER,1,50,11,1200,1150,0,22.0
3539,17142.0,REVOLVER WOODEN RULER ,1,287,9,1000,713,1,18.0
3540,17144.0,VICTORIAN SEWING BOX LARGE,2,253,27,2800,2547,1,54.0
3541,17146.0,WOODEN UNION JACK BUNTING,3,246,19,2000,1754,1,38.0
3542,17147.0,EASTER TIN BUNNY BOUQUET,6,293,43,4400,4107,1,86.0
3543,17148.0,LUNCH BAG  BLACK SKULL.,1,14,4,500,486,0,8.0
3544,17152.0,PACK OF 60 SPACEBOY CAKE CASES,4,58,7,800,742,0,14.0
3545,17153.0,WALL ART STOP FOR TEA ,1,39,8,900,861,0,16.0
3546,17154.0,WOODEN TREE CHRISTMAS SCANDINAVIAN,1,25,14,1500,1475,0,13.6
3547,17155.0,PACK OF 6 COCKTAIL PARASOL STRAWS,2,51,11,1200,1149,0,11.400000000000002
3548,17157.0,BUNDLE OF 3 SCHOOL EXERCISE BOOKS  ,3,41,8,900,859,0,16.0
3549,17158.0,WELCOME  WOODEN BLOCK LETTERS,3,217,35,3600,3383,1,70.0
3550,17159.0,LUNCH BAG  BLACK SKULL.,4,245,45,4600,4355,1,90.0
3551,17160.0,LUNCH BAG  BLACK SKULL.,6,377,100,10100,9723,1,200.0
3552,17162.0,BLUE HAPPY BIRTHDAY BUNTING,11,406,49,5000,4594,1,98.0
3553,17163.0,GREY HEART HOT WATER BOTTLE,2,22,2,300,278,0,4.0
3554,17164.0,CHRISTMAS CRAFT WHITE FAIRY ,8,359,65,6600,6241,1,130.0
3555,17165.0,FELTCRAFT BUTTERFLY HEARTS,1,30,6,700,670,0,12.0
3556,17166.0,GREEN POLKADOT BOWL,3,49,7,800,751,0,14.0
3557,17169.0,RED RETROSPOT PEG BAG,4,170,29,3000,2830,1,58.0
3558,17171.0,WOODEN UNION JACK BUNTING,1,38,6,700,662,0,12.0
3559,17172.0,PAINTED METAL HEART WITH HOLLY BELL,2,17,6,700,683,0,12.0
3560,17173.0,RED RETROSPOT SUGAR JAM BOWL,9,330,47,4800,4470,1,94.0
3561,17174.0,TOY TIDY PINK POLKADOT,1,6,1,200,194,0,2.0
3562,17175.0,IVORY SWEETHEART WIRE LETTER RACK ,5,270,31,3200,2930,1,62.0
3563,17176.0,SMALL ZINC HEART WALL ORGANISER,1,41,7,800,759,0,14.0
3564,17179.0,GREEN POLKADOT BOWL,3,185,42,4300,4115,1,84.0
3565,17180.0,S/12 VANILLA  BOTANICAL T-LIGHTS,6,257,70,7100,6843,1,140.0
3566,17181.0,AGED GLASS SILVER T-LIGHT HOLDER,2,69,14,1500,1431,0,12.800000000000002
3567,17183.0,BLUE GIANT GARDEN THERMOMETER,8,318,34,3500,3182,1,68.0
3568,17186.0,POPCORN HOLDER,2,1,1,200,199,0,2.0
3569,17187.0,SWEETHEART CAKESTAND 3 TIER,1,37,6,700,663,0,12.0
3570,17188.0,SWEETHEART CAKESTAND 3 TIER,9,253,44,4500,4247,1,88.0
3571,17189.0,DOORMAT RED RETROSPOT,2,141,26,2700,2559,0,36.300000000000004
3572,17190.0,RUSTIC STRAWBERRY JAM POT LARGE ,3,428,12,1300,872,1,24.0
3573,17191.0,SET 7 BABUSHKA NESTING BOXES,7,607,104,10500,9893,1,208.0
3574,17193.0,MINI PLAYING CARDS SPACEBOY ,9,84,17,1800,1716,0,20.499999999999996
3575,17194.0,SET 7 BABUSHKA NESTING BOXES,2,113,14,1500,1387,0,16.299999999999997
3576,17197.0,WHITE SKULL HOT WATER BOTTLE ,1,159,18,1900,1741,1,36.0
3577,17198.0,SET 7 BABUSHKA NESTING BOXES,3,278,56,5700,5422,1,112.0
3578,17201.0,BLUE GIANT GARDEN THERMOMETER,1,77,22,2300,2223,0,22.899999999999995
3579,17203.0,DECORATIVE WICKER HEART LARGE,6,263,78,7900,7637,1,156.0
3580,17204.0,LUNCH BAG  BLACK SKULL.,9,319,38,3900,3581,1,76.0
3581,17205.0,WRAP I LOVE LONDON ,1,6,7,800,794,0,14.0
3582,17206.0,EMBROIDERED RIBBON REEL REBECCA ,1,19,4,500,481,0,8.0
3583,17211.0,LUNCH BAG  BLACK SKULL.,9,691,98,9900,9209,1,196.0
3584,17212.0,ROSES REGENCY TEACUP AND SAUCER ,1,5,2,300,295,0,4.0
3585,17213.0,ROSE SCENT CANDLE IN JEWELLED BOX,11,679,82,8300,7621,1,164.0
3586,17214.0,RIBBON REEL POLKADOTS ,7,628,52,5300,4672,1,104.0
3587,17217.0,REX CASH+CARRY JUMBO SHOPPER,1,33,4,500,467,0,8.0
3588,17218.0,SET 7 BABUSHKA NESTING BOXES,10,797,117,11800,11003,1,234.0
3589,17219.0,RECYCLED ACAPULCO MAT GREEN,1,47,11,1200,1153,0,11.4
3590,17220.0,LUNCH BAG VINTAGE LEAF DESIGN,14,1161,163,16400,15239,1,326.0
3591,17221.0,RED RETROSPOT PEG BAG,2,122,32,3300,3178,0,33.599999999999994
3592,17222.0,ROSE 1 WICK MORRIS BOXED CANDLE,1,83,15,1600,1517,0,13.900000000000002
3593,17223.0,GLITTER HANGING BUTTERFLY STRING,2,213,28,2900,2687,1,56.0
3594,17226.0,BANQUET BIRTHDAY  CARD  ,1,54,12,1300,1246,0,11.3
3595,17227.0,REX CASH+CARRY JUMBO SHOPPER,6,64,22,2300,2236,0,24.4
3596,17228.0,12 PENCIL SMALL TUBE WOODLAND,8,359,89,9000,8641,1,178.0
3597,17229.0,LUNCH BAG VINTAGE LEAF DESIGN,2,94,25,2600,2506,0,18.5
3598,17230.0,REX CASH+CARRY JUMBO SHOPPER,11,270,42,4300,4030,1,84.0
3599,17231.0,RIBBON REEL POLKADOTS ,14,1520,188,18900,17380,1,376.0
3600,17232.0,GINGERBREAD MAN COOKIE CUTTER,2,95,21,2200,2105,0,20.800000000000004
3601,17233.0,POPPY FIELDS CHOPPING BOARD,1,61,13,1400,1339,0,10.2
3602,17234.0,CHILDRENS CUTLERY DOLLY GIRL ,1,51,6,700,649,0,12.0
3603,17235.0,REX CASH+CARRY JUMBO SHOPPER,2,92,14,1500,1408,0,16.5
3604,17236.0,IVORY SWEETHEART WIRE LETTER RACK ,6,282,55,5600,5318,1,110.0
3605,17237.0,CLASSIC BICYCLE CLIPS ,2,61,11,1200,1139,0,22.0
3606,17238.0,LUNCH BAG  BLACK SKULL.,17,1521,181,18200,16679,1,362.0
3607,17239.0,RIBBON REEL HEARTS DESIGN ,2,63,9,1000,937,0,18.0
3608,17242.0,LUNCH BAG  BLACK SKULL.,2,85,16,1700,1615,0,21.7
3609,17243.0,LUNCH BAG VINTAGE LEAF DESIGN,30,1722,154,15500,13778,1,308.0
3610,17244.0,REX CASH+CARRY JUMBO SHOPPER,1,52,16,1700,1648,0,12.600000000000003
3611,17245.0,6 RIBBONS RUSTIC CHARM,1,26,5,600,574,0,10.0
3612,17247.0,WOODEN CROQUET GARDEN SET,1,180,32,3300,3120,1,64.0
3613,17248.0,REX CASH+CARRY JUMBO SHOPPER,1,131,37,3800,3669,0,30.000000000000004
3614,17250.0,12 PENCIL SMALL TUBE WOODLAND,2,171,30,3100,2929,1,60.0
3615,17251.0,PICTURE DOMINOES,1,136,21,2200,2064,0,22.000000000000004
3616,17252.0,TOXIC AREA  DOOR HANGER ,2,241,43,4400,4159,1,86.0
3617,17253.0,WOODEN CROQUET GARDEN SET,1,101,8,900,799,0,16.0
3618,17254.0,12 PENCIL SMALL TUBE WOODLAND,2,168,54,5500,5332,1,108.0
3619,17255.0,REX CASH+CARRY JUMBO SHOPPER,2,150,34,3500,3350,1,68.0
3620,17256.0,SKULL AND CROSSBONES  GARLAND ,2,39,7,800,761,0,14.0
3621,17259.0,CHRISTMAS TOILET ROLL,2,289,63,6400,6111,1,126.0
3622,17262.0,6 RIBBONS EMPIRE  ,5,48,7,800,752,0,14.0
3623,17263.0,REX CASH+CARRY JUMBO SHOPPER,1,46,14,1500,1454,0,13.999999999999998
3624,17265.0,NO JUNK MAIL METAL SIGN,2,295,67,6800,6505,1,134.0
3625,17266.0,TREASURE ISLAND BOOK BOX,3,207,37,3800,3593,1,74.0
3626,17267.0,HOT WATER BOTTLE I AM SO POORLY,2,129,18,1900,1771,0,18.6
3627,17268.0,ZINC  STAR T-LIGHT HOLDER ,4,6,4,500,494,0,8.0
3628,17272.0,TREASURE ISLAND BOOK BOX,5,215,56,5700,5485,1,112.0
3629,17274.0,RUSTIC STRAWBERRY JAM POT LARGE ,1,47,15,1600,1553,0,12.9
3630,17277.0,REX CASH+CARRY JUMBO SHOPPER,2,231,38,3900,3669,1,76.0
3631,17278.0,BLUE GIANT GARDEN THERMOMETER,1,71,6,700,629,0,12.0
3632,17279.0,LARGE CERAMIC TOP STORAGE JAR,1,60,6,700,640,0,12.0
3633,17282.0,GARLAND WOODEN HAPPY EASTER,3,224,46,4700,4476,1,92.0
3634,17284.0,SET OF 4 POLKADOT PLACEMATS ,7,483,122,12300,11817,1,244.0
3635,17286.0,REX CASH+CARRY JUMBO SHOPPER,1,84,22,2300,2216,0,21.7
3636,17287.0,CHRISTMAS TOILET ROLL,7,393,64,6500,6107,1,128.0
3637,17288.0,PIG KEYRING WITH LIGHT & SOUND ,7,379,66,6700,6321,1,132.0
3638,17289.0,LARGE IVORY HEART WALL ORGANISER,4,251,58,5900,5649,1,116.0
3639,17290.0,TOXIC AREA  DOOR HANGER ,2,262,45,4600,4338,1,90.0
3640,17291.0,GLASS CLOCHE LARGE,1,7,0,100,93,0,0.0
3641,17293.0,PIG KEYRING WITH LIGHT & SOUND ,9,373,63,6400,6027,1,126.0
3642,17295.0,JUMBO BAG VINTAGE DOILY ,3,203,33,3400,3197,1,66.0
3643,17297.0,TREASURE ISLAND BOOK BOX,1,112,25,2600,2488,0,28.399999999999995
3644,17298.0,REX CASH+CARRY JUMBO SHOPPER,2,62,15,1600,1538,0,16.7
3645,17299.0,WRAP BILLBOARD FONTS DESIGN,4,92,32,3300,3208,0,31.5
3646,17301.0,DECORATIVE WICKER HEART LARGE,1,126,43,4400,4274,0,31.60000000000001
3647,17302.0,TREASURE ISLAND BOOK BOX,6,213,40,4100,3887,1,80.0
3648,17303.0,BLUE GIANT GARDEN THERMOMETER,1,155,29,3000,2845,1,58.0
3649,17306.0,REGENCY SUGAR TONGS,21,108,37,3800,3692,0,32.800000000000004
3650,17307.0,STRAWBERRY CERAMIC TRINKET BOX,1,1,0,100,99,0,0.0
3651,17309.0,SLATE TILE NATURAL HANGING,1,35,6,700,665,0,12.0
3652,17311.0,GINGERBREAD MAN COOKIE CUTTER,2,168,27,2800,2632,1,54.0
3653,17312.0,REX CASH+CARRY JUMBO SHOPPER,3,32,6,700,668,0,12.0
3654,17313.0,GINGERBREAD MAN COOKIE CUTTER,2,59,14,1500,1441,0,13.600000000000001
3655,17314.0,VINTAGE KEEPSAKE BOX TRAVELOGUE,11,328,68,6900,6572,1,136.0
3656,17315.0,LUNCH BAG  BLACK SKULL.,43,1342,167,16800,15458,1,334.0
3657,17317.0,RIBBON REEL SNOWY VILLAGE,5,31,6,700,669,0,12.0
3658,17320.0,DOORMAT RED RETROSPOT,3,273,39,4000,3727,1,78.0
3659,17321.0,MIRROR CORNICE,2,296,55,5600,5304,1,110.0
3660,17323.0,LUNCH BAG VINTAGE LEAF DESIGN,9,294,102,10300,10006,1,204.0
3661,17324.0,REX CASH+CARRY JUMBO SHOPPER,4,138,23,2400,2262,0,24.800000000000004
3662,17325.0,SET OF 3 NOTEBOOKS IN PARCEL,1,9,3,400,391,0,6.0
3663,17329.0,WHITE SKULL HOT WATER BOTTLE ,2,136,17,1800,1664,0,14.600000000000001
3664,17330.0,PLAYING CARDS JUBILEE UNION JACK,2,26,2,300,274,0,4.0
3665,17331.0,REGENCY CAKESTAND 3 TIER,1,10,0,100,90,0,0.0
3666,17333.0,HOT WATER BOTTLE I AM SO POORLY,1,49,13,1400,1351,0,14.600000000000003
3667,17334.0,PAINT YOUR OWN CANVAS SET,3,15,7,800,785,0,14.0
3668,17337.0,60 TEATIME FAIRY CAKE CASES,7,1264,193,19400,18136,1,386.0
3669,17338.0,ROSE SCENT CANDLE IN JEWELLED BOX,10,2122,219,22000,19878,1,438.0
3670,17339.0,SET 6 SCHOOL MILK BOTTLES IN CRATE,2,26,6,700,674,0,12.0
3671,17340.0,PIG KEYRING WITH LIGHT & SOUND ,16,1615,172,17300,15685,1,344.0
3672,17341.0,12 PENCIL SMALL TUBE WOODLAND,3,388,76,7700,7312,1,152.0
3673,17343.0,CHEST OF DRAWERS GINGHAM HEART ,1,79,8,900,821,0,16.0
3674,17344.0,REX CASH+CARRY JUMBO SHOPPER,1,90,18,1900,1810,0,13.700000000000003
3675,17345.0,BISCUITS SMALL BOWL LIGHT BLUE,4,239,47,4800,4561,1,94.0
3676,17346.0,LUNCH BAG  BLACK SKULL.,16,1216,176,17700,16484,1,352.0
3677,17347.0,ANTIQUE SILVER TEA GLASS ENGRAVED,1,1,0,100,99,0,0.0
3678,17348.0,WRAP SUKI AND FRIENDS,5,364,98,9900,9536,1,196.0
3679,17349.0,LOVELY BONBON STICKER SHEET,1,27,4,500,473,0,8.0
3680,17350.0,GINGERBREAD MAN COOKIE CUTTER,5,174,38,3900,3726,1,76.0
3681,17351.0,DOORMAT RED RETROSPOT,3,154,13,1400,1246,1,26.0
3682,17353.0,LUNCH BAG SUKI DESIGN ,2,11,3,400,389,0,6.0
3683,17354.0,VINTAGE BILLBOARD MUG ,1,22,7,800,778,0,14.0
3684,17356.0,FELT EGG COSY WHITE RABBIT ,1,21,9,1000,979,0,18.0
3685,17357.0,WOODEN CROQUET GARDEN SET,2,155,24,2500,2345,1,48.0
3686,17358.0,FROG CANDLE,2,158,32,3300,3142,1,64.0
3687,17359.0,ENGLISH ROSE NOTEBOOK A7 SIZE,1,31,6,700,669,0,12.0
3688,17360.0,ALARM CLOCK BAKELIKE GREEN,3,373,70,7100,6727,1,140.0
3689,17361.0,WOODEN CROQUET GARDEN SET,3,140,16,1700,1560,0,13.8
3690,17362.0,FROG CANDLE,2,104,22,2300,2196,0,16.599999999999998
3691,17364.0,BLUE HAPPY BIRTHDAY BUNTING,12,1124,161,16200,15076,1,322.0
3692,17365.0,WRAP SUKI AND FRIENDS,8,905,170,17100,16195,1,340.0
3693,17367.0,REX CASH+CARRY JUMBO SHOPPER,1,64,17,1800,1736,0,17.199999999999996
3694,17368.0,RIBBON REEL POLKADOTS ,9,291,69,7000,6709,1,138.0
3695,17370.0,PLASTERS IN TIN CIRCUS PARADE ,4,46,17,1800,1754,0,18.299999999999997
3696,17371.0,LUNCH BAG  BLACK SKULL.,3,276,43,4400,4124,1,86.0
3697,17372.0,12 PENCIL SMALL TUBE WOODLAND,8,588,108,10900,10312,1,216.0
3698,17373.0,REX CASH+CARRY JUMBO SHOPPER,4,107,30,3100,2993,0,31.6
3699,17374.0,DOORMAT RED RETROSPOT,2,198,14,1500,1302,1,28.0
3700,17375.0,12 PENCIL SMALL TUBE WOODLAND,4,196,37,3800,3604,1,74.0
3701,17376.0,GINGERBREAD MAN COOKIE CUTTER,2,82,12,1300,1218,0,10.999999999999998
3702,17377.0,LUNCH BAG  BLACK SKULL.,21,1263,151,15200,13937,1,302.0
3703,17379.0,REX CASH+CARRY JUMBO SHOPPER,1,113,43,4400,4287,0,39.599999999999994
3704,17381.0,MAGIC DRAWING SLATE PURDEY,30,146,51,5200,5054,0,50.89999999999999
3705,17382.0,Next Day Carriage,1,17,0,100,83,0,0.0
3706,17383.0,12 PENCIL SMALL TUBE WOODLAND,1,94,26,2700,2606,0,26.0
3707,17384.0,BELLE JARDINIERE CUSHION COVER,2,48,7,800,752,0,14.0
3708,17385.0,DOUGHNUT LIP GLOSS ,1,90,30,3100,3010,0,21.599999999999998
3709,17386.0,LUNCH BAG  BLACK SKULL.,6,45,13,1400,1355,0,12.700000000000001
3710,17387.0,PLASTERS IN TIN CIRCUS PARADE ,2,188,40,4100,3912,1,80.0
3711,17388.0,GINGERBREAD MAN COOKIE CUTTER,4,70,5,600,530,0,10.0
3712,17389.0,WOODEN CROQUET GARDEN SET,43,1273,107,10800,9527,1,214.0
3713,17391.0,EMBOSSED GLASS TEALIGHT HOLDER,2,3,1,200,197,0,2.0
3714,17392.0,GLITTER HANGING BUTTERFLY STRING,2,211,29,3000,2789,1,58.0
3715,17394.0,SMALL HANGING GLASS+ZINC LANTERN,1,13,2,300,287,0,4.0
3716,17396.0,ALARM CLOCK BAKELIKE GREEN,8,119,14,1500,1381,0,14.1
3717,17397.0,MIRRORED WALL ART LADIES,2,282,40,4100,3818,1,80.0
3718,17398.0,CAKE STAND LOVEBIRD 2 TIER WHITE,3,183,22,2300,2117,1,44.0
3719,17400.0,TOXIC AREA  DOOR HANGER ,5,714,97,9800,9086,1,194.0
3720,17402.0,REX CASH+CARRY JUMBO SHOPPER,13,345,32,3300,2955,1,64.0
3721,17403.0,PLAYING CARDS KEEP CALM & CARRY ON,1,103,17,1800,1697,0,15.8
3722,17404.0,SET 7 BABUSHKA NESTING BOXES,18,446,93,9400,8954,1,186.0
3723,17405.0,SPACEBOY BIRTHDAY CARD,5,297,48,4900,4603,1,96.0
3724,17406.0,LANTERN CREAM GAZEBO ,5,1036,56,5700,4664,1,112.0
3725,17408.0,CAKE STAND LOVEBIRD 2 TIER PINK,1,22,1,200,178,0,2.0
3726,17409.0,PAPER BUNTING WHITE LACE,2,99,8,900,801,0,16.0
3727,17410.0,GINGERBREAD MAN COOKIE CUTTER,5,223,37,3800,3577,1,74.0
3728,17411.0,HOT WATER BOTTLE I AM SO POORLY,4,177,20,2100,1923,1,40.0
3729,17412.0,SET 7 BABUSHKA NESTING BOXES,7,179,31,3200,3021,1,62.0
3730,17414.0,BROCADE RING PURSE ,2,2,3,400,398,0,6.0
3731,17415.0,BREAD BIN DINER STYLE RED ,1,195,8,900,705,1,16.0
3732,17416.0,WRAP SUKI AND FRIENDS,9,635,113,11400,10765,1,226.0
3733,17418.0,HEART DECORATION RUSTIC HANGING ,2,88,16,1700,1612,0,15.2
3734,17419.0,BLUE HAPPY BIRTHDAY BUNTING,14,864,96,9700,8836,1,192.0
3735,17420.0,JAM MAKING SET PRINTED,3,116,14,1500,1384,0,14.499999999999996
3736,17422.0,S/4 GROOVY CAT MAGNETS,10,226,68,6900,6674,1,136.0
3737,17423.0,60 TEATIME FAIRY CAKE CASES,4,61,16,1700,1639,0,15.7
3738,17425.0,DOORMAT RED RETROSPOT,2,114,22,2300,2186,0,18.5
3739,17426.0,12 PENCIL SMALL TUBE WOODLAND,7,818,110,11100,10282,1,220.0
3740,17427.0,DOORMAT KEEP CALM AND COME IN,1,8,1,200,192,0,2.0
3741,17428.0,LUNCH BAG VINTAGE LEAF DESIGN,33,1249,137,13800,12551,1,274.0
3742,17429.0,BOOZE & WOMEN GREETING CARD ,4,88,20,2100,2012,0,16.999999999999996
3743,17430.0,12 PENCILS SMALL TUBE SKULL,2,27,8,900,873,0,16.0
3744,17431.0,JAM MAKING SET PRINTED,1,84,23,2400,2316,0,19.700000000000003
3745,17432.0,JAM MAKING SET PRINTED,2,121,24,2500,2379,0,24.600000000000005
3746,17433.0,STORAGE TIN VINTAGE DOILY ,1,129,28,2900,2771,0,24.699999999999996
3747,17434.0,12 PENCIL SMALL TUBE WOODLAND,9,392,67,6800,6408,1,134.0
3748,17436.0,COFFEE MUG CAT + BIRD DESIGN,2,21,6,700,679,0,12.0
3749,17438.0,RED RETROSPOT ROUND CAKE TINS,2,96,10,1100,1004,0,20.0
3750,17440.0,GOLD SCROLL GLASS T-LIGHT HOLDER,5,5,4,500,495,0,8.0
3751,17442.0,ALARM CLOCK BAKELIKE GREEN,10,370,71,7200,6830,1,142.0
3752,17443.0,RETRO COFFEE MUGS ASSORTED,1,1,0,100,99,0,0.0
3753,17444.0,LUNCH BAG  BLACK SKULL.,3,883,75,7600,6717,1,150.0
3754,17446.0,PACK OF 60 SPACEBOY CAKE CASES,2,6,5,600,594,0,10.0
3755,17447.0,JUMBO BAG VINTAGE DOILY ,2,60,20,2100,2040,0,16.299999999999997
3756,17448.0,Manual,1,4287,0,100,4187,0,0.0
3757,17449.0,ANT COPPER LIME BOUDICCA BRACELET,8,976,126,12700,11724,1,252.0
3758,17450.0,DOORMAT MERRY CHRISTMAS RED ,55,3320,140,14100,10780,1,280.0
3759,17451.0,LUNCH BAG VINTAGE LEAF DESIGN,10,256,58,5900,5644,1,116.0
3760,17453.0,DOORMAT KEEP CALM AND COME IN,2,65,7,800,735,0,10.100000000000001
3761,17454.0,PACK OF 6 SKULL PAPER CUPS,4,161,30,3100,2939,1,60.0
3762,17455.0,LUNCH BAG VINTAGE LEAF DESIGN,1,22,3,400,378,0,6.0
3763,17456.0,PIGGY BANK RETROSPOT ,1,25,8,900,875,0,16.0
3764,17457.0,SET OF 16 VINTAGE RED CUTLERY,5,61,9,1000,939,0,18.0
3765,17458.0,CARD HOLDER LOVE BIRD SMALL,1,131,30,3100,2969,0,24.0
3766,17459.0,LUNCH BAG  BLACK SKULL.,2,212,60,6100,5888,1,120.0
3767,17460.0,SET 20 NAPKINS FAIRY CAKES DESIGN ,8,165,20,2100,1935,1,40.0
3768,17461.0,LUNCH BAG VINTAGE LEAF DESIGN,3,266,52,5300,5034,1,104.0
3769,17462.0,RED RETROSPOT PEG BAG,3,109,15,1600,1491,0,13.700000000000001
3770,17463.0,LUNCH BAG  BLACK SKULL.,6,612,96,9700,9088,1,192.0
3771,17464.0,REX CASH+CARRY JUMBO SHOPPER,1,24,4,500,476,0,8.0
3772,17466.0,COLOURING PENCILS BROWN TUBE,2,192,24,2500,2308,1,48.0
3773,17468.0,VINTAGE BILLBOARD MUG ,2,5,4,500,495,0,8.0
3774,17469.0,LUNCH BAG VINTAGE LEAF DESIGN,6,278,46,4700,4422,1,92.0
3775,17470.0,LUNCH BAG  BLACK SKULL.,5,93,42,4300,4207,0,41.09999999999999
3776,17472.0,BLUE HAPPY BIRTHDAY BUNTING,3,372,84,8500,8128,1,168.0
3777,17475.0,FANCY FONTS BIRTHDAY WRAP,1,24,4,500,476,0,8.0
3778,17480.0,GINGERBREAD MAN COOKIE CUTTER,2,57,15,1600,1543,0,18.000000000000004
3779,17481.0,RED RETROSPOT PEG BAG,5,215,49,5000,4785,1,98.0
3780,17483.0,PACK OF 6 SWEETIE GIFT BOXES,3,68,11,1200,1132,0,13.200000000000001
3781,17486.0,"SWISS ROLL TOWEL, CHOCOLATE  SPOTS",1,69,14,1500,1431,0,12.299999999999997
3782,17489.0,TRADITIONAL MODELLING CLAY,2,31,15,1600,1569,0,14.600000000000001
3783,17490.0,VINTAGE RED ENAMEL TRIM PLATE,11,256,42,4300,4044,1,84.0
3784,17491.0,WOODEN CROQUET GARDEN SET,11,378,55,5600,5222,1,110.0
3785,17492.0,FELT FARM ANIMAL CHICKEN,1,42,6,700,658,0,12.0
3786,17495.0,GINGERBREAD MAN COOKIE CUTTER,2,99,14,1500,1401,0,14.099999999999998
3787,17496.0,HOT WATER BOTTLE I AM SO POORLY,1,51,4,500,449,0,8.0
3788,17498.0,PAINTED METAL HEART WITH HOLLY BELL,1,34,6,700,666,0,12.0
3789,17499.0,TRADITIONAL MODELLING CLAY,1,69,20,2100,2031,0,20.799999999999997
3790,17500.0,TUSCAN VILLA DOVECOTE BIRD FEEDER,3,271,2,300,29,1,4.0
3791,17501.0,SET 20 NAPKINS FAIRY CAKES DESIGN ,2,62,8,900,838,0,16.0
3792,17502.0,IVORY WICKER HEART SMALL,4,78,13,1400,1322,0,14.5
3793,17503.0,GINGERBREAD MAN COOKIE CUTTER,2,88,18,1900,1812,0,21.4
3794,17504.0,LANTERN CREAM GAZEBO ,10,486,67,6800,6314,1,134.0
3795,17505.0,HOT WATER BOTTLE I AM SO POORLY,2,153,27,2800,2647,1,54.0
3796,17506.0,REGENCY SUGAR TONGS,2,56,7,800,744,0,14.0
3797,17507.0,GARLAND WOODEN HAPPY EASTER,2,234,49,5000,4766,1,98.0
3798,17508.0,S/4 GROOVY CAT MAGNETS,1,35,12,1300,1265,0,10.3
3799,17509.0,SET OF 6 TEA TIME BAKING CASES,11,835,162,16300,15465,1,324.0
3800,17510.0,MAGIC DRAWING SLATE DINOSAUR,1,44,12,1300,1256,0,24.0
3801,17511.0,LUNCH BAG VINTAGE LEAF DESIGN,46,2607,258,25900,23293,1,516.0
3802,17512.0,HERB MARKER PARSLEY,11,210,53,5400,5190,1,106.0
3803,17513.0,PLAYING CARDS JUBILEE UNION JACK,1,16,2,300,284,0,4.0
3804,17514.0,WHITE HANGING HEART T-LIGHT HOLDER,1,89,22,2300,2211,0,24.8
3805,17515.0,I'M ON HOLIDAY METAL SIGN,4,325,39,4000,3675,1,78.0
3806,17516.0,LUNCH BAG  BLACK SKULL.,5,377,64,6500,6123,1,128.0
3807,17517.0,FELT FARM ANIMAL CHICKEN,1,27,5,600,573,0,10.0
3808,17519.0,PACK OF 6 COCKTAIL PARASOL STRAWS,7,257,44,4500,4243,1,88.0
3809,17520.0,WHITE SKULL HOT WATER BOTTLE ,1,98,17,1800,1702,0,13.899999999999999
3810,17521.0,12 PENCILS TALL TUBE WOODLAND,4,88,25,2600,2512,0,29.299999999999997
3811,17522.0,REX CASH+CARRY JUMBO SHOPPER,5,141,35,3600,3459,0,34.1
3812,17523.0,PARTY CONE CHRISTMAS DECORATION ,4,103,16,1700,1597,0,13.7
3813,17524.0,RETROSPOT SMALL TUBE MATCHES,1,9,3,400,391,0,6.0
3814,17525.0,HOT WATER BOTTLE I AM SO POORLY,1,54,4,500,446,0,8.0
3815,17526.0,SWEETHEART CAKESTAND 3 TIER,8,130,14,1500,1370,0,10.299999999999997
3816,17527.0,GINGERBREAD MAN COOKIE CUTTER,6,171,23,2400,2229,1,46.0
3817,17528.0,12 PENCIL SMALL TUBE WOODLAND,11,867,112,11300,10433,1,224.0
3818,17530.0,LUNCH BAG VINTAGE LEAF DESIGN,10,916,141,14200,13284,1,282.0
3819,17531.0,Manual,2,60,10,1100,1040,0,20.0
3820,17534.0,HOT WATER BOTTLE I AM SO POORLY,1,24,5,600,576,0,10.0
3821,17535.0,FELT EGG COSY CHICKEN,1,19,8,900,881,0,16.0
3822,17536.0,SET OF 16 VINTAGE SKY BLUE CUTLERY,1,38,1,200,162,0,2.0
3823,17537.0,ANT COPPER LIME BOUDICCA BRACELET,2,199,34,3500,3301,1,68.0
3824,17538.0,ROLL WRAP 50'S CHRISTMAS,1,10,5,600,590,0,10.0
3825,17540.0,HOT WATER BOTTLE I AM SO POORLY,3,96,12,1300,1204,0,12.999999999999998
3826,17542.0,SET 7 BABUSHKA NESTING BOXES,1,64,13,1400,1336,0,10.3
3827,17545.0,MIRRORED WALL ART LADIES,3,360,67,6800,6440,1,134.0
3828,17547.0,PINK OWL SOFT TOY,1,5,0,100,95,0,0.0
3829,17548.0,PACK OF 12 BLUE PAISLEY TISSUES ,3,33,10,1100,1067,0,20.0
3830,17549.0,GLITTER CHRISTMAS TREE WITH BELLS,2,10,2,300,290,0,4.0
3831,17550.0,EASTER TIN BUNNY BOUQUET,3,125,22,2300,2175,0,18.999999999999993
3832,17551.0,BLUE GINGHAM ROSE CUSHION COVER,1,109,21,2200,2091,0,23.799999999999997
3833,17552.0,GINGERBREAD MAN COOKIE CUTTER,6,116,28,2900,2784,0,26.500000000000007
3834,17553.0,SOMBRERO ,1,6,1,200,194,0,2.0
3835,17554.0,WOODEN CROQUET GARDEN SET,5,269,50,5100,4831,1,100.0
3836,17555.0,12 PENCIL SMALL TUBE WOODLAND,2,231,56,5700,5469,1,112.0
3837,17556.0,ROSES REGENCY TEACUP AND SAUCER ,1,28,2,300,272,0,4.0
3838,17557.0,TREASURE ISLAND BOOK BOX,3,91,18,1900,1809,0,19.599999999999998
3839,17560.0,SWEETHEART CAKESTAND 3 TIER,5,89,13,1400,1311,0,11.399999999999999
3840,17561.0,CARD HOLDER LOVE BIRD SMALL,1,96,25,2600,2504,0,24.699999999999996
3841,17562.0,LUNCH BAG  BLACK SKULL.,8,123,31,3200,3077,0,31.299999999999994
3842,17564.0,HOT WATER BOTTLE I AM SO POORLY,3,182,22,2300,2118,1,44.0
3843,17566.0,SNACK TRAY PAISLEY PARK,2,403,71,7200,6797,1,142.0
3844,17567.0,HEART OF WICKER SMALL,10,417,83,8400,7983,1,166.0
3845,17569.0,SPACEBOY LUNCH BOX ,1,97,17,1800,1703,0,14.3
3846,17571.0,SET 7 BABUSHKA NESTING BOXES,4,824,125,12600,11776,1,250.0
3847,17572.0,"SWISS ROLL TOWEL, CHOCOLATE  SPOTS",4,37,7,800,763,0,14.0
3848,17573.0,FRENCH PAISLEY CUSHION COVER ,4,58,12,1300,1242,0,13.799999999999999
3849,17574.0,RIBBON REEL HEARTS DESIGN ,1,26,6,700,674,0,12.0
3850,17576.0,RIBBON REEL SNOWY VILLAGE,22,1285,158,15900,14615,1,316.0
3851,17578.0,DAIRY MAID STRIPE MUG,2,6,3,400,394,0,6.0
3852,17579.0,REX CASH+CARRY JUMBO SHOPPER,4,132,28,2900,2768,0,26.799999999999994
3853,17580.0,FELT EGG COSY WHITE RABBIT ,3,97,27,2800,2703,0,21.599999999999998
3854,17581.0,LUNCH BAG  BLACK SKULL.,31,1600,160,16100,14500,1,320.0
3855,17582.0,ASSORTED COLOUR METAL CAT ,1,61,15,1600,1539,0,14.2
3856,17584.0,HEART OF WICKER SMALL,3,140,20,2100,1960,0,17.600000000000005
3857,17585.0,HEART OF WICKER SMALL,4,295,93,9400,9105,1,186.0
3858,17588.0,DOORMAT RED RETROSPOT,3,119,13,1400,1281,0,11.3
3859,17589.0,LUNCH BAG  BLACK SKULL.,4,550,108,10900,10350,1,216.0
3860,17590.0,DECORATIVE WICKER HEART LARGE,3,536,89,9000,8464,1,178.0
3861,17591.0,MIRROR CORNICE,8,597,75,7600,7003,1,150.0
3862,17593.0,RIBBON REEL POLKADOTS ,6,536,99,10000,9464,1,198.0
3863,17594.0,LUNCH BAG  BLACK SKULL.,2,97,24,2500,2403,0,27.9
3864,17595.0,REX CASH+CARRY JUMBO SHOPPER,2,207,43,4400,4193,1,86.0
3865,17596.0,12 PENCIL SMALL TUBE WOODLAND,7,517,119,12000,11483,1,238.0
3866,17597.0,LUNCH BAG VINTAGE LEAF DESIGN,1,186,25,2600,2414,1,50.0
3867,17600.0,HOT WATER BOTTLE I AM SO POORLY,1,45,6,700,655,0,12.0
3868,17601.0,FELTCRAFT BUTTERFLY HEARTS,1,14,4,500,486,0,8.0
3869,17602.0,HAND WARMER UNION JACK,8,1130,182,18300,17170,1,364.0
3870,17603.0,LA JARDIN BOTANIQUE CUSHION COVER,5,1156,8,900,256,1,16.0
3871,17604.0,HOT WATER BOTTLE I AM SO POORLY,2,159,33,3400,3241,1,66.0
3872,17608.0,REX CASH+CARRY JUMBO SHOPPER,2,68,28,2900,2832,0,30.099999999999998
3873,17609.0,LUNCH BAG  BLACK SKULL.,6,551,101,10200,9649,1,202.0
3874,17611.0,ASSORTED INCENSE PACK,19,1484,200,20100,18616,1,400.0
3875,17612.0,LUNCH BAG  BLACK SKULL.,10,390,64,6500,6110,1,128.0
3876,17613.0,LUNCH BAG  BLACK SKULL.,17,851,137,13800,12949,1,274.0
3877,17614.0,CHRISTMAS CRAFT WHITE FAIRY ,1,221,51,5200,4979,1,102.0
3878,17615.0,SLATE TILE NATURAL HANGING,3,54,6,700,646,0,12.0
3879,17616.0,WHITE HANGING HEART T-LIGHT HOLDER,3,7,1,200,193,0,2.0
3880,17618.0,GINGERBREAD MAN COOKIE CUTTER,3,334,37,3800,3466,1,74.0
3881,17619.0,REX CASH+CARRY JUMBO SHOPPER,1,138,42,4300,4162,0,38.599999999999994
3882,17620.0,JAM JAR WITH GREEN LID,1,11,1,200,189,0,2.0
3883,17621.0,DOORMAT RED RETROSPOT,4,92,14,1500,1408,0,13.100000000000003
3884,17623.0,CHRISTMAS GINGHAM STAR,1,94,16,1700,1606,0,17.200000000000003
3885,17624.0,WRAP BILLBOARD FONTS DESIGN,2,147,24,2500,2353,0,26.299999999999994
3886,17625.0,WHITE SKULL HOT WATER BOTTLE ,4,799,136,13700,12901,1,272.0
3887,17628.0,PACK OF 72 RETROSPOT CAKE CASES,1,12,2,300,288,0,4.0
3888,17629.0,PIG KEYRING WITH LIGHT & SOUND ,9,260,66,6700,6440,1,132.0
3889,17630.0,WOODEN CROQUET GARDEN SET,2,203,14,1500,1297,1,28.0
3890,17631.0,PLASTERS IN TIN CIRCUS PARADE ,3,144,20,2100,1956,0,21.299999999999994
3891,17633.0,JUMBO BAG VINTAGE DOILY ,6,206,39,4000,3794,1,78.0
3892,17634.0,MIRRORED WALL ART LADIES,9,1106,116,11700,10594,1,232.0
3893,17636.0,JUMBO BAG VINTAGE DOILY ,2,60,14,1500,1440,0,11.400000000000002
3894,17637.0,STRAWBERRY RAFFIA FOOD COVER,2,120,19,2000,1880,0,17.999999999999996
3895,17639.0,REX CASH+CARRY JUMBO SHOPPER,1,38,4,500,462,0,8.0
3896,17640.0,COLOUR GLASS. STAR T-LIGHT HOLDER,1,12,3,400,388,0,6.0
3897,17642.0,PINK VINTAGE SPOT BEAKER,2,93,21,2200,2107,0,22.699999999999996
3898,17643.0,DOVE DECORATION PAINTED ZINC ,1,32,4,500,468,0,8.0
3899,17644.0,LUNCH BAG VINTAGE LEAF DESIGN,17,472,81,8200,7728,1,162.0
3900,17646.0,BLUE GIANT GARDEN THERMOMETER,4,255,27,2800,2545,1,54.0
3901,17647.0,VINTAGE COFFEE GRINDER BOX,1,49,4,500,451,0,8.0
3902,17648.0,SET 7 BABUSHKA NESTING BOXES,5,511,46,4700,4189,1,92.0
3903,17649.0,DOORMAT RED RETROSPOT,2,192,33,3400,3208,1,66.0
3904,17650.0,PACK OF 72 RETROSPOT CAKE CASES,1,15,4,500,485,0,8.0
3905,17651.0,LUNCH BAG  BLACK SKULL.,14,501,97,9800,9299,1,194.0
3906,17652.0,LUNCH BAG  BLACK SKULL.,18,927,108,10900,9973,1,216.0
3907,17653.0,DECORATIVE WICKER HEART LARGE,5,207,25,2600,2393,1,50.0
3908,17654.0,POTTING SHED TWINE,1,69,11,1200,1131,0,22.0
3909,17655.0,DECORATIVE WICKER HEART LARGE,8,440,43,4400,3960,1,86.0
3910,17656.0,TOXIC AREA  DOOR HANGER ,5,227,43,4400,4173,1,86.0
3911,17658.0,PACK OF 6 HANDBAG GIFT BOXES,3,54,14,1500,1446,0,11.500000000000002
3912,17659.0,LUNCH BAG  BLACK SKULL.,14,651,73,7400,6749,1,146.0
3913,17660.0,S/12 VANILLA  BOTANICAL T-LIGHTS,1,90,23,2400,2310,0,23.7
3914,17663.0,SWEETHEART CAKESTAND 3 TIER,9,358,50,5100,4742,1,100.0
3915,17664.0,WRAP SUKI AND FRIENDS,2,82,24,2500,2418,0,23.2
3916,17666.0,DECORATIVE WICKER HEART LARGE,2,34,11,1200,1166,0,22.0
3917,17667.0,IVORY SWEETHEART WIRE LETTER RACK ,5,425,54,5500,5075,1,108.0
3918,17668.0,3 TIER CAKE TIN RED AND CREAM,2,110,9,1000,890,0,18.0
3919,17669.0,LUNCH BAG  BLACK SKULL.,7,126,33,3400,3274,0,32.00000000000001
3920,17670.0,PACK OF 6 SANDCASTLE FLAGS ASSORTED,1,28,6,700,672,0,12.0
3921,17671.0,BLUE GIANT GARDEN THERMOMETER,6,210,32,3300,3090,1,64.0
3922,17672.0,WRAP SUKI AND FRIENDS,4,393,61,6200,5807,1,122.0
3923,17673.0,TOXIC AREA  DOOR HANGER ,7,367,108,10900,10533,1,216.0
3924,17674.0,TREASURE ISLAND BOOK BOX,2,20,15,1600,1580,0,16.000000000000004
3925,17675.0,LUNCH BAG  BLACK SKULL.,41,2576,224,22500,19924,1,448.0
3926,17676.0,LUNCH BAG  BLACK SKULL.,7,152,45,4600,4448,1,90.0
3927,17677.0,LUNCH BAG  BLACK SKULL.,43,892,128,12900,12008,1,256.0
3928,17678.0,PARTY METAL SIGN ,1,35,9,1000,965,0,18.0
3929,17679.0,JAM MAKING SET PRINTED,2,159,16,1700,1541,1,32.0
3930,17680.0,SWALLOW WOODEN CHRISTMAS DECORATION,1,30,4,500,470,0,8.0
3931,17682.0,LUNCH BAG  BLACK SKULL.,7,290,57,5800,5510,1,114.0
3932,17684.0,DECORATIVE WICKER HEART LARGE,1,43,8,900,857,0,16.0
3933,17685.0,12 PENCIL SMALL TUBE WOODLAND,7,260,67,6800,6540,1,134.0
3934,17686.0,LUNCH BAG  BLACK SKULL.,7,1103,122,12300,11197,1,244.0
3935,17690.0,CANDLE PLATE LACE WHITE,16,1464,118,11900,10436,1,236.0
3936,17691.0,JAM MAKING SET PRINTED,2,64,11,1200,1136,0,22.0
3937,17692.0,BLACK PIRATE TREASURE CHEST,5,77,22,2300,2223,0,27.600000000000005
3938,17693.0,RETROSPOT TEA SET CERAMIC 11 PC ,3,46,11,1200,1154,0,22.0
3939,17694.0,PACK OF 12 HEARTS DESIGN TISSUES ,1,39,9,1000,961,0,18.0
3940,17695.0,12 PENCILS TALL TUBE WOODLAND,2,43,17,1800,1757,0,15.499999999999996
3941,17696.0,WRAP SUKI AND FRIENDS,14,319,68,6900,6581,1,136.0
3942,17697.0,PLASTERS IN TIN CIRCUS PARADE ,1,96,9,1000,904,0,12.0
3943,17698.0,JAM MAKING SET PRINTED,1,17,2,300,283,0,4.0
3944,17700.0,RIBBON REEL POLKADOTS ,6,467,70,7100,6633,1,140.0
3945,17701.0,LUNCH BAG  BLACK SKULL.,1,138,13,1400,1262,0,15.399999999999999
3946,17702.0,12 PENCIL SMALL TUBE WOODLAND,6,149,43,4400,4251,0,37.699999999999996
3947,17703.0,PINK VINTAGE SPOT BEAKER,3,90,28,2900,2810,0,24.4
3948,17704.0,WOODEN UNION JACK BUNTING,2,121,16,1700,1579,0,15.299999999999999
3949,17705.0,LUNCH BAG  BLACK SKULL.,10,342,52,5300,4958,1,104.0
3950,17706.0,LUNCH BAG VINTAGE LEAF DESIGN,22,1714,135,13600,11886,1,270.0
3951,17707.0,ROSES REGENCY TEACUP AND SAUCER ,2,8,2,300,292,0,4.0
3952,17708.0,GREEN POLKADOT BOWL,2,110,18,1900,1790,0,17.6
3953,17709.0,CREAM WALL PLANTER HEART SHAPED,1,91,5,600,509,0,10.0
3954,17711.0,CHRYSANTHEMUM NOTEBOOK,2,56,11,1200,1144,0,10.999999999999998
3955,17712.0,GIFT BAG PSYCHEDELIC APPLES,1,135,19,2000,1865,0,15.9
3956,17714.0,MOUSE TOY WITH PINK T-SHIRT,1,20,5,600,580,0,10.0
3957,17715.0,LARGE CIRCULAR MIRROR MOBILE,1,0,0,100,100,0,0.0
3958,17716.0,LUNCH BAG  BLACK SKULL.,12,643,104,10500,9857,1,208.0
3959,17718.0,SET 20 NAPKINS FAIRY CAKES DESIGN ,1,25,4,500,475,0,8.0
3960,17719.0,ALARM CLOCK BAKELIKE GREEN,18,1240,113,11400,10160,1,226.0
3961,17720.0,PAPER BUNTING WHITE LACE,4,271,28,2900,2629,1,56.0
3962,17722.0,SET OF 16 VINTAGE SKY BLUE CUTLERY,6,392,61,6200,5808,1,122.0
3963,17723.0,PARTY BUNTING,6,40,5,600,560,0,10.0
3964,17724.0,DRAWER KNOB CRACKLE GLAZE BLUE,4,189,27,2800,2611,1,54.0
3965,17725.0,IVORY SWEETHEART WIRE LETTER RACK ,14,527,96,9700,9173,1,192.0
3966,17727.0,JUMBO BAG VINTAGE DOILY ,2,209,37,3800,3591,1,74.0
3967,17728.0,LUNCH BAG  BLACK SKULL.,5,907,87,8800,7893,1,174.0
3968,17730.0,HEART STRING MEMO HOLDER HANGING,15,435,97,9800,9365,1,194.0
3969,17731.0,PINK PARTY BAGS,5,454,43,4400,3946,1,86.0
3970,17732.0,IVORY KITCHEN SCALES,1,89,9,1000,911,0,18.0
3971,17733.0,WOODEN TREE CHRISTMAS SCANDINAVIAN,2,103,18,1900,1797,0,13.100000000000001
3972,17734.0,BATH BUILDING BLOCK WORD,3,124,22,2300,2176,0,19.000000000000004
3973,17735.0,LUNCH BAG VINTAGE LEAF DESIGN,19,1512,204,20500,18988,1,408.0
3974,17736.0,MORE BUTTER METAL SIGN ,4,170,15,1600,1430,1,30.0
3975,17737.0,HEART WREATH DECORATION WITH BELL,2,24,5,600,576,0,10.0
3976,17738.0,BLUE HAPPY BIRTHDAY BUNTING,5,361,46,4700,4339,1,92.0
3977,17739.0,HOT WATER BOTTLE I AM SO POORLY,8,215,23,2400,2185,1,46.0
3978,17742.0,BIRDHOUSE GARDEN MARKER ,2,133,7,800,667,0,14.0
3979,17744.0,TOXIC AREA  DOOR HANGER ,7,122,65,6600,6478,0,61.400000000000006
3980,17746.0,SWEETHEART CAKESTAND 3 TIER,2,42,4,500,458,0,8.0
3981,17747.0,MIRROR MOSAIC HURRICANE LAMP ,2,12,0,100,88,0,0.0
3982,17749.0,RECYCLED ACAPULCO MAT GREEN,2,160,19,2000,1840,1,38.0
3983,17750.0,TOXIC AREA  DOOR HANGER ,9,127,79,8000,7873,0,97.2
3984,17752.0,RATTLE SNAKE EGGS,1,0,0,100,100,0,0.0
3985,17754.0,RIBBON REEL POLKADOTS ,6,91,48,4900,4809,0,48.8
3986,17757.0,DECORATIVE WICKER HEART LARGE,31,2041,220,22100,20059,1,440.0
3987,17758.0,LUNCH BAG VINTAGE LEAF DESIGN,8,978,157,15800,14822,1,314.0
3988,17759.0,DECORATIVE WICKER HEART SMALL,3,215,43,4400,4185,1,86.0
3989,17760.0,TREASURE ISLAND BOOK BOX,2,56,13,1400,1344,0,11.999999999999998
3990,17761.0,HEART OF WICKER SMALL,1,59,12,1300,1241,0,10.399999999999999
3991,17763.0,LARGE CIRCULAR MIRROR MOBILE,1,1,0,100,99,0,0.0
3992,17764.0,HOT WATER BOTTLE I AM SO POORLY,2,236,36,3700,3464,1,72.0
3993,17765.0,LUNCH BAG  BLACK SKULL.,3,221,27,2800,2579,1,54.0
3994,17767.0,GLITTER HANGING BUTTERFLY STRING,1,58,12,1300,1242,0,10.3
3995,17768.0,WHITE SKULL HOT WATER BOTTLE ,3,403,51,5200,4797,1,102.0
3996,17769.0,LUNCH BAG  BLACK SKULL.,12,977,128,12900,11923,1,256.0
3997,17770.0,REX CASH+CARRY JUMBO SHOPPER,5,183,17,1800,1617,1,34.0
3998,17771.0,PLASTERS IN TIN CIRCUS PARADE ,2,121,28,2900,2779,0,29.699999999999996
3999,17772.0,REX CASH+CARRY JUMBO SHOPPER,2,176,29,3000,2824,1,58.0
4000,17774.0,SET 7 BABUSHKA NESTING BOXES,5,531,73,7400,6869,1,146.0
4001,17775.0,LOVEBIRD HANGING DECORATION WHITE ,1,2,0,100,98,0,0.0
4002,17777.0,IVORY SWEETHEART WIRE LETTER RACK ,3,319,93,9400,9081,1,186.0
4003,17779.0,REX CASH+CARRY JUMBO SHOPPER,5,244,44,4500,4256,1,88.0
4004,17781.0,SET 12 KIDS COLOUR  CHALK STICKS,2,66,5,600,534,0,10.0
4005,17783.0,MIRRORED WALL ART LADIES,2,128,40,4100,3972,0,36.60000000000001
4006,17785.0,HEART OF WICKER LARGE,1,33,9,1000,967,0,18.0
4007,17786.0,ASS COL SMALL SAND GECKO P'WEIGHT,2,152,36,3700,3548,1,72.0
4008,17787.0,TOXIC AREA  DOOR HANGER ,4,381,69,7000,6619,1,138.0
4009,17788.0,POSTAGE,2,27,1,200,173,0,2.0
4010,17789.0,GLASS CHALICE GREEN  LARGE ,1,55,7,800,745,0,14.0
4011,17790.0,DECORATIVE WICKER HEART LARGE,14,594,83,8400,7806,1,166.0
4012,17791.0,36 PENCILS TUBE RED RETROSPOT,1,27,4,500,473,0,8.0
4013,17793.0,REX CASH+CARRY JUMBO SHOPPER,1,218,32,3300,3082,1,64.0
4014,17795.0,12 PENCIL SMALL TUBE WOODLAND,2,88,23,2400,2312,0,22.5
4015,17796.0,REX CASH+CARRY JUMBO SHOPPER,4,329,39,4000,3671,1,78.0
4016,17797.0,LUNCH BAG VINTAGE LEAF DESIGN,3,283,50,5100,4817,1,100.0
4017,17799.0,LUNCH BAG  BLACK SKULL.,11,1053,156,15700,14647,1,312.0
4018,17800.0,LUNCH BAG  BLACK SKULL.,9,228,51,5200,4972,1,102.0
4019,17802.0,BLUE HAPPY BIRTHDAY BUNTING,4,342,69,7000,6658,1,138.0
4020,17805.0,REGENCY SUGAR TONGS,1,22,4,500,478,0,8.0
4021,17806.0,DOUGHNUT LIP GLOSS ,1,43,20,2100,2057,0,24.500000000000004
4022,17809.0,REX CASH+CARRY JUMBO SHOPPER,15,897,33,3400,2503,1,66.0
4023,17811.0,SET OF 4 POLKADOT PLACEMATS ,51,2390,230,23100,20710,1,460.0
4024,17812.0,DECORATIVE WICKER HEART LARGE,4,427,70,7100,6673,1,140.0
4025,17813.0,CANDLE PLATE LACE WHITE,7,1295,155,15600,14305,1,310.0
4026,17816.0,REX CASH+CARRY JUMBO SHOPPER,4,23,9,1000,977,0,18.0
4027,17817.0,BLUE  TILE HOOK,3,301,16,1700,1399,1,32.0
4028,17819.0,WOODEN CROQUET GARDEN SET,8,224,25,2600,2376,1,50.0
4029,17820.0,ROSES REGENCY TEACUP AND SAUCER ,2,24,3,400,376,0,6.0
4030,17824.0,WOODEN BOX OF DOMINOES,1,13,6,700,687,0,12.0
4031,17827.0,CHRISTMAS TOILET ROLL,5,523,91,9200,8677,1,182.0
4032,17828.0,LANTERN CREAM GAZEBO ,9,474,39,4000,3526,1,78.0
4033,17829.0,GARDEN METAL SIGN ,1,77,14,1500,1423,0,17.200000000000006
4034,17830.0,DOORMAT SPOTTY HOME SWEET HOME,3,138,11,1200,1062,0,11.099999999999998
4035,17831.0,GREEN REGENCY TEACUP AND SAUCER,1,5,1,200,195,0,2.0
4036,17832.0,REX CASH+CARRY JUMBO SHOPPER,1,67,33,3400,3333,0,33.8
4037,17835.0,12 PENCIL SMALL TUBE WOODLAND,3,103,31,3200,3097,0,33.0
4038,17836.0,ENVELOPE 50 BLOSSOM IMAGES,1,32,12,1300,1268,0,24.0
4039,17837.0,HAND WARMER UNION JACK,10,686,85,8600,7914,1,170.0
4040,17838.0,60 TEATIME FAIRY CAKE CASES,6,484,71,7200,6716,1,142.0
4041,17839.0,BUNDLE OF 3 SCHOOL EXERCISE BOOKS  ,1,98,30,3100,3002,0,27.099999999999994
4042,17841.0,LUNCH BAG VINTAGE LEAF DESIGN,169,20333,280,28100,7767,1,560.0
4043,17843.0,12 PENCILS TALL TUBE WOODLAND,1,118,20,2100,1982,0,16.6
4044,17844.0,SET OF 6 TEA TIME BAKING CASES,1,4,2,300,296,0,4.0
4045,17846.0,Manual,1,2033,0,100,1933,0,0.0
4046,17848.0,RECIPE BOX PANTRY YELLOW DESIGN,9,215,27,2800,2585,1,54.0
4047,17849.0,REX CASH+CARRY JUMBO SHOPPER,4,268,15,1600,1332,1,30.0
4048,17850.0,SET 7 BABUSHKA NESTING BOXES,35,1224,127,12800,11576,1,254.0
4049,17852.0,GREEN DRAWER KNOB ACRYLIC EDWARDIAN,2,56,13,1400,1344,0,10.900000000000002
4050,17854.0,HEART IVORY TRELLIS LARGE,2,53,7,800,747,0,14.0
4051,17855.0,SET 12 KIDS COLOUR  CHALK STICKS,1,30,8,900,870,0,16.0
4052,17856.0,LARGE HANGING IVORY & RED WOOD BIRD,6,56,9,1000,944,0,18.0
4053,17857.0,TREASURE ISLAND BOOK BOX,25,559,31,3200,2641,1,62.0
4054,17858.0,MIRROR CORNICE,12,1171,89,9000,7829,1,178.0
4055,17859.0,REX CASH+CARRY JUMBO SHOPPER,1,45,16,1700,1655,0,15.300000000000002
4056,17860.0,HOT WATER BOTTLE I AM SO POORLY,1,148,33,3400,3252,0,27.6
4057,17861.0,LUNCH BAG  BLACK SKULL.,9,539,104,10500,9961,1,208.0
4058,17862.0,BLUE 3 PIECE POLKADOT CUTLERY SET,1,56,5,600,544,0,10.0
4059,17863.0,RIBBON REEL SNOWY VILLAGE,6,228,76,7700,7472,1,152.0
4060,17864.0,REX CASH+CARRY JUMBO SHOPPER,3,184,52,5300,5116,1,104.0
4061,17865.0,TOXIC AREA  DOOR HANGER ,27,1121,157,15800,14679,1,314.0
4062,17866.0,GLITTER HANGING BUTTERFLY STRING,2,34,5,600,566,0,10.0
4063,17867.0,WOODEN CROQUET GARDEN SET,8,202,40,4100,3898,1,80.0
4064,17869.0,DAIRY MAID STRIPE MUG,5,246,18,1900,1654,1,36.0
4065,17870.0,SET OF 4 POLKADOT PLACEMATS ,13,622,118,11900,11278,1,236.0
4066,17871.0,CHILDRENS CUTLERY DOLLY GIRL ,1,21,6,700,679,0,12.0
4067,17873.0,"FEATHER PEN,LIGHT PINK",6,210,25,2600,2390,1,50.0
4068,17874.0,WOODEN UNION JACK BUNTING,7,189,24,2500,2311,1,48.0
4069,17877.0,RED RETROSPOT OVEN GLOVE DOUBLE,1,42,5,600,558,0,10.0
4070,17878.0,SMALL HANGING IVORY/RED WOOD BIRD,1,58,14,1500,1442,0,10.6
4071,17879.0,SMOKEY GREY COLOUR D.O.F. GLASS,1,21,4,500,479,0,8.0
4072,17880.0,MAGIC DRAWING SLATE PURDEY,1,64,12,1300,1236,0,13.3
4073,17881.0,4 PINK DINNER CANDLE SILVER FLOCK,1,36,4,500,464,0,8.0
4074,17883.0,PIG KEYRING WITH LIGHT & SOUND ,4,333,65,6600,6267,1,130.0
4075,17884.0,LUNCH BAG  BLACK SKULL.,4,224,59,6000,5776,1,118.0
4076,17885.0,PLASTERS IN TIN CIRCUS PARADE ,1,141,33,3400,3259,0,29.6
4077,17886.0,12 PENCILS SMALL TUBE RED RETROSPOT,3,325,54,5500,5175,1,108.0
4078,17887.0,CHRISTMAS STAR WISH LIST CHALKBOARD,1,52,6,700,648,0,12.0
4079,17888.0,REX CASH+CARRY JUMBO SHOPPER,10,217,39,4000,3783,1,78.0
4080,17889.0,REX CASH+CARRY JUMBO SHOPPER,2,72,11,1200,1128,0,22.0
4081,17890.0,CANDLE PLATE LACE WHITE,2,232,45,4600,4368,1,90.0
4082,17891.0,BANQUET BIRTHDAY  CARD  ,1,24,17,1800,1776,0,20.6
4083,17892.0,ENVELOPE 50 BLOSSOM IMAGES,3,91,12,1300,1209,0,14.7
4084,17893.0,WRAP I LOVE LONDON ,1,33,6,700,667,0,12.0
4085,17894.0,RIBBON REEL POLKADOTS ,8,539,89,9000,8461,1,178.0
4086,17895.0,CARD CHRISTMAS VILLAGE,1,29,6,700,671,0,12.0
4087,17896.0,ANTIQUE SILVER TEA GLASS ENGRAVED,1,1,0,100,99,0,0.0
4088,17897.0,LUNCH BAG VINTAGE LEAF DESIGN,4,355,53,5400,5045,1,106.0
4089,17898.0,SMALL TALL CAMPHOR WOOD TOADSTOOL,2,41,17,1800,1759,0,15.100000000000003
4090,17899.0,REX CASH+CARRY JUMBO SHOPPER,1,76,13,1400,1324,0,17.599999999999994
4091,17900.0,Next Day Carriage,4,28,5,600,572,0,10.0
4092,17901.0,REX CASH+CARRY JUMBO SHOPPER,1,101,11,1200,1099,0,22.0
4093,17904.0,REX CASH+CARRY JUMBO SHOPPER,2,150,19,2000,1850,1,38.0
4094,17905.0,WELCOME  WOODEN BLOCK LETTERS,4,128,20,2100,1972,0,17.0
4095,17906.0,REX CASH+CARRY JUMBO SHOPPER,1,45,6,700,655,0,12.0
4096,17908.0,WHITE SKULL HOT WATER BOTTLE ,1,155,34,3500,3345,1,68.0
4097,17911.0,DOORMAT RED RETROSPOT,1,85,21,2200,2115,0,18.699999999999996
4098,17912.0,REX CASH+CARRY JUMBO SHOPPER,6,166,21,2200,2034,1,42.0
4099,17913.0,RED TEA TOWEL CLASSIC DESIGN,2,143,29,3000,2857,0,29.799999999999997
4100,17914.0,PLASTERS IN TIN CIRCUS PARADE ,1,157,41,4200,4043,1,82.0
4101,17917.0,LUNCH BAG  BLACK SKULL.,3,209,49,5000,4791,1,98.0
4102,17919.0,PACK OF 12 LONDON TISSUES ,1,49,12,1300,1251,0,10.299999999999999
4103,17920.0,LUNCH BAG VINTAGE LEAF DESIGN,17,1623,208,20900,19277,1,416.0
4104,17921.0,LUNCH BAG  BLACK SKULL.,4,340,68,6900,6560,1,136.0
4105,17923.0,PARTY BUNTING,1,4,0,100,96,0,0.0
4106,17924.0,WHITE SKULL HOT WATER BOTTLE ,13,131,23,2400,2269,0,19.799999999999997
4107,17925.0,BLACK RECORD COVER FRAME,1,3,0,100,97,0,0.0
4108,17926.0,PICNIC BASKET WICKER LARGE,2,66,11,1200,1134,0,22.0
4109,17928.0,CARD CIRCUS PARADE,2,68,13,1400,1332,0,12.400000000000002
4110,17929.0,BOX OF VINTAGE ALPHABET BLOCKS,5,46,2,300,254,0,4.0
4111,17930.0,PACK OF 6 COCKTAIL PARASOL STRAWS,5,57,21,2200,2143,0,19.099999999999994
4112,17931.0,SWEETHEART CAKESTAND 3 TIER,2,199,29,3000,2801,1,58.0
4113,17932.0,WATERING CAN GREEN DINOSAUR,3,246,48,4900,4654,1,96.0
4114,17934.0,CLASSIC GLASS COOKIE JAR,2,72,10,1100,1028,0,10.9
4115,17935.0,SET 7 BABUSHKA NESTING BOXES,2,54,15,1600,1546,0,11.2
4116,17936.0,PLASTERS IN TIN CIRCUS PARADE ,1,183,39,4000,3817,1,78.0
4117,17937.0,HOLIDAY FUN LUDO,7,149,25,2600,2451,0,18.499999999999993
4118,17939.0,REX CASH+CARRY JUMBO SHOPPER,1,29,7,800,771,0,14.0
4119,17940.0,PACK OF 12 HEARTS DESIGN TISSUES ,14,3994,11,1200,2794,1,22.0
4120,17941.0,SCANDINAVIAN REDS RIBBONS,1,2,0,100,98,0,0.0
4121,17942.0,REX CASH+CARRY JUMBO SHOPPER,1,3,1,200,197,0,2.0
4122,17946.0,REX CASH+CARRY JUMBO SHOPPER,2,62,11,1200,1138,0,22.0
4123,17947.0,CARD PARTY GAMES ,1,8,5,600,592,0,10.0
4124,17948.0,BISCUIT TIN 50'S CHRISTMAS,1,2,0,100,98,0,0.0
4125,17949.0,CHRISTMAS TOILET ROLL,52,727,43,4400,3673,1,86.0
4126,17950.0,SILK PURSE BABUSHKA RED,4,165,40,4100,3935,1,80.0
4127,17951.0,CHRISTMAS METAL TAGS ASSORTED ,4,47,12,1300,1253,0,10.3
4128,17954.0,LUNCH BAG VINTAGE LEAF DESIGN,16,969,160,16100,15131,1,320.0
4129,17955.0,SET 12 KIDS COLOUR  CHALK STICKS,4,106,10,1100,994,0,20.0
4130,17956.0,SET OF 2 WOODEN MARKET CRATES,1,12,0,100,88,0,0.0
4131,17957.0,WRAP I LOVE LONDON ,1,41,18,1900,1859,0,16.5
4132,17958.0,OCEAN SCENT CANDLE IN JEWELLED BOX,1,28,3,400,372,0,6.0
4133,17960.0,MAGIC DRAWING SLATE PURDEY,1,44,15,1600,1556,0,10.600000000000001
4134,17961.0,LUNCH BAG  BLACK SKULL.,39,814,107,10800,9986,1,214.0
4135,17962.0,SET 6 PAPER TABLE LANTERN STARS ,1,57,19,2000,1943,0,21.1
4136,17964.0,FLOWER VINE RAFFIA FOOD COVER,2,278,47,4800,4522,1,94.0
4137,17965.0,SET/6 PINK  BUTTERFLY T-LIGHTS,14,1147,140,14100,12953,1,280.0
4138,17966.0,WRAP BILLBOARD FONTS DESIGN,5,101,37,3800,3699,0,38.9
4139,17967.0,LUNCH BAG  BLACK SKULL.,1,90,26,2700,2610,0,23.9
4140,17968.0,PURPLE SWEETHEART BRACELET,1,163,48,4900,4737,1,96.0
4141,17969.0,REX CASH+CARRY JUMBO SHOPPER,2,65,7,800,735,0,14.0
4142,17970.0,DECORATIVE PLANT POT WITH FRIEZE,1,91,16,1700,1609,0,15.1
4143,17972.0,FOLDING UMBRELLA PINKWHITE POLKADOT,1,131,18,1900,1769,0,13.7
4144,17973.0,PAPER LANTERN 9 POINT SNOW STAR,1,48,8,900,852,0,16.0
4145,17974.0,HAND WARMER UNION JACK,3,362,81,8200,7838,1,162.0
4146,17975.0,DECORATIVE WICKER HEART LARGE,14,943,119,12000,11057,1,238.0
4147,17976.0,REX CASH+CARRY JUMBO SHOPPER,1,229,31,3200,2971,1,62.0
4148,17977.0,HANGING JAM JAR T-LIGHT HOLDERS,1,68,9,1000,932,0,12.0
4149,17978.0,SET OF 20 VINTAGE CHRISTMAS NAPKINS,1,28,6,700,672,0,12.0
4150,17979.0,LUNCH BAG  BLACK SKULL.,5,351,67,6800,6449,1,134.0
4151,17980.0,REX CASH+CARRY JUMBO SHOPPER,3,66,16,1700,1634,0,14.9
4152,17984.0,SET OF 6 TEA TIME BAKING CASES,1,99,28,2900,2801,0,28.89999999999999
4153,17985.0,ANT COPPER LIME BOUDICCA BRACELET,1,102,14,1500,1398,0,11.299999999999999
4154,17986.0,JUMBO BAG SCANDINAVIAN BLUE PAISLEY,1,2,0,100,98,0,0.0
4155,17987.0,PAPER POCKET TRAVELING FAN ,1,11,6,700,689,0,12.0
4156,17988.0,REX CASH+CARRY JUMBO SHOPPER,8,203,17,1800,1597,1,34.0
4157,17990.0,HOT WATER BOTTLE I AM SO POORLY,3,67,17,1800,1733,0,13.8
4158,17991.0,PAPER CHAIN KIT EMPIRE,2,24,2,300,276,0,4.0
4159,17994.0,REX CASH+CARRY JUMBO SHOPPER,6,203,46,4700,4497,1,92.0
4160,17995.0,RED PAPER PARASOL,1,3,0,100,97,0,0.0
4161,17997.0,MIRRORED WALL ART LADIES,12,287,78,7900,7613,1,156.0
4162,17999.0,LUNCH BAG  BLACK SKULL.,2,262,41,4200,3938,1,82.0
4163,18001.0,REX CASH+CARRY JUMBO SHOPPER,2,164,30,3100,2936,1,60.0
4164,18004.0,BLUE GIANT GARDEN THERMOMETER,1,110,19,2000,1890,0,22.699999999999992
4165,18005.0,REX CASH+CARRY JUMBO SHOPPER,2,191,28,2900,2709,1,56.0
4166,18006.0,HAND WARMER UNION JACK,1,71,12,1300,1229,0,11.399999999999999
4167,18008.0,REX CASH+CARRY JUMBO SHOPPER,9,114,15,1600,1486,0,17.6
4168,18009.0,LUNCH BAG VINTAGE LEAF DESIGN,2,134,18,1900,1766,0,15.399999999999999
4169,18010.0,REX CASH+CARRY JUMBO SHOPPER,1,70,5,600,530,0,10.0
4170,18011.0,SET/4 BADGES CUTE CREATURES,1,66,14,1500,1434,0,13.3
4171,18013.0,REX CASH+CARRY JUMBO SHOPPER,2,36,17,1800,1764,0,17.0
4172,18014.0,GINGERBREAD MAN COOKIE CUTTER,1,93,17,1800,1707,0,15.299999999999995
4173,18015.0,REX CASH+CARRY JUMBO SHOPPER,1,58,23,2400,2342,0,24.299999999999997
4174,18016.0,LUNCH BAG  BLACK SKULL.,5,412,57,5800,5388,1,114.0
4175,18017.0,JUMBO BAG RED RETROSPOT,3,5,2,300,295,0,4.0
4176,18018.0,IVORY SWEETHEART WIRE LETTER RACK ,2,110,15,1600,1490,0,12.399999999999995
4177,18019.0,ALARM CLOCK BAKELIKE GREEN,1,28,2,300,272,0,4.0
4178,18022.0,12 PENCIL SMALL TUBE WOODLAND,1,335,89,9000,8665,1,178.0
4179,18024.0,WELCOME  WOODEN BLOCK LETTERS,3,58,13,1400,1342,0,13.2
4180,18027.0,HOT WATER BOTTLE I AM SO POORLY,1,58,10,1100,1042,0,20.0
4181,18030.0,BOX OF VINTAGE JIGSAW BLOCKS ,3,70,4,500,430,0,8.0
4182,18032.0,PINK PARTY BAGS,1,9,2,300,291,0,4.0
4183,18033.0,12 PENCIL SMALL TUBE WOODLAND,1,63,17,1800,1737,0,17.7
4184,18034.0,12 PENCIL SMALL TUBE WOODLAND,2,149,55,5600,5451,0,52.69999999999999
4185,18035.0,BISCUIT TIN 50'S CHRISTMAS,3,130,28,2900,2770,0,27.099999999999994
4186,18036.0,12 PENCIL SMALL TUBE WOODLAND,3,181,47,4800,4619,1,94.0
4187,18037.0,BLUE POLKADOT GARDEN PARASOL,6,68,9,1000,932,0,10.1
4188,18040.0,WOODLAND CHARLOTTE BAG,2,58,8,900,842,0,16.0
4189,18041.0,LUNCH BAG  BLACK SKULL.,22,934,170,17100,16166,1,340.0
4190,18042.0,HOT WATER BOTTLE I AM SO POORLY,1,38,5,600,562,0,10.0
4191,18043.0,RIBBON REEL POLKADOTS ,3,352,60,6100,5748,1,120.0
4192,18044.0,HAND WARMER UNION JACK,11,542,57,5800,5258,1,114.0
4193,18045.0,LUNCH BAG  BLACK SKULL.,1,122,22,2300,2178,0,24.29999999999999
4194,18048.0,REX CASH+CARRY JUMBO SHOPPER,2,10,3,400,390,0,6.0
4195,18050.0,FAIRY CAKE DESIGN UMBRELLA,1,11,1,200,189,0,2.0
4196,18053.0,DECORATIVE WICKER HEART LARGE,2,34,11,1200,1166,0,22.0
4197,18055.0,BLUE HAPPY BIRTHDAY BUNTING,11,1467,143,14400,12933,1,286.0
4198,18056.0,EASTER TIN BUNNY BOUQUET,1,71,11,1200,1129,0,22.0
4199,18058.0,CINNAMON SCENTED VOTIVE CANDLE,1,5,1,200,195,0,2.0
4200,18059.0,4 LILY  BOTANICAL DINNER CANDLES,4,39,11,1200,1161,0,10.700000000000001
4201,18061.0,"FANCY FONT BIRTHDAY CARD, ",10,230,20,2100,1870,1,40.0
4202,18062.0,WOODEN CROQUET GARDEN SET,3,121,17,1800,1679,0,17.1
4203,18064.0,LUNCH BAG VINTAGE LEAF DESIGN,2,15,4,500,485,0,8.0
4204,18065.0,WHITE SKULL HOT WATER BOTTLE ,15,573,66,6700,6127,1,132.0
4205,18066.0,ALARM CLOCK BAKELIKE GREEN,1,34,5,600,566,0,10.0
4206,18067.0,REX CASH+CARRY JUMBO SHOPPER,1,104,16,1700,1596,0,14.8
4207,18068.0,FAUX FUR CHOCOLATE THROW,1,16,0,100,84,0,0.0
4208,18069.0,SET 7 BABUSHKA NESTING BOXES,7,1044,173,17400,16356,1,346.0
4209,18071.0,RIDGED GLASS POSY VASE ,2,74,15,1600,1526,0,12.200000000000003
4210,18072.0,HEART DECORATION RUSTIC HANGING ,2,43,19,2000,1957,0,17.4
4211,18073.0,RECYCLED ACAPULCO MAT GREEN,13,285,44,4500,4215,1,88.0
4212,18074.0,HANGING MEDINA LANTERN SMALL,1,62,7,800,738,0,14.0
4213,18075.0,STRAWBERRY RAFFIA FOOD COVER,14,544,69,7000,6456,1,138.0
4214,18077.0,MINI PLAYING CARDS GYMKHANA,11,414,97,9800,9386,1,194.0
4215,18078.0,SMALL TALL CAMPHOR WOOD TOADSTOOL,2,86,16,1700,1614,0,17.5
4216,18079.0,LUNCH BAG VINTAGE LEAF DESIGN,4,113,61,6200,6087,0,63.900000000000006
4217,18080.0,SET OF 72 PINK HEART PAPER DOILIES,2,3,0,100,97,0,0.0
4218,18081.0,RED ROCKING HORSE HAND PAINTED,3,65,7,800,735,0,14.0
4219,18082.0,REX CASH+CARRY JUMBO SHOPPER,1,157,39,4000,3843,1,78.0
4220,18084.0,WOODEN STAR CHRISTMAS SCANDINAVIAN,2,3,0,100,97,0,0.0
4221,18085.0,FELT EGG COSY WHITE RABBIT ,2,82,13,1400,1318,0,16.900000000000002
4222,18086.0,LUNCH BAG  BLACK SKULL.,1,10,6,700,690,0,12.0
4223,18087.0,EMPIRE DESIGN ROSETTE,4,857,3,400,457,1,6.0
4224,18088.0,SET OF 6 TEA TIME BAKING CASES,1,81,22,2300,2219,0,16.799999999999997
4225,18092.0,WHITE SKULL HOT WATER BOTTLE ,12,332,45,4600,4268,1,90.0
4226,18093.0,CHRISTMAS CRAFT WHITE FAIRY ,5,63,21,2200,2137,0,19.600000000000005
4227,18094.0,DOUGHNUT LIP GLOSS ,7,150,35,3600,3450,1,70.0
4228,18095.0,PINK BLUE FELT CRAFT TRINKET BOX,2,55,10,1100,1045,0,11.700000000000003
4229,18096.0,MIRRORED WALL ART LADIES,3,487,98,9900,9413,1,196.0
4230,18097.0,TREASURE ISLAND BOOK BOX,7,325,53,5400,5075,1,106.0
4231,18099.0,PLASTERS IN TIN CIRCUS PARADE ,1,40,8,900,860,0,16.0
4232,18101.0,CUT GLASS HEXAGON T-LIGHT HOLDER,2,105,21,2200,2095,0,21.0
4233,18102.0,DOORMAT MERRY CHRISTMAS RED ,62,5159,159,16000,10841,1,318.0
4234,18104.0,DOORMAT RED RETROSPOT,1,142,18,1900,1758,0,17.099999999999998
4235,18105.0,REX CASH+CARRY JUMBO SHOPPER,1,40,9,1000,960,0,18.0
4236,18106.0,WELCOME  WOODEN BLOCK LETTERS,1,153,21,2200,2047,1,42.0
4237,18108.0,DOORMAT FANCY FONT HOME SWEET HOME,2,86,7,800,714,0,14.0
4238,18109.0,HEART OF WICKER SMALL,31,2267,175,17600,15333,1,350.0
4239,18110.0,REX CASH+CARRY JUMBO SHOPPER,2,139,24,2500,2361,0,27.6
4240,18112.0,CLASSIC GLASS COOKIE JAR,2,111,15,1600,1489,0,12.2
4241,18113.0,ANTIQUE SILVER TEA GLASS ETCHED,1,1,0,100,99,0,0.0
4242,18114.0,ENAMEL COLANDER CREAM,1,154,16,1700,1546,1,32.0
4243,18116.0,SET OF 16 VINTAGE SKY BLUE CUTLERY,8,895,146,14700,13805,1,292.0
4244,18117.0,REX CASH+CARRY JUMBO SHOPPER,1,89,37,3800,3711,0,38.199999999999996
4245,18118.0,SET OF 4 POLKADOT PLACEMATS ,31,3292,259,26000,22708,1,518.0
4246,18119.0,REX CASH+CARRY JUMBO SHOPPER,1,83,13,1400,1317,0,15.8
4247,18120.0,ENGLISH ROSE METAL WASTE BIN,1,68,10,1100,1032,0,20.0
4248,18121.0,ZINC T-LIGHT HOLDER STARS SMALL,2,59,17,1800,1741,0,13.6
4249,18122.0,LUNCH BAG  BLACK SKULL.,6,851,139,14000,13149,1,278.0
4250,18123.0,LUNCH BAG  BLACK SKULL.,2,51,19,2000,1949,0,20.199999999999996
4251,18125.0,SET OF 4 POLKADOT PLACEMATS ,5,437,85,8600,8163,1,170.0
4252,18126.0,PACK OF 6 SKULL PAPER CUPS,1,109,31,3200,3091,0,30.200000000000003
4253,18127.0,ROSE SCENT CANDLE JEWELLED DRAWER,3,149,24,2500,2351,0,27.1
4254,18129.0,METAL SIGN EMPIRE TEA,1,40,6,700,660,0,12.0
4255,18130.0,LUNCH BAG  BLACK SKULL.,4,167,33,3400,3233,1,66.0
4256,18133.0,Manual,2,0,1,200,200,0,2.0
4257,18135.0,TREASURE ISLAND BOOK BOX,5,46,8,900,854,0,16.0
4258,18136.0,HOT WATER BOTTLE I AM SO POORLY,4,107,18,1900,1793,0,24.099999999999998
4259,18138.0,VICTORIAN GLASS HANGING T-LIGHT,1,50,3,400,350,0,6.0
4260,18139.0,SET OF 6 TEA TIME BAKING CASES,8,241,87,8800,8559,1,174.0
4261,18141.0,NATURAL SLATE HEART CHALKBOARD ,1,2,0,100,98,0,0.0
4262,18142.0,PINK CREAM FELT CRAFT TRINKET BOX ,4,27,10,1100,1073,0,11.6
4263,18143.0,SET OF 6 TEA TIME BAKING CASES,2,166,35,3600,3434,1,70.0
4264,18144.0,SWEETHEART CAKESTAND 3 TIER,12,190,23,2400,2210,1,46.0
4265,18145.0,LUNCH BAG  BLACK SKULL.,4,398,93,9400,9002,1,186.0
4266,18146.0,PACK OF 60 SPACEBOY CAKE CASES,2,19,4,500,481,0,8.0
4267,18147.0,VINTAGE BEAD PINK EVENING BAG,2,9,4,500,491,0,8.0
4268,18149.0,REX CASH+CARRY JUMBO SHOPPER,3,44,8,900,856,0,16.0
4269,18150.0,CHRISTMAS CRAFT WHITE FAIRY ,3,85,21,2200,2115,0,20.099999999999998
4270,18151.0,FELT EGG COSY WHITE RABBIT ,2,121,17,1800,1679,0,20.8
4271,18154.0,SET OF 10 LED DOLLY LIGHTS,2,59,10,1100,1041,0,20.0
4272,18155.0,SET 6 PAPER TABLE LANTERN STARS ,4,72,14,1500,1428,0,12.9
4273,18156.0,WHITE SKULL HOT WATER BOTTLE ,2,420,68,6900,6480,1,136.0
4274,18158.0,WOODEN TREE CHRISTMAS SCANDINAVIAN,3,45,17,1800,1755,0,17.500000000000007
4275,18159.0,WOODEN UNION JACK BUNTING,1,115,11,1200,1085,0,14.2
4276,18160.0,DOORMAT VINTAGE LEAVES DESIGN ,2,142,23,2400,2258,0,24.600000000000005
4277,18161.0,RECIPE BOX PANTRY YELLOW DESIGN,6,294,39,4000,3706,1,78.0
4278,18164.0,DOORMAT KEEP CALM AND COME IN,2,105,13,1400,1295,0,13.7
4279,18165.0,PACK OF 6 SWEETIE GIFT BOXES,1,12,6,700,688,0,12.0
4280,18167.0,RED RETROSPOT SUGAR JAM BOWL,6,156,26,2700,2544,1,52.0
4281,18168.0,BLUE HAPPY BIRTHDAY BUNTING,9,460,72,7300,6840,1,144.0
4282,18169.0,HEART OF WICKER LARGE,1,33,3,400,367,0,6.0
4283,18170.0,DECORATIVE WICKER HEART LARGE,3,161,15,1600,1439,1,30.0
4284,18171.0,WOODEN CROQUET GARDEN SET,7,286,29,3000,2714,1,58.0
4285,18172.0,SET 7 BABUSHKA NESTING BOXES,25,619,96,9700,9081,1,192.0
4286,18173.0,BLUE GIANT GARDEN THERMOMETER,4,83,17,1800,1717,0,15.100000000000001
4287,18174.0,JUMBO BAG RED RETROSPOT,1,2,0,100,98,0,0.0
4288,18176.0,SET OF 4 NAPKIN CHARMS HEARTS,2,97,16,1700,1603,0,16.000000000000004
4289,18177.0,LUNCH BAG  BLACK SKULL.,7,141,36,3700,3559,0,37.499999999999986
4290,18178.0,LUNCH BAG  BLACK SKULL.,6,246,50,5100,4854,1,100.0
4291,18179.0,LUNCH BAG  BLACK SKULL.,6,248,46,4700,4452,1,92.0
4292,18180.0,WHITE SKULL HOT WATER BOTTLE ,6,247,56,5700,5453,1,112.0
4293,18181.0,HOT WATER BOTTLE I AM SO POORLY,1,159,22,2300,2141,1,44.0
4294,18183.0,RED RETROSPOT PEG BAG,6,155,24,2500,2345,1,48.0
4295,18184.0,ASSORTED COLOURS SILK FAN,1,0,0,100,100,0,0.0
4296,18185.0,SWEETHEART CAKESTAND 3 TIER,1,61,12,1300,1239,0,24.0
4297,18188.0,JUMBO BAG VINTAGE DOILY ,4,178,36,3700,3522,1,72.0
4298,18189.0,HERB MARKER PARSLEY,3,226,37,3800,3574,1,74.0
4299,18190.0,PACK OF 12 HEARTS DESIGN TISSUES ,3,68,8,900,832,0,16.0
4300,18191.0,RECYCLED ACAPULCO MAT GREEN,1,28,3,400,372,0,6.0
4301,18192.0,LUNCH BAG VINTAGE LEAF DESIGN,1,180,21,2200,2020,1,42.0
4302,18193.0,WOODEN CROQUET GARDEN SET,3,74,10,1100,1026,0,20.0
4303,18194.0,TEA PARTY BIRTHDAY CARD,2,12,4,500,488,0,8.0
4304,18196.0,ALARM CLOCK BAKELIKE GREEN,2,311,67,6800,6489,1,134.0
4305,18198.0,LUNCH BAG  BLACK SKULL.,21,390,77,7800,7410,1,154.0
4306,18200.0,ENVELOPE 50 BLOSSOM IMAGES,1,62,15,1600,1538,0,16.200000000000003
4307,18202.0,SWEETHEART CAKESTAND 3 TIER,3,275,33,3400,3125,1,66.0
4308,18203.0,SMALL TALL CAMPHOR WOOD TOADSTOOL,1,87,10,1100,1013,0,20.0
4309,18204.0,WRAP SUKI AND FRIENDS,4,524,92,9300,8776,1,184.0
4310,18205.0,DOORMAT KEEP CALM AND COME IN,2,146,15,1600,1454,0,15.200000000000001
4311,18209.0,LETS GO SHOPPING COTTON TOTE BAG,1,25,3,400,375,0,6.0
4312,18210.0,MINI PLAYING CARDS GYMKHANA,6,482,66,6700,6218,1,132.0
4313,18211.0,DECORATIVE WICKER HEART LARGE,5,102,19,2000,1898,0,21.2
4314,18212.0,REX CASH+CARRY JUMBO SHOPPER,1,131,24,2500,2369,0,18.9
4315,18213.0,36 PENCILS TUBE WOODLAND,1,22,6,700,678,0,12.0
4316,18215.0,DOORMAT SPOTTY HOME SWEET HOME,1,38,5,600,562,0,10.0
4317,18216.0,BLUE HAPPY BIRTHDAY BUNTING,1,128,14,1500,1372,0,12.900000000000002
4318,18217.0,SET OF 6 TEA TIME BAKING CASES,2,64,14,1500,1436,0,17.499999999999996
4319,18218.0,LUNCH BAG  BLACK SKULL.,4,43,12,1300,1257,0,10.999999999999998
4320,18219.0,WRAP ENGLISH ROSE ,11,495,55,5600,5105,1,110.0
4321,18220.0,STRAWBERRY CERAMIC TRINKET BOX,2,4,2,300,296,0,4.0
4322,18221.0,PINK PARTY BAGS,6,170,34,3500,3330,1,68.0
4323,18222.0,WOODEN CROQUET GARDEN SET,1,61,9,1000,939,0,18.0
4324,18223.0,ALARM CLOCK BAKELIKE GREEN,27,889,129,13000,12111,1,258.0
4325,18224.0,MOUSE TOY WITH PINK T-SHIRT,1,30,6,700,670,0,12.0
4326,18225.0,12 PENCILS SMALL TUBE RED RETROSPOT,17,763,124,12500,11737,1,248.0
4327,18226.0,LUNCH BAG  BLACK SKULL.,14,543,115,11600,11057,1,230.0
4328,18227.0,CREAM SWEETHEART MINI CHEST,1,43,3,400,357,0,6.0
4329,18228.0,HOT WATER BOTTLE I AM SO POORLY,3,130,18,1900,1770,0,15.9
4330,18229.0,LUNCH BAG  BLACK SKULL.,20,758,79,8000,7242,1,158.0
4331,18230.0,TROPICAL PASSPORT COVER ,10,204,46,4700,4496,1,92.0
4332,18231.0,SET/6 PINK  BUTTERFLY T-LIGHTS,6,470,55,5600,5130,1,110.0
4333,18232.0,SWEETHEART CAKESTAND 3 TIER,5,148,21,2200,2052,0,18.900000000000002
4334,18233.0,CHEST NATURAL WOOD 20 DRAWERS,1,110,0,100,10,0,0.0
4335,18235.0,GREY HEART HOT WATER BOTTLE,3,223,57,5800,5577,1,114.0
4336,18236.0,PINK VINTAGE SPOT BEAKER,6,164,28,2900,2736,1,56.0
4337,18237.0,DRAWER KNOB CRACKLE GLAZE BLUE,5,180,26,2700,2520,1,52.0
4338,18239.0,CERAMIC BIRDHOUSE CRESTED TIT SMALL,5,252,44,4500,4248,1,88.0
4339,18240.0,EDWARDIAN PARASOL PINK,1,23,4,500,477,0,8.0
4340,18241.0,DOORMAT RED RETROSPOT,18,342,57,5800,5458,1,114.0
4341,18242.0,RED RETROSPOT PEG BAG,4,255,33,3400,3145,1,66.0
4342,18245.0,ALARM CLOCK BAKELIKE GREEN,8,469,78,7900,7431,1,156.0
4343,18246.0,WHITE METAL LANTERN,2,18,1,200,182,0,2.0
4344,18248.0,DOORMAT RED RETROSPOT,4,197,23,2400,2203,1,46.0
4345,18249.0,FAWN BLUE HOT WATER BOTTLE,1,12,5,600,588,0,10.0
4346,18250.0,GINGERBREAD MAN COOKIE CUTTER,2,86,10,1100,1014,0,20.0
4347,18251.0,PACK OF 72 RETROSPOT CAKE CASES,1,12,9,1000,988,0,18.0
4348,18252.0,PANTRY HOOK BALLOON WHISK ,2,306,49,5000,4694,1,98.0
4349,18255.0,RED RETROSPOT SMALL MILK JUG,1,10,2,300,290,0,4.0
4350,18256.0,CHRISTMAS RETROSPOT TREE WOOD,1,3,2,300,297,0,4.0
4351,18257.0,LUNCH BAG VINTAGE LEAF DESIGN,12,421,63,6400,5979,1,126.0
4352,18259.0,HOT WATER BOTTLE I AM SO POORLY,3,136,25,2600,2464,0,23.799999999999997
4353,18260.0,BLUE HAPPY BIRTHDAY BUNTING,8,515,59,6000,5485,1,118.0
4354,18261.0,CHRISTMAS CRAFT WHITE FAIRY ,2,64,12,1300,1236,0,10.600000000000001
4355,18262.0,JAM MAKING SET PRINTED,1,14,7,800,786,0,14.0
4356,18263.0,PICTURE DOMINOES,4,60,31,3200,3140,0,33.599999999999994
4357,18265.0,WRAP ENGLISH ROSE ,2,241,26,2700,2459,1,52.0
4358,18268.0,SET OF 16 VINTAGE ROSE CUTLERY,2,25,1,200,175,0,2.0
4359,18269.0,SILK PURSE BABUSHKA BLUE,2,27,4,500,473,0,8.0
4360,18270.0,SET OF 16 VINTAGE PISTACHIO CUTLERY,3,59,5,600,541,0,10.0
4361,18272.0,HOMEMADE JAM SCENTED CANDLES,7,391,85,8600,8209,1,170.0
4362,18273.0,"ART LIGHTS,FUNK MONKEY",3,7,1,200,193,0,2.0
4363,18274.0,SET 20 NAPKINS FAIRY CAKES DESIGN ,2,80,12,1300,1220,0,13.2
4364,18276.0,PINK CREAM FELT CRAFT TRINKET BOX ,3,47,9,1000,953,0,18.0
4365,18277.0,EDWARDIAN PARASOL PINK,2,37,4,500,463,0,8.0
4366,18278.0,GARDENERS KNEELING PAD KEEP CALM ,1,29,4,500,471,0,8.0
4367,18280.0,WOODEN UNION JACK BUNTING,1,47,4,500,453,0,8.0
4368,18281.0,LUNCH BAG DOILEY PATTERN ,1,39,2,300,261,0,4.0
4369,18282.0,CARD CHRISTMAS VILLAGE,3,62,7,800,738,0,14.0
4370,18283.0,LUNCH BAG  BLACK SKULL.,16,1220,209,21000,19780,1,418.0
4371,18287.0,SET 7 BABUSHKA NESTING BOXES,3,104,41,4200,4096,0,36.19999999999999
4372,1001.0,WHITE HANGING HEART T-LIGHT HOLDER,24,982,20,2100,1118,1,40.0
4373,1002.0,WHITE METAL LANTERN,26,658,20,2100,1442,1,40.0
4374,1003.0,CREAM CUPID HEARTS COAT HANGER,10,804,25,2600,1796,1,50.0
4375,1004.0,KNITTED UNION FLAG HOT WATER BOTTLE,34,100,0,100,0,1,0.0
4376,1005.0,RED WOOLLY HOTTIE WHITE HEART.,21,1472,20,2100,628,1,40.0
4377,1006.0,SET 7 BABUSHKA NESTING BOXES,28,1624,25,2600,976,1,50.0
4378,1007.0,GLASS STAR FROSTED T-LIGHT HOLDER,31,535,6,700,165,1,12.0
4379,1008.0,HAND WARMER UNION JACK,35,670,17,1800,1130,1,34.0
4380,1009.0,HAND WARMER RED POLKA DOT,4,2070,22,2300,230,1,44.0
4381,1010.0,ASSORTED COLOUR BIRD ORNAMENT,21,935,20,2100,1165,1,40.0
4382,1011.0,POPPY'S PLAYHOUSE BEDROOM ,33,147,3,400,253,1,6.0
4383,1012.0,POPPY'S PLAYHOUSE KITCHEN,21,449,11,1200,751,1,22.0
4384,1013.0,FELTCRAFT PRINCESS CHARLOTTE DOLL,19,795,19,2000,1205,1,38.0
4385,1014.0,IVORY KNITTED MUG COSY ,10,413,4,500,87,1,8.0
4386,1015.0,BOX OF 6 ASSORTED COLOUR TEASPOONS,33,355,5,600,245,1,10.0
4387,1016.0,BOX OF VINTAGE JIGSAW BLOCKS ,21,527,23,2400,1873,1,46.0
4388,1017.0,BOX OF VINTAGE ALPHABET BLOCKS,27,1069,15,1600,531,1,30.0
4389,1018.0,HOME BUILDING BLOCK WORD,24,254,2,300,46,1,4.0
4390,1019.0,LOVE BUILDING BLOCK WORD,24,651,9,1000,349,1,18.0
4391,1020.0,RECIPE BOX WITH METAL HEART,17,615,16,1700,1085,1,32.0
4392,1021.0,DOORMAT NEW ENGLAND,8,598,21,2200,1602,1,42.0
4393,1022.0,JAM MAKING SET WITH JARS,27,1584,15,1600,16,1,30.0
4394,1023.0,RED COAT RACK PARIS FASHION,19,100,0,100,0,1,0.0
4395,1024.0,YELLOW COAT RACK PARIS FASHION,24,183,5,600,417,1,10.0
4396,1025.0,BLUE COAT RACK PARIS FASHION,27,1626,17,1800,174,1,34.0
4397,1026.0,BATH BUILDING BLOCK WORD,11,329,5,600,271,1,10.0
4398,1027.0,ALARM CLOCK BAKELIKE PINK,14,332,5,600,268,1,10.0
4399,1028.0,ALARM CLOCK BAKELIKE RED ,9,703,15,1600,897,1,30.0
4400,1029.0,ALARM CLOCK BAKELIKE GREEN,27,478,10,1100,622,1,20.0
4401,1030.0,PANDA AND BUNNIES STICKER SHEET,19,680,8,900,220,1,16.0
4402,1031.0,STARS GIFT TAPE ,34,1306,21,2200,894,1,42.0
4403,1032.0,INFLATABLE POLITICAL GLOBE ,30,1770,18,1900,130,1,36.0
4404,1033.0,VINTAGE HEADS AND TAILS CARD GAME ,25,429,18,1900,1471,1,36.0
4405,1034.0,SET/2 RED RETROSPOT TEA TOWELS ,24,751,18,1900,1149,1,36.0
4406,1035.0,ROUND SNACK BOXES SET OF4 WOODLAND ,2,1156,20,2100,944,1,40.0
4407,1036.0,SPACEBOY LUNCH BOX ,25,1982,19,2000,18,1,38.0
4408,1037.0,LUNCH BOX I LOVE LONDON,10,137,6,700,563,1,12.0
4409,1038.0,CIRCUS PARADE LUNCH BOX ,10,337,8,900,563,1,16.0
4410,1039.0,CHARLOTTE BAG DOLLY GIRL DESIGN,2,421,4,500,79,1,8.0
4411,1040.0,RED TOADSTOOL LED NIGHT LIGHT,5,546,5,600,54,1,10.0
4412,1041.0, SET 2 TEA TOWELS I LOVE LONDON ,6,385,6,700,315,1,12.0
4413,1042.0,VINTAGE SEASIDE JIGSAW PUZZLES,16,565,9,1000,435,1,18.0
4414,1043.0,MINI JIGSAW CIRCUS PARADE ,22,770,8,900,130,1,16.0
4415,1044.0,MINI JIGSAW SPACEBOY,31,483,6,700,217,1,12.0
4416,1045.0,MINI PAINT SET VINTAGE ,35,862,13,1400,538,1,26.0
4417,1046.0,POSTAGE,25,542,24,2500,1958,1,48.0
4418,1047.0,PAPER CHAIN KIT 50'S CHRISTMAS ,34,1719,25,2600,881,1,50.0
4419,1048.0,HAND WARMER RED POLKA DOT,15,1132,16,1700,568,1,32.0
4420,1049.0,HAND WARMER UNION JACK,5,888,8,900,12,1,16.0
4421,1050.0,WHITE HANGING HEART T-LIGHT HOLDER,33,1142,25,2600,1458,1,50.0
4422,1051.0,WHITE METAL LANTERN,20,1830,20,2100,270,1,40.0
4423,1052.0,CREAM CUPID HEARTS COAT HANGER,6,793,7,800,7,1,14.0
4424,1053.0,EDWARDIAN PARASOL RED,29,726,12,1300,574,1,24.0
4425,1054.0,RETRO COFFEE MUGS ASSORTED,22,190,2,300,110,1,4.0
4426,1055.0,SAVE THE PLANET MUG,33,1933,24,2500,567,1,48.0
4427,1056.0,VINTAGE BILLBOARD DRINK ME MUG,29,1152,23,2400,1248,1,46.0
4428,1057.0,VINTAGE BILLBOARD LOVE/HATE MUG,27,482,4,500,18,1,8.0
4429,1058.0,WOOD 2 DRAWER CABINET WHITE FINISH,11,616,10,1100,484,1,20.0
4430,1059.0,WOOD S/3 CABINET ANT WHITE FINISH,21,100,0,100,0,1,0.0
4431,1060.0,WOODEN PICTURE FRAME WHITE FINISH,35,1304,25,2600,1296,1,50.0
4432,1061.0,WOODEN FRAME ANTIQUE WHITE ,3,1088,24,2500,1412,1,48.0
4433,1062.0,KNITTED UNION FLAG HOT WATER BOTTLE,16,188,1,200,12,1,2.0
4434,1063.0,RED WOOLLY HOTTIE WHITE HEART.,9,245,15,1600,1355,1,30.0
4435,1064.0,SET 7 BABUSHKA NESTING BOXES,8,1063,14,1500,437,1,28.0
4436,1065.0,GLASS STAR FROSTED T-LIGHT HOLDER,1,1661,24,2500,839,1,48.0
4437,1066.0,VICTORIAN SEWING BOX LARGE,11,665,14,1500,835,1,28.0
4438,1067.0,WHITE HANGING HEART T-LIGHT HOLDER,21,1225,24,2500,1275,1,48.0
4439,1068.0,WHITE METAL LANTERN,15,207,13,1400,1193,1,26.0
4440,1069.0,CREAM CUPID HEARTS COAT HANGER,24,355,10,1100,745,1,20.0
4441,1070.0,EDWARDIAN PARASOL RED,24,387,8,900,513,1,16.0
4442,1071.0,RETRO COFFEE MUGS ASSORTED,14,989,18,1900,911,1,36.0
4443,1072.0,SAVE THE PLANET MUG,24,1627,25,2600,973,1,50.0
4444,1073.0,VINTAGE BILLBOARD DRINK ME MUG,33,176,6,700,524,1,12.0
4445,1074.0,VINTAGE BILLBOARD LOVE/HATE MUG,24,320,6,700,380,1,12.0
4446,1075.0,WOOD 2 DRAWER CABINET WHITE FINISH,23,532,6,700,168,1,12.0
4447,1076.0,WOOD S/3 CABINET ANT WHITE FINISH,1,2566,25,2600,34,1,50.0
4448,1077.0,WOODEN PICTURE FRAME WHITE FINISH,25,396,9,1000,604,1,18.0
4449,1078.0,WOODEN FRAME ANTIQUE WHITE ,8,152,18,1900,1748,1,36.0
4450,1079.0,KNITTED UNION FLAG HOT WATER BOTTLE,27,682,6,700,18,1,12.0
4451,1080.0,RED WOOLLY HOTTIE WHITE HEART.,23,251,2,300,49,1,4.0
4452,1081.0,SET 7 BABUSHKA NESTING BOXES,4,1449,25,2600,1151,1,50.0
4453,1082.0,GLASS STAR FROSTED T-LIGHT HOLDER,4,173,8,900,727,1,16.0
4454,1083.0,HOT WATER BOTTLE TEA AND SYMPATHY,19,283,8,900,617,1,16.0
4455,1084.0,RED HANGING HEART T-LIGHT HOLDER,9,152,1,200,48,1,2.0
4456,1085.0,HAND WARMER RED POLKA DOT,3,566,6,700,134,1,12.0
4457,1086.0,HAND WARMER UNION JACK,14,809,23,2400,1591,1,46.0
4458,1087.0,JUMBO BAG PINK POLKADOT,4,1793,25,2600,807,1,50.0
4459,1088.0,JUMBO  BAG BAROQUE BLACK WHITE,3,2284,24,2500,216,1,48.0
4460,1089.0,JUMBO BAG CHARLIE AND LOLA TOYS,13,299,7,800,501,1,14.0
4461,1090.0,STRAWBERRY CHARLOTTE BAG,13,420,7,800,380,1,14.0
4462,1091.0,RED 3 PIECE RETROSPOT CUTLERY SET,1,909,19,2000,1091,1,38.0
4463,1092.0,BLUE 3 PIECE POLKADOT CUTLERY SET,5,1823,21,2200,377,1,42.0
4464,1093.0,SET/6 RED SPOTTY PAPER PLATES,28,413,21,2200,1787,1,42.0
4465,1094.0,LUNCH BAG RED RETROSPOT,31,2056,21,2200,144,1,42.0
4466,1095.0,STRAWBERRY LUNCH BOX WITH CUTLERY,19,556,13,1400,844,1,26.0
4467,1096.0,LUNCH BOX WITH CUTLERY RETROSPOT ,4,1741,19,2000,259,1,38.0
4468,1097.0,PACK OF 72 RETROSPOT CAKE CASES,12,341,6,700,359,1,12.0
4469,1098.0,PACK OF 60 DINOSAUR CAKE CASES,20,719,14,1500,781,1,28.0
4470,1099.0,PACK OF 60 PINK PAISLEY CAKE CASES,32,747,16,1700,953,1,32.0
4471,1100.0,60 TEATIME FAIRY CAKE CASES,18,378,14,1500,1122,1,28.0
4472,1101.0,TOMATO CHARLIE+LOLA COASTER SET,19,461,13,1400,939,1,26.0
4473,1102.0,CHARLIE & LOLA WASTEPAPER BIN FLORA,13,272,11,1200,928,1,22.0
4474,1103.0,RED CHARLIE+LOLA PERSONAL DOORSIGN,15,114,6,700,586,1,12.0
4475,1104.0,JUMBO STORAGE BAG SUKI,8,410,8,900,490,1,16.0
4476,1105.0,JUMBO BAG PINK VINTAGE PAISLEY,10,1026,12,1300,274,1,24.0
4477,1106.0,JAM MAKING SET PRINTED,33,200,1,200,0,1,2.0
4478,1107.0,RETROSPOT TEA SET CERAMIC 11 PC ,35,1873,24,2500,627,1,48.0
4479,1108.0,GIRLY PINK TOOL SET,8,148,8,900,752,1,16.0
4480,1109.0,JUMBO SHOPPER VINTAGE RED PAISLEY,18,1053,23,2400,1347,1,46.0
4481,1110.0,"AIRLINE LOUNGE,METAL SIGN",18,1811,20,2100,289,1,40.0
4482,1111.0,WHITE SPOT RED CERAMIC DRAWER KNOB,17,454,10,1100,646,1,20.0
4483,1112.0,RED DRAWER KNOB ACRYLIC EDWARDIAN,18,1390,19,2000,610,1,38.0
4484,1113.0,CLEAR DRAWER KNOB ACRYLIC EDWARDIAN,3,536,12,1300,764,1,24.0
4485,1114.0,PHOTO CLIP LINE,2,1229,13,1400,171,1,26.0
4486,1115.0,FELT EGG COSY CHICKEN,5,625,9,1000,375,1,18.0
4487,1116.0,PIGGY BANK RETROSPOT ,27,758,23,2400,1642,1,46.0
4488,1117.0,SKULL SHOULDER BAG,2,446,22,2300,1854,1,44.0
4489,1118.0,YOU'RE CONFUSING ME METAL SIGN ,10,100,0,100,0,1,0.0
4490,1119.0,COOK WITH WINE METAL SIGN ,5,1542,23,2400,858,1,46.0
4491,1120.0,GIN + TONIC DIET METAL SIGN,23,509,10,1100,591,1,20.0
4492,1121.0,YELLOW BREAKFAST CUP AND SAUCER,8,1071,13,1400,329,1,26.0
4493,1122.0,PINK BREAKFAST CUP AND SAUCER ,34,160,1,200,40,1,2.0
4494,1123.0,PAPER CHAIN KIT 50'S CHRISTMAS ,3,792,17,1800,1008,1,34.0
4495,1124.0,PAPER CHAIN KIT RETROSPOT,27,1814,18,1900,86,1,36.0
4496,1125.0,SMALL HEART FLOWERS HOOK ,24,617,10,1100,483,1,20.0
4497,1126.0,PHOTO CLIP LINE,4,342,11,1200,858,1,22.0
4498,1127.0,TEA TIME DES TEA COSY,18,872,9,1000,128,1,18.0
4499,1128.0,FELT EGG COSY WHITE RABBIT ,23,171,13,1400,1229,1,26.0
4500,1129.0,ZINC WILLIE WINKIE  CANDLE STICK,14,242,2,300,58,1,4.0
4501,1130.0,CERAMIC CHERRY CAKE MONEY BANK,17,348,23,2400,2052,1,46.0
4502,1131.0,RETROSPOT LARGE MILK JUG,6,2369,25,2600,231,1,50.0
4503,1132.0,SET OF 6 FUNKY BEAKERS,22,121,2,300,179,1,4.0
4504,1133.0,EDWARDIAN PARASOL BLACK,34,1898,19,2000,102,1,38.0
4505,1134.0,EDWARDIAN PARASOL NATURAL,20,633,11,1200,567,1,22.0
4506,1135.0,CERAMIC STRAWBERRY CAKE MONEY BANK,33,196,13,1400,1204,1,26.0
4507,1136.0,BLUE OWL SOFT TOY,34,480,5,600,120,1,10.0
4508,1137.0,BALLOON ART MAKE YOUR OWN FLOWERS,18,575,5,600,25,1,10.0
4509,1138.0,RED TOADSTOOL LED NIGHT LIGHT,7,366,24,2500,2134,1,48.0
4510,1139.0,GLASS CLOCHE SMALL,30,1884,23,2400,516,1,46.0
4511,1140.0,GUMBALL MONOCHROME COAT RACK,17,2170,21,2200,30,1,42.0
4512,1141.0,DOORMAT FANCY FONT HOME SWEET HOME,17,193,5,600,407,1,10.0
4513,1142.0,Discount,30,121,3,400,279,1,6.0
4514,1143.0,INFLATABLE POLITICAL GLOBE ,23,453,9,1000,547,1,18.0
4515,1144.0,VINTAGE SNAKES & LADDERS,11,420,9,1000,580,1,18.0
4516,1145.0,CHOCOLATE CALCULATOR,33,154,22,2300,2146,1,44.0
4517,1146.0,JUMBO SHOPPER VINTAGE RED PAISLEY,8,138,2,300,162,1,4.0
4518,1147.0,RECYCLING BAG RETROSPOT ,8,589,25,2600,2011,1,50.0
4519,1148.0,TOY TIDY PINK POLKADOT,25,1829,22,2300,471,1,44.0
4520,1149.0,ANTIQUE GLASS DRESSING TABLE POT,29,246,2,300,54,1,4.0
4521,1150.0,ALARM CLOCK BAKELIKE GREEN,27,1085,10,1100,15,1,20.0
4522,1151.0,IVORY GIANT GARDEN THERMOMETER,27,210,15,1600,1390,1,30.0
4523,1152.0,3 TIER CAKE TIN GREEN AND CREAM,31,447,17,1800,1353,1,34.0
4524,1153.0,3 TIER CAKE TIN RED AND CREAM,30,975,11,1200,225,1,22.0
4525,1154.0,SET 3 WICKER OVAL BASKETS W LIDS,24,267,8,900,633,1,16.0
4526,1155.0,SET OF 3 COLOURED  FLYING DUCKS,2,1092,21,2200,1108,1,42.0
4527,1156.0,WOOD BLACK BOARD ANT WHITE FINISH,6,463,8,900,437,1,16.0
4528,1157.0,COLOUR GLASS T-LIGHT HOLDER HANGING,35,189,16,1700,1511,1,32.0
4529,1158.0,HANGING METAL HEART LANTERN,15,115,1,200,85,1,2.0
4530,1159.0,HANGING MEDINA LANTERN SMALL,9,242,2,300,58,1,4.0
4531,1160.0,NATURAL SLATE HEART CHALKBOARD ,28,141,1,200,59,1,2.0
4532,1161.0,HEART OF WICKER SMALL,13,100,0,100,0,1,0.0
4533,1162.0,HEART OF WICKER LARGE,16,300,12,1300,1000,1,24.0
4534,1163.0,WHITE LOVEBIRD LANTERN,17,202,4,500,298,1,8.0
4535,1164.0,CLASSIC METAL BIRDCAGE PLANT HOLDER,35,100,0,100,0,1,0.0
4536,1165.0,CREAM HEART CARD HOLDER,26,1670,20,2100,430,1,40.0
4537,1166.0,ENAMEL FLOWER JUG CREAM,4,1202,16,1700,498,1,32.0
4538,1167.0,ENAMEL FIRE BUCKET CREAM,19,923,17,1800,877,1,34.0
4539,1168.0,ENAMEL BREAD BIN CREAM,13,357,3,400,43,1,6.0
4540,1169.0,SET 3 WICKER OVAL BASKETS W LIDS,26,2189,25,2600,411,1,50.0
4541,1170.0,JAM MAKING SET PRINTED,16,100,0,100,0,1,0.0
4542,1171.0,JAM MAKING SET WITH JARS,32,433,9,1000,567,1,18.0
4543,1172.0,JUMBO BAG DOLLY GIRL DESIGN,20,2465,25,2600,135,1,50.0
4544,1173.0,TRADITIONAL CHRISTMAS RIBBONS,6,144,1,200,56,1,2.0
4545,1174.0,ORGANISER WOOD ANTIQUE WHITE ,17,1113,20,2100,987,1,40.0
4546,1175.0,LUNCH BAG DOLLY GIRL DESIGN,28,357,10,1100,743,1,20.0
4547,1176.0,WHITE WIRE EGG HOLDER,14,249,2,300,51,1,4.0
4548,1177.0,JUMBO  BAG BAROQUE BLACK WHITE,2,1487,15,1600,113,1,30.0
4549,1178.0,JUMBO BAG RED RETROSPOT,25,332,7,800,468,1,14.0
4550,1179.0,CHILLI LIGHTS,26,348,21,2200,1852,1,42.0
4551,1180.0,LIGHT GARLAND BUTTERFILES PINK,26,638,22,2300,1662,1,44.0
4552,1181.0,WOODEN OWLS LIGHT GARLAND ,27,1358,13,1400,42,1,26.0
4553,1182.0,FAIRY TALE COTTAGE NIGHTLIGHT,32,346,6,700,354,1,12.0
4554,1183.0,RED TOADSTOOL LED NIGHT LIGHT,35,1804,24,2500,696,1,48.0
4555,1184.0,HOME BUILDING BLOCK WORD,5,149,3,400,251,1,6.0
4556,1185.0,LOVE BUILDING BLOCK WORD,1,299,2,300,1,1,4.0
4557,1186.0,DOORMAT FANCY FONT HOME SWEET HOME,32,235,2,300,65,1,4.0
4558,1187.0,HOME SMALL WOOD LETTERS,2,824,19,2000,1176,1,38.0
4559,1188.0,GINGHAM HEART  DOORSTOP RED,9,107,2,300,193,1,4.0
4560,1189.0,FIVE HEART HANGING DECORATION,6,987,12,1300,313,1,24.0
4561,1190.0,HANGING METAL HEART LANTERN,23,292,13,1400,1108,1,26.0
4562,1191.0,ASSORTED BOTTLE TOP  MAGNETS ,27,177,2,300,123,1,4.0
4563,1192.0,FRIDGE MAGNETS US DINER ASSORTED,33,617,13,1400,783,1,26.0
4564,1193.0,HOMEMADE JAM SCENTED CANDLES,33,109,3,400,291,1,6.0
4565,1194.0,FRIDGE MAGNETS LES ENFANTS ASSORTED,2,1520,18,1900,380,1,36.0
4566,1195.0,ROSE CARAVAN DOORSTOP,32,573,25,2600,2027,1,50.0
4567,1196.0,HEART OF WICKER SMALL,35,2402,25,2600,198,1,50.0
4568,1197.0,5 HOOK HANGER MAGIC TOADSTOOL,27,523,18,1900,1377,1,36.0
4569,1198.0,CHRISTMAS LIGHTS 10 REINDEER,33,602,13,1400,798,1,26.0
4570,1199.0,VINTAGE UNION JACK CUSHION COVER,15,139,2,300,161,1,4.0
4571,1200.0,VINTAGE HEADS AND TAILS CARD GAME ,3,569,9,1000,431,1,18.0
4572,1201.0,SET OF 3 COLOURED  FLYING DUCKS,24,100,0,100,0,1,0.0
4573,1202.0,SET OF 3 GOLD FLYING DUCKS,7,145,3,400,255,1,6.0
4574,1203.0,RED RETROSPOT UMBRELLA,5,1581,21,2200,619,1,42.0
4575,1204.0,BLACK/BLUE POLKADOT UMBRELLA,26,290,25,2600,2310,1,50.0
4576,1205.0,RED DINER WALL CLOCK,7,204,10,1100,896,1,20.0
4577,1206.0,ALARM CLOCK BAKELIKE GREEN,23,2228,23,2400,172,1,46.0
4578,1207.0,ALARM CLOCK BAKELIKE RED ,4,883,22,2300,1417,1,44.0
4579,1208.0,BLUE DINER WALL CLOCK,15,221,3,400,179,1,6.0
4580,1209.0,IVORY DINER WALL CLOCK,30,304,4,500,196,1,8.0
4581,1210.0,LARGE HEART MEASURING SPOONS,13,1020,12,1300,280,1,24.0
4582,1211.0,SMALL HEART MEASURING SPOONS,5,996,16,1700,704,1,32.0
4583,1212.0,CHRISTMAS LIGHTS 10 REINDEER,23,699,8,900,201,1,16.0
4584,1213.0,JAM MAKING SET WITH JARS,1,298,2,300,2,1,4.0
4585,1214.0,JAM MAKING SET PRINTED,3,100,0,100,0,1,0.0
4586,1215.0,JAM JAR WITH PINK LID,5,1010,11,1200,190,1,22.0
4587,1216.0,JAM JAR WITH GREEN LID,8,199,2,300,101,1,4.0
4588,1217.0,ROSE COTTAGE KEEPSAKE BOX ,15,1125,12,1300,175,1,24.0
4589,1218.0,HANGING HEART ZINC T-LIGHT HOLDER,32,899,14,1500,601,1,28.0
4590,1219.0,PAPER CHAIN KIT VINTAGE CHRISTMAS,8,527,8,900,373,1,16.0
4591,1220.0,DISCO BALL CHRISTMAS DECORATION,29,1262,24,2500,1238,1,48.0
4592,1221.0,WHITE HANGING HEART T-LIGHT HOLDER,20,151,8,900,749,1,16.0
4593,1222.0,SMALL POPCORN HOLDER,32,1250,14,1500,250,1,28.0
4594,1223.0,LARGE POPCORN HOLDER ,31,229,13,1400,1171,1,26.0
4595,1224.0,RETROSPOT LARGE MILK JUG,28,552,9,1000,448,1,18.0
4596,1225.0,SET/20 RED RETROSPOT PAPER NAPKINS ,3,553,6,700,147,1,12.0
4597,1226.0,SET/6 RED SPOTTY PAPER PLATES,20,242,20,2100,1858,1,40.0
4598,1227.0,SET/6 RED SPOTTY PAPER CUPS,33,235,2,300,65,1,4.0
4599,1228.0,POLKADOT RAIN HAT ,20,704,15,1600,896,1,30.0
4600,1229.0,DELUXE SEWING KIT ,23,107,2,300,193,1,4.0
4601,1230.0,RETROSPOT HEART HOT WATER BOTTLE,26,1643,19,2000,357,1,38.0
4602,1231.0,KNITTED UNION FLAG HOT WATER BOTTLE,31,147,1,200,53,1,2.0
4603,1232.0,ENGLISH ROSE HOT WATER BOTTLE,21,780,8,900,120,1,16.0
4604,1233.0,PHOTO CUBE,23,663,16,1700,1037,1,32.0
4605,1234.0,HOMEMADE JAM SCENTED CANDLES,19,888,16,1700,812,1,32.0
4606,1235.0,JUMBO BAG RED RETROSPOT,10,225,14,1500,1275,1,28.0
4607,1236.0,PLASTERS IN TIN CIRCUS PARADE ,29,1964,23,2400,436,1,46.0
4608,1237.0,PACK OF 12 PINK PAISLEY TISSUES ,17,2213,24,2500,287,1,48.0
4609,1238.0,PACK OF 12 BLUE PAISLEY TISSUES ,12,1075,18,1900,825,1,36.0
4610,1239.0,PACK OF 12 RED RETROSPOT TISSUES ,27,1296,21,2200,904,1,42.0
4611,1240.0,CHICK GREY HOT WATER BOTTLE,21,557,13,1400,843,1,26.0
4612,1241.0,PLASTERS IN TIN VINTAGE PAISLEY ,30,677,9,1000,323,1,18.0
4613,1242.0,PLASTERS IN TIN SKULLS,8,629,11,1200,571,1,22.0
4614,1243.0,3 STRIPEY MICE FELTCRAFT,28,1802,24,2500,698,1,48.0
4615,1244.0,SET OF 6 SOLDIER SKITTLES,15,199,6,700,501,1,12.0
4616,1245.0,TRADITIONAL WOODEN SKIPPING ROPE,4,246,3,400,154,1,6.0
4617,1246.0,WOODEN BOX OF DOMINOES,35,1198,21,2200,1002,1,42.0
4618,1247.0,RUSTIC  SEVENTEEN DRAWER SIDEBOARD,13,2464,25,2600,136,1,50.0
4619,1248.0,PARTY CONES CARNIVAL ASSORTED,18,213,19,2000,1787,1,38.0
4620,1249.0,PARTY CONES CANDY ASSORTED,8,454,15,1600,1146,1,30.0
4621,1250.0,PICNIC BASKET WICKER SMALL,6,136,4,500,364,1,8.0
4622,1251.0,ASSORTED COLOUR BIRD ORNAMENT,12,778,17,1800,1022,1,34.0
4623,1252.0,STAR DECORATION PAINTED ZINC ,9,819,17,1800,981,1,34.0
4624,1253.0,RETROSPOT LAMP,13,890,16,1700,810,1,32.0
4625,1254.0,"FANCY FONT BIRTHDAY CARD, ",1,136,14,1500,1364,1,28.0
4626,1255.0,HAND WARMER UNION JACK,17,385,14,1500,1115,1,28.0
4627,1256.0,HAND WARMER SCOTTY DOG DESIGN,1,230,6,700,470,1,12.0
4628,1257.0,HAND WARMER OWL DESIGN,9,126,5,600,474,1,10.0
4629,1258.0,HAND WARMER RED RETROSPOT,22,841,17,1800,959,1,34.0
4630,1259.0,RETROSPOT HEART HOT WATER BOTTLE,15,179,1,200,21,1,2.0
4631,1260.0,DOG BOWL CHASING BALL DESIGN,13,885,8,900,15,1,16.0
4632,1261.0,CLOTHES PEGS RETROSPOT PACK 24 ,11,1574,20,2100,526,1,40.0
4633,1262.0,HAND OVER THE CHOCOLATE   SIGN ,33,692,7,800,108,1,14.0
4634,1263.0,WHITE HANGING HEART T-LIGHT HOLDER,16,874,8,900,26,1,16.0
4635,1264.0,TRAVEL SEWING KIT,26,214,22,2300,2086,1,44.0
4636,1265.0,BLACK HEART CARD HOLDER,18,158,13,1400,1242,1,26.0
4637,1266.0,ASSORTED COLOUR BIRD ORNAMENT,10,1317,18,1900,583,1,36.0
4638,1267.0,PACK OF 60 PINK PAISLEY CAKE CASES,17,548,22,2300,1752,1,44.0
4639,1268.0,60 TEATIME FAIRY CAKE CASES,26,264,10,1100,836,1,20.0
4640,1269.0,PACK OF 72 RETROSPOT CAKE CASES,3,389,3,400,11,1,6.0
4641,1270.0,CHICK GREY HOT WATER BOTTLE,35,584,20,2100,1516,1,40.0
4642,1271.0,SMALL GLASS HEART TRINKET POT,24,142,1,200,58,1,2.0
4643,1272.0,ALARM CLOCK BAKELIKE IVORY,16,1005,15,1600,595,1,30.0
4644,1273.0,ALARM CLOCK BAKELIKE RED ,1,241,6,700,459,1,12.0
4645,1274.0,ALARM CLOCK BAKELIKE ORANGE,2,314,5,600,286,1,10.0
4646,1275.0,ALARM CLOCK BAKELIKE GREEN,27,661,8,900,239,1,16.0
4647,1276.0,HOT WATER BOTTLE TEA AND SYMPATHY,1,100,0,100,0,1,0.0
4648,1277.0,HAND WARMER BIRD DESIGN,27,1485,19,2000,515,1,38.0
4649,1278.0,HAND WARMER SCOTTY DOG DESIGN,7,724,17,1800,1076,1,34.0
4650,1279.0,WHITE HANGING HEART T-LIGHT HOLDER,18,790,7,800,10,1,14.0
4651,1280.0,WHITE METAL LANTERN,25,458,6,700,242,1,12.0
4652,1281.0,CREAM CUPID HEARTS COAT HANGER,13,277,21,2200,1923,1,42.0
4653,1282.0,EDWARDIAN PARASOL BLACK,30,424,6,700,276,1,12.0
4654,1283.0,EDWARDIAN PARASOL RED,12,726,18,1900,1174,1,36.0
4655,1284.0,RETRO COFFEE MUGS ASSORTED,30,1728,21,2200,472,1,42.0
4656,1285.0,SAVE THE PLANET MUG,12,255,18,1900,1645,1,36.0
4657,1286.0,VINTAGE BILLBOARD DRINK ME MUG,16,1446,20,2100,654,1,40.0
4658,1287.0,VINTAGE BILLBOARD LOVE/HATE MUG,34,599,17,1800,1201,1,34.0
4659,1288.0,WOOD 2 DRAWER CABINET WHITE FINISH,9,1735,24,2500,765,1,48.0
4660,1289.0,WOOD S/3 CABINET ANT WHITE FINISH,22,1552,17,1800,248,1,34.0
4661,1290.0,WOODEN PICTURE FRAME WHITE FINISH,22,813,21,2200,1387,1,42.0
4662,1291.0,WOODEN FRAME ANTIQUE WHITE ,14,1704,24,2500,796,1,48.0
4663,1292.0,KNITTED UNION FLAG HOT WATER BOTTLE,24,1513,23,2400,887,1,46.0
4664,1293.0,RED WOOLLY HOTTIE WHITE HEART.,1,342,17,1800,1458,1,34.0
4665,1294.0,SET 7 BABUSHKA NESTING BOXES,33,1235,19,2000,765,1,38.0
4666,1295.0,IVORY EMBROIDERED QUILT ,14,456,11,1200,744,1,22.0
4667,1296.0,GLASS STAR FROSTED T-LIGHT HOLDER,14,200,4,500,300,1,8.0
4668,1297.0,SET OF 3 BLACK FLYING DUCKS,34,740,17,1800,1060,1,34.0
4669,1298.0,SET OF 3 COLOURED  FLYING DUCKS,34,124,1,200,76,1,2.0
4670,1299.0,PACK OF 12 RED RETROSPOT TISSUES ,34,371,7,800,429,1,14.0
4671,1300.0,RED RETROSPOT MUG,35,271,16,1700,1429,1,32.0
4672,1301.0,BABUSHKA LIGHTS STRING OF 10,11,747,12,1300,553,1,24.0
4673,1302.0,PIGGY BANK RETROSPOT ,20,282,16,1700,1418,1,32.0
4674,1303.0,SET 7 BABUSHKA NESTING BOXES,2,1167,11,1200,33,1,22.0
4675,1304.0,DOORMAT FAIRY CAKE,28,196,2,300,104,1,4.0
4676,1305.0,HAND WARMER RED RETROSPOT,23,286,7,800,514,1,14.0
4677,1306.0,HAND WARMER SCOTTY DOG DESIGN,27,2295,24,2500,205,1,48.0
4678,1307.0,HAND WARMER OWL DESIGN,23,230,2,300,70,1,4.0
4679,1308.0,STRAWBERRY CERAMIC TRINKET BOX,5,397,18,1900,1503,1,36.0
4680,1309.0,PINK DOUGHNUT TRINKET POT ,11,963,12,1300,337,1,24.0
4681,1310.0,SILK PURSE BABUSHKA PINK,16,183,3,400,217,1,6.0
4682,1311.0,HOT WATER BOTTLE TEA AND SYMPATHY,28,566,6,700,134,1,12.0
4683,1312.0,HOT WATER BOTTLE I AM SO POORLY,24,168,11,1200,1032,1,22.0
4684,1313.0,CHOCOLATE HOT WATER BOTTLE,29,1385,17,1800,415,1,34.0
4685,1314.0,WHITE SKULL HOT WATER BOTTLE ,34,564,25,2600,2036,1,50.0
4686,1315.0,SCOTTIE DOG HOT WATER BOTTLE,12,1433,19,2000,567,1,38.0
4687,1316.0,HAND WARMER RED POLKA DOT,29,848,16,1700,852,1,32.0
4688,1317.0,HAND WARMER UNION JACK,25,1239,15,1600,361,1,30.0
4689,1318.0,HOMEMADE JAM SCENTED CANDLES,29,484,5,600,116,1,10.0
4690,1319.0,BIRD HOUSE HOT WATER BOTTLE,9,193,4,500,307,1,8.0
4691,1320.0,BOUDOIR SQUARE TISSUE BOX,23,303,10,1100,797,1,20.0
4692,1321.0,SKULLS SQUARE TISSUE BOX,3,207,5,600,393,1,10.0
4693,1322.0,PHOTO FRAME CORNICE,18,2083,21,2200,117,1,42.0
4694,1323.0,SILK PURSE BABUSHKA RED,23,2497,24,2500,3,1,48.0
4695,1324.0,PICTURE DOMINOES,23,325,9,1000,675,1,18.0
4696,1325.0,S/6 SEW ON CROCHET FLOWERS,13,527,8,900,373,1,16.0
4697,1326.0,SCANDINAVIAN REDS RIBBONS,32,1975,21,2200,225,1,42.0
4698,1327.0,BALLOONS  WRITING SET ,9,1003,13,1400,397,1,26.0
4699,1328.0,JAM MAKING SET PRINTED,11,1181,16,1700,519,1,32.0
4700,1329.0,LAVENDER INCENSE IN TIN,24,1003,12,1300,297,1,24.0
4701,1330.0,TV DINNER TRAY VINTAGE PAISLEY,18,140,1,200,60,1,2.0
4702,1331.0,SET OF 4 ENGLISH ROSE PLACEMATS,18,2006,20,2100,94,1,40.0
4703,1332.0,SET OF 4 ENGLISH ROSE COASTERS,20,627,11,1200,573,1,22.0
4704,1333.0,TRIPLE PHOTO FRAME CORNICE ,31,372,4,500,128,1,8.0
4705,1334.0,FAMILY PHOTO FRAME CORNICE,22,300,4,500,200,1,8.0
4706,1335.0,MIRRORED DISCO BALL ,9,1312,17,1800,488,1,34.0
4707,1336.0,DISCO BALL ROTATOR BATTERY OPERATED,22,1785,22,2300,515,1,44.0
4708,1337.0,SILVER LOOKING MIRROR,14,134,1,200,66,1,2.0
4709,1338.0,LADIES & GENTLEMEN METAL SIGN,30,500,24,2500,2000,1,48.0
4710,1339.0,METAL SIGN HER DINNER IS SERVED ,17,185,2,300,115,1,4.0
4711,1340.0,YOU'RE CONFUSING ME METAL SIGN ,5,279,3,400,121,1,6.0
4712,1341.0,DOORMAT TOPIARY,9,949,12,1300,351,1,24.0
4713,1342.0,BATHROOM METAL SIGN,7,800,9,1000,200,1,18.0
4714,1343.0,KITCHEN METAL SIGN,1,1313,16,1700,387,1,32.0
4715,1344.0,TOILET METAL SIGN,3,609,11,1200,591,1,22.0
4716,1345.0,METAL SIGN TAKE IT OR LEAVE IT ,15,392,3,400,8,1,6.0
4717,1346.0,I'M ON HOLIDAY METAL SIGN,10,472,17,1800,1328,1,34.0
4718,1347.0,GROW YOUR OWN BASIL IN ENAMEL MUG,19,1295,12,1300,5,1,24.0
4719,1348.0,SET/10 PINK POLKADOT PARTY CANDLES,14,190,3,400,210,1,6.0
4720,1349.0,SET 20 NAPKINS FAIRY CAKES DESIGN ,32,242,4,500,258,1,8.0
4721,1350.0,60 TEATIME FAIRY CAKE CASES,18,909,21,2200,1291,1,42.0
4722,1351.0,SET OF 6 T-LIGHTS SNOWMEN,28,270,2,300,30,1,4.0
4723,1352.0,SET OF 6 T-LIGHTS SANTA,31,968,21,2200,1232,1,42.0
4724,1353.0,SET OF 9 HEART SHAPED BALLOONS,10,1998,24,2500,502,1,48.0
4725,1354.0,SANDWICH BATH SPONGE,32,805,9,1000,195,1,18.0
4726,1355.0,APPLE BATH SPONGE,13,934,15,1600,666,1,30.0
4727,1356.0,STRAWBERRY BATH SPONGE ,22,595,13,1400,805,1,26.0
4728,1357.0,BLACK PIRATE TREASURE CHEST,18,656,9,1000,344,1,18.0
4729,1358.0,STAR PORTABLE TABLE LIGHT ,8,186,10,1100,914,1,20.0
4730,1359.0,SNOWFLAKE PORTABLE TABLE LIGHT ,5,1172,11,1200,28,1,22.0
4731,1360.0,PINK OVAL JEWELLED MIRROR,8,137,1,200,63,1,2.0
4732,1361.0,RETROSPOT CIGAR BOX MATCHES ,8,1221,24,2500,1279,1,48.0
4733,1362.0,COSY HOUR GIANT TUBE MATCHES,11,1283,17,1800,517,1,34.0
4734,1363.0,JAZZ HEARTS PURSE NOTEBOOK,29,580,18,1900,1320,1,36.0
4735,1364.0,LUNCH BAG DOLLY GIRL DESIGN,26,118,1,200,82,1,2.0
4736,1365.0,WHITE HANGING HEART T-LIGHT HOLDER,22,141,2,300,159,1,4.0
4737,1366.0,CANDLEHOLDER PINK HANGING HEART,1,462,24,2500,2038,1,48.0
4738,1367.0,WOOD 2 DRAWER CABINET WHITE FINISH,27,154,25,2600,2446,1,50.0
4739,1368.0,ASSORTED COLOUR MINI CASES,17,342,6,700,358,1,12.0
4740,1369.0,LUNCH BAG RED RETROSPOT,18,666,8,900,234,1,16.0
4741,1370.0,LUNCH BAG SPACEBOY DESIGN ,28,1712,22,2300,588,1,44.0
4742,1371.0,LUNCH BAG WOODLAND,29,963,12,1300,337,1,24.0
4743,1372.0,LUNCH BAG PINK POLKADOT,29,1440,14,1500,60,1,28.0
4744,1373.0,GUMBALL COAT RACK,3,366,6,700,334,1,12.0
4745,1374.0,BLUE NEW BAROQUE CANDLESTICK CANDLE,3,646,14,1500,854,1,28.0
4746,1375.0,PINK NEW BAROQUECANDLESTICK CANDLE,31,166,2,300,134,1,4.0
4747,1376.0,FAIRY CAKE FLANNEL ASSORTED COLOUR,9,1628,21,2200,572,1,42.0
4748,1377.0,BREAD BIN DINER STYLE PINK,35,565,7,800,235,1,14.0
4749,1378.0,JUMBO BAG CHARLIE AND LOLA TOYS,7,1104,16,1700,596,1,32.0
4750,1379.0,TEA TIME TABLE CLOTH,24,521,15,1600,1079,1,30.0
4751,1380.0,ENGLISH ROSE HOT WATER BOTTLE,19,328,11,1200,872,1,22.0
4752,1381.0,ENAMEL FIRE BUCKET CREAM,29,371,8,900,529,1,16.0
4753,1382.0,PICNIC BASKET WICKER SMALL,28,100,0,100,0,1,0.0
4754,1383.0,PAPER CHAIN KIT 50'S CHRISTMAS ,13,522,10,1100,578,1,20.0
4755,1384.0,PAPER CHAIN KIT VINTAGE CHRISTMAS,17,258,6,700,442,1,12.0
4756,1385.0,HOT WATER BOTTLE BABUSHKA ,3,112,5,600,488,1,10.0
4757,1386.0,HAND WARMER BIRD DESIGN,23,883,12,1300,417,1,24.0
4758,1387.0,POSTAGE,2,1108,19,2000,892,1,38.0
4759,1388.0,HEART IVORY TRELLIS SMALL,18,102,5,600,498,1,10.0
4760,1389.0,CLEAR DRAWER KNOB ACRYLIC EDWARDIAN,24,591,21,2200,1609,1,42.0
4761,1390.0,PINK DRAWER KNOB ACRYLIC EDWARDIAN,35,1228,18,1900,672,1,36.0
4762,1391.0,GREEN DRAWER KNOB ACRYLIC EDWARDIAN,30,998,13,1400,402,1,26.0
4763,1392.0,BLUE DRAWER KNOB ACRYLIC EDWARDIAN,35,702,14,1500,798,1,28.0
4764,1393.0,HEART OF WICKER SMALL,15,1766,19,2000,234,1,38.0
4765,1394.0,SMALL POPCORN HOLDER,14,1472,14,1500,28,1,28.0
4766,1395.0,SET 6 FOOTBALL CELEBRATION CANDLES,30,2023,21,2200,177,1,42.0
4767,1396.0,SET OF 6 GIRLS CELEBRATION CANDLES,15,628,6,700,72,1,12.0
4768,1397.0,ROMANTIC PINKS RIBBONS ,4,333,3,400,67,1,6.0
4769,1398.0,BRIGHT BLUES RIBBONS ,30,720,11,1200,480,1,22.0
4770,1399.0,SCANDINAVIAN REDS RIBBONS,7,298,16,1700,1402,1,32.0
4771,1400.0,CHOCOLATE BOX RIBBONS ,18,832,11,1200,368,1,22.0
4772,1401.0,PARTY INVITES FOOTBALL,10,874,9,1000,126,1,18.0
4773,1402.0,PARTY INVITES JAZZ HEARTS,31,752,9,1000,248,1,18.0
4774,1403.0,PARTY INVITES SPACEMAN,6,609,16,1700,1091,1,32.0
4775,1404.0,SET OF 3 BUTTERFLY COOKIE CUTTERS,8,327,25,2600,2273,1,50.0
4776,1405.0,SET OF 3 HEART COOKIE CUTTERS,22,398,3,400,2,1,6.0
4777,1406.0,3 PIECE SPACEBOY COOKIE CUTTER SET,29,390,13,1400,1010,1,26.0
4778,1407.0,PACK OF 72 SKULL CAKE CASES,10,167,23,2400,2233,1,46.0
4779,1408.0,PACK OF 60 SPACEBOY CAKE CASES,9,563,18,1900,1337,1,36.0
4780,1409.0,PACK OF 72 RETROSPOT CAKE CASES,25,585,6,700,115,1,12.0
4781,1410.0,72 SWEETHEART FAIRY CAKE CASES,13,240,4,500,260,1,8.0
4782,1411.0,PACK OF 60 DINOSAUR CAKE CASES,32,1835,20,2100,265,1,40.0
4783,1412.0,LUNCH BAG SUKI  DESIGN ,34,2103,22,2300,197,1,44.0
4784,1413.0,LUNCH BAG CARS BLUE,13,947,10,1100,153,1,20.0
4785,1414.0,LUNCH BAG  BLACK SKULL.,24,300,9,1000,700,1,18.0
4786,1415.0,HEART IVORY TRELLIS LARGE,17,730,9,1000,270,1,18.0
4787,1416.0,SET/5 RED RETROSPOT LID GLASS BOWLS,5,181,6,700,519,1,12.0
4788,1417.0,WHITE HANGING HEART T-LIGHT HOLDER,26,372,13,1400,1028,1,26.0
4789,1418.0,WHITE METAL LANTERN,23,430,12,1300,870,1,24.0
4790,1419.0,CREAM CUPID HEARTS COAT HANGER,3,843,17,1800,957,1,34.0
4791,1420.0,EDWARDIAN PARASOL RED,15,1218,17,1800,582,1,34.0
4792,1421.0,RETRO COFFEE MUGS ASSORTED,21,811,24,2500,1689,1,48.0
4793,1422.0,SAVE THE PLANET MUG,3,1908,23,2400,492,1,46.0
4794,1423.0,VINTAGE BILLBOARD DRINK ME MUG,17,355,23,2400,2045,1,46.0
4795,1424.0,VINTAGE BILLBOARD LOVE/HATE MUG,12,2569,25,2600,31,1,50.0
4796,1425.0,WOOD 2 DRAWER CABINET WHITE FINISH,12,475,12,1300,825,1,24.0
4797,1426.0,WOOD S/3 CABINET ANT WHITE FINISH,9,416,4,500,84,1,8.0
4798,1427.0,WOODEN PICTURE FRAME WHITE FINISH,31,156,1,200,44,1,2.0
4799,1428.0,WOODEN FRAME ANTIQUE WHITE ,11,284,3,400,116,1,6.0
4800,1429.0,KNITTED UNION FLAG HOT WATER BOTTLE,31,588,15,1600,1012,1,30.0
4801,1430.0,RED WOOLLY HOTTIE WHITE HEART.,23,100,0,100,0,1,0.0
4802,1431.0,SET 7 BABUSHKA NESTING BOXES,10,1443,25,2600,1157,1,50.0
4803,1432.0,IVORY EMBROIDERED QUILT ,29,2298,25,2600,302,1,50.0
4804,1433.0,GLASS STAR FROSTED T-LIGHT HOLDER,14,943,9,1000,57,1,18.0
4805,1434.0,HAND WARMER RED POLKA DOT,28,857,10,1100,243,1,20.0
4806,1435.0,HAND WARMER UNION JACK,18,2420,25,2600,180,1,50.0
4807,1436.0,MAGIC DRAWING SLATE DINOSAUR,18,1123,20,2100,977,1,40.0
4808,1437.0,MAGIC DRAWING SLATE BAKE A CAKE ,9,770,7,800,30,1,14.0
4809,1438.0,12 PENCILS TALL TUBE SKULLS,19,1275,21,2200,925,1,42.0
4810,1439.0,CHOCOLATE CALCULATOR,27,802,21,2200,1398,1,42.0
4811,1440.0,RED  HARMONICA IN BOX ,5,531,13,1400,869,1,26.0
4812,1441.0,BLUE HARMONICA IN BOX ,12,1719,24,2500,781,1,48.0
4813,1442.0,SKULLS  WATER TRANSFER TATTOOS ,5,1400,14,1500,100,1,28.0
4814,1443.0,PACK 3 BOXES BIRD PANNETONE ,27,2474,24,2500,26,1,48.0
4815,1444.0,HOT WATER BOTTLE TEA AND SYMPATHY,25,1154,21,2200,1046,1,42.0
4816,1445.0,RED WOOLLY HOTTIE WHITE HEART.,7,784,23,2400,1616,1,46.0
4817,1446.0,WHITE SKULL HOT WATER BOTTLE ,4,283,12,1300,1017,1,24.0
4818,1447.0,3 PIECE SPACEBOY COOKIE CUTTER SET,28,483,7,800,317,1,14.0
4819,1448.0,SET OF 20 KIDS COOKIE CUTTERS,10,421,9,1000,579,1,18.0
4820,1449.0,10 COLOUR SPACEBOY PEN,10,330,13,1400,1070,1,26.0
4821,1450.0,VICTORIAN GLASS HANGING T-LIGHT,5,306,8,900,594,1,16.0
4822,1451.0,SINGLE HEART ZINC T-LIGHT HOLDER,12,428,4,500,72,1,8.0
4823,1452.0,RED HANGING HEART T-LIGHT HOLDER,22,453,23,2400,1947,1,46.0
4824,1453.0,HANGING METAL STAR LANTERN,11,247,2,300,53,1,4.0
4825,1454.0,SILVER HANGING T-LIGHT HOLDER,34,674,10,1100,426,1,20.0
4826,1455.0,DOORMAT RED RETROSPOT,6,628,6,700,72,1,12.0
4827,1456.0,DOORMAT HEARTS,5,1153,21,2200,1047,1,42.0
4828,1457.0,NATURAL SLATE RECTANGLE CHALKBOARD,12,1624,25,2600,976,1,50.0
4829,1458.0,LOVEBIRD HANGING DECORATION WHITE ,22,1068,19,2000,932,1,38.0
4830,1459.0,ASSORTED COLOUR BIRD ORNAMENT,24,340,6,700,360,1,12.0
4831,1460.0,HOME BUILDING BLOCK WORD,12,778,25,2600,1822,1,50.0
4832,1461.0,LOVE BUILDING BLOCK WORD,17,459,7,800,341,1,14.0
4833,1462.0,PHOTO FRAME CORNICE,4,1911,21,2200,289,1,42.0
4834,1463.0,PENS ASSORTED FUNNY FACE,6,252,3,400,148,1,6.0
4835,1464.0,CARD CIRCUS PARADE,34,455,5,600,145,1,10.0
4836,1465.0,WRAP COWBOYS  ,13,408,4,500,92,1,8.0
4837,1466.0,AIRLINE BAG VINTAGE TOKYO 78,15,100,0,100,0,1,0.0
4838,1467.0,RED RETROSPOT UMBRELLA,3,571,23,2400,1829,1,46.0
4839,1468.0,BLACK/BLUE POLKADOT UMBRELLA,24,170,2,300,130,1,4.0
4840,1469.0,RED 3 PIECE RETROSPOT CUTLERY SET,4,610,10,1100,490,1,20.0
4841,1470.0,PACK OF 72 RETROSPOT CAKE CASES,3,808,8,900,92,1,16.0
4842,1471.0,SET OF 72 RETROSPOT PAPER  DOILIES,7,156,2,300,144,1,4.0
4843,1472.0,BLUE COAT RACK PARIS FASHION,1,1328,24,2500,1172,1,48.0
4844,1473.0,PLASTERS IN TIN SKULLS,35,256,8,900,644,1,16.0
4845,1474.0,SLEEPING CAT ERASERS,29,452,4,500,48,1,8.0
4846,1475.0,CARD BIRTHDAY COWBOY,23,2256,25,2600,344,1,50.0
4847,1476.0,PACK 3 BOXES CHRISTMAS PANNETONE,13,421,11,1200,779,1,22.0
4848,1477.0,ROTATING SILVER ANGELS T-LIGHT HLDR,10,437,9,1000,563,1,18.0
4849,1478.0,COSY HOUR GIANT TUBE MATCHES,2,283,6,700,417,1,12.0
4850,1479.0,RIBBON REEL MAKING SNOWMEN ,8,121,1,200,79,1,2.0
4851,1480.0,MINI PAINT SET VINTAGE ,12,274,7,800,526,1,14.0
4852,1481.0,4 TRADITIONAL SPINNING TOPS,21,177,3,400,223,1,6.0
4853,1482.0,SET OF 6 SOLDIER SKITTLES,22,1048,10,1100,52,1,20.0
4854,1483.0,BAG 500g SWIRLY MARBLES,31,1040,20,2100,1060,1,40.0
4855,1484.0,5 STRAND GLASS NECKLACE CRYSTAL,7,726,9,1000,274,1,18.0
4856,1485.0,WHITE SKULL HOT WATER BOTTLE ,21,100,0,100,0,1,0.0
4857,1486.0,SCOTTIE DOG HOT WATER BOTTLE,24,655,11,1200,545,1,22.0
4858,1487.0,SQUARECUSHION COVER PINK UNION FLAG,18,1586,15,1600,14,1,30.0
4859,1488.0,SPACEBOY CHILDRENS EGG CUP,7,253,11,1200,947,1,22.0
4860,1489.0,CHILDREN'S SPACEBOY MUG,33,456,8,900,444,1,16.0
4861,1490.0,HAND WARMER SCOTTY DOG DESIGN,11,102,9,1000,898,1,18.0
4862,1491.0,FELTCRAFT CUSHION OWL,14,1509,24,2500,991,1,48.0
4863,1492.0,BLACK CANDELABRA T-LIGHT HOLDER,32,683,18,1900,1217,1,36.0
4864,1493.0,TOY TIDY DOLLY GIRL DESIGN,27,1086,10,1100,14,1,20.0
4865,1494.0,SET 12 LAVENDER  BOTANICAL T-LIGHTS,16,373,5,600,227,1,10.0
4866,1495.0,UNION JACK FLAG LUGGAGE TAG,14,524,18,1900,1376,1,36.0
4867,1496.0,RED HEART LUGGAGE TAG,29,1549,18,1900,351,1,36.0
4868,1497.0,RED GLASS TASSLE BAG CHARM,33,135,1,200,65,1,2.0
4869,1498.0,CLEAR ACRYLIC FACETED BANGLE,11,868,25,2600,1732,1,50.0
4870,1499.0,5 STRAND GLASS NECKLACE CRYSTAL,19,281,6,700,419,1,12.0
4871,1500.0,DOORMAT UNION JACK GUNS AND ROSES,19,865,12,1300,435,1,24.0
4872,1501.0,VANILLA SCENT CANDLE JEWELLED BOX,11,1148,12,1300,152,1,24.0
4873,1502.0,FULL ENGLISH BREAKFAST PLATE,19,2154,24,2500,346,1,48.0
4874,1503.0,BLACK CANDELABRA T-LIGHT HOLDER,18,184,1,200,16,1,2.0
4875,1504.0,MAGIC DRAWING SLATE CIRCUS PARADE  ,5,1188,23,2400,1212,1,46.0
4876,1505.0,CHRISTMAS HANGING HEART WITH BELL,31,791,14,1500,709,1,28.0
4877,1506.0,CAKE STAND VICTORIAN FILIGREE MED,16,1145,11,1200,55,1,22.0
4878,1507.0,PAISLEY PATTERN  STICKERS,1,100,0,100,0,1,0.0
4879,1508.0,FLOWERS  STICKERS,16,1553,18,1900,347,1,36.0
4880,1509.0,PINK NEW BAROQUECANDLESTICK CANDLE,25,643,9,1000,357,1,18.0
4881,1510.0,BLUE NEW BAROQUE CANDLESTICK CANDLE,5,359,20,2100,1741,1,40.0
4882,1511.0,JUMBO STORAGE BAG SUKI,3,742,12,1300,558,1,24.0
4883,1512.0,BLACK LOVE BIRD CANDLE,4,1275,18,1900,625,1,36.0
4884,1513.0,PARTY TIME PENCIL ERASERS,8,1311,25,2600,1289,1,50.0
4885,1514.0,DISCO BALL CHRISTMAS DECORATION,22,826,13,1400,574,1,26.0
4886,1515.0,PINK B'FLY C/COVER W BOBBLES,13,672,12,1300,628,1,24.0
4887,1516.0,PINK UNION JACK  LUGGAGE TAG,15,120,19,2000,1880,1,38.0
4888,1517.0,6 RIBBONS ELEGANT CHRISTMAS ,22,172,1,200,28,1,2.0
4889,1518.0,UNION JACK FLAG LUGGAGE TAG,35,1866,25,2600,734,1,50.0
4890,1519.0,AGED GLASS SILVER T-LIGHT HOLDER,8,1500,21,2200,700,1,42.0
4891,1520.0,BOOM BOX SPEAKER GIRLS,18,1803,21,2200,397,1,42.0
4892,1521.0,6 RIBBONS SHIMMERING PINKS ,3,122,1,200,78,1,2.0
4893,1522.0, SET 2 TEA TOWELS I LOVE LONDON ,19,488,17,1800,1312,1,34.0
4894,1523.0,JUMBO BAG OWLS,10,639,22,2300,1661,1,44.0
4895,1524.0,SANDWICH BATH SPONGE,11,335,10,1100,765,1,20.0
4896,1525.0,OWL DOORSTOP,21,269,8,900,631,1,16.0
4897,1526.0,5 STRAND GLASS NECKLACE CRYSTAL,31,1379,21,2200,821,1,42.0
4898,1527.0,HAND WARMER UNION JACK,22,171,2,300,129,1,4.0
4899,1528.0,HAND WARMER SCOTTY DOG DESIGN,12,100,0,100,0,1,0.0
4900,1529.0,LARGE POPCORN HOLDER ,17,869,13,1400,531,1,26.0
4901,1530.0,PAINTED METAL STAR WITH HOLLY BELLS,25,143,6,700,557,1,12.0
4902,1531.0,PAINTED METAL HEART WITH HOLLY BELL,33,287,10,1100,813,1,20.0
4903,1532.0,ANGEL DECORATION STARS ON DRESS,28,121,1,200,79,1,2.0
4904,1533.0,SMALL POPCORN HOLDER,14,1179,20,2100,921,1,40.0
4905,1534.0,JUMBO BAG RED RETROSPOT,14,317,18,1900,1583,1,36.0
4906,1535.0,JUMBO BAG STRAWBERRY,10,259,3,400,141,1,6.0
4907,1536.0,STRAWBERRY SHOPPER BAG,8,1419,15,1600,181,1,30.0
4908,1537.0,STRAWBERRY CHARLOTTE BAG,22,200,1,200,0,1,2.0
4909,1538.0, SET 2 TEA TOWELS I LOVE LONDON ,35,126,1,200,74,1,2.0
4910,1539.0,PACK OF 12 RED RETROSPOT TISSUES ,3,454,16,1700,1246,1,32.0
4911,1540.0,SCOTTIE DOG HOT WATER BOTTLE,2,1322,15,1600,278,1,30.0
4912,1541.0,CHOCOLATE HOT WATER BOTTLE,6,1806,19,2000,194,1,38.0
4913,1542.0,LUNCH BAG CARS BLUE,20,1403,17,1800,397,1,34.0
4914,1543.0,LUNCH BAG SPACEBOY DESIGN ,20,344,15,1600,1256,1,30.0
4915,1544.0,ROUND SNACK BOXES SET OF4 WOODLAND ,6,1561,15,1600,39,1,30.0
4916,1545.0,LUNCH BAG DOLLY GIRL DESIGN,31,112,1,200,88,1,2.0
4917,1546.0,LUNCH BAG SUKI  DESIGN ,4,178,9,1000,822,1,18.0
4918,1547.0,LUNCH BAG  BLACK SKULL.,25,1005,23,2400,1395,1,46.0
4919,1548.0,ROUND SNACK BOXES SET OF 4 FRUITS ,31,949,11,1200,251,1,22.0
4920,1549.0,ROUND SNACK BOXES SET OF 4 SKULLS,26,1003,14,1500,497,1,28.0
4921,1550.0,DOLLY GIRL LUNCH BOX,28,594,18,1900,1306,1,36.0
4922,1551.0,SPACEBOY LUNCH BOX ,18,1810,20,2100,290,1,40.0
4923,1552.0,GREEN POLKADOT PLATE ,32,1392,15,1600,208,1,30.0
4924,1553.0,BLUE POLKADOT PLATE ,18,258,7,800,542,1,14.0
4925,1554.0,RED RETROSPOT PLATE ,13,1704,17,1800,96,1,34.0
4926,1555.0,PINK  POLKADOT PLATE ,28,973,10,1100,127,1,20.0
4927,1556.0,ROUND SNACK BOXES SET OF 4 SKULLS,19,197,1,200,3,1,2.0
4928,1557.0,FELTCRAFT DOLL MOLLY,8,486,22,2300,1814,1,44.0
4929,1558.0,FELTCRAFT CHRISTMAS FAIRY,29,302,9,1000,698,1,18.0
4930,1559.0,TRAVEL SEWING KIT,28,362,6,700,338,1,12.0
4931,1560.0,SET OF 3 NOTEBOOKS IN PARCEL,3,100,0,100,0,1,0.0
4932,1561.0,RED RETROSPOT TAPE,28,100,0,100,0,1,0.0
4933,1562.0,COSY SLIPPER SHOES SMALL  RED ,4,939,10,1100,161,1,20.0
4934,1563.0,6 RIBBONS RUSTIC CHARM,30,769,13,1400,631,1,26.0
4935,1564.0,SCANDINAVIAN REDS RIBBONS,2,1792,17,1800,8,1,34.0
4936,1565.0,JAM MAKING SET PRINTED,31,296,14,1500,1204,1,28.0
4937,1566.0,12 DAISY PEGS IN WOOD BOX,22,1362,16,1700,338,1,32.0
4938,1567.0,HOT WATER BOTTLE BABUSHKA ,26,1088,16,1700,612,1,32.0
4939,1568.0,FELTCRAFT PRINCESS CHARLOTTE DOLL,2,899,19,2000,1101,1,38.0
4940,1569.0,FELTCRAFT CHRISTMAS FAIRY,20,952,22,2300,1348,1,44.0
4941,1570.0,FELTCRAFT PRINCESS CHARLOTTE DOLL,13,236,2,300,64,1,4.0
4942,1571.0,6 RIBBONS RUSTIC CHARM,22,201,23,2400,2199,1,46.0
4943,1572.0,COSY SLIPPER SHOES SMALL  RED ,9,1117,25,2600,1483,1,50.0
4944,1573.0,SCANDINAVIAN REDS RIBBONS,33,888,15,1600,712,1,30.0
4945,1574.0,5 HOOK HANGER RED MAGIC TOADSTOOL,6,232,9,1000,768,1,18.0
4946,1575.0,CHRISTMAS CRAFT TREE TOP ANGEL,13,1257,12,1300,43,1,24.0
4947,1576.0,CHRISTMAS CRAFT LITTLE FRIENDS,30,143,4,500,357,1,8.0
4948,1577.0,5 HOOK HANGER RED MAGIC TOADSTOOL,11,555,22,2300,1745,1,44.0
4949,1578.0,6 RIBBONS RUSTIC CHARM,25,1973,20,2100,127,1,40.0
4950,1579.0,12 DAISY PEGS IN WOOD BOX,8,1008,23,2400,1392,1,46.0
4951,1580.0,SET OF 3 NOTEBOOKS IN PARCEL,18,1369,23,2400,1031,1,46.0
4952,1581.0,5 HOOK HANGER MAGIC TOADSTOOL,1,803,14,1500,697,1,28.0
4953,1582.0,SCANDINAVIAN REDS RIBBONS,20,178,4,500,322,1,8.0
4954,1583.0,RED TOADSTOOL LED NIGHT LIGHT,4,589,16,1700,1111,1,32.0
4955,1584.0,5 HOOK HANGER RED MAGIC TOADSTOOL,7,482,7,800,318,1,14.0
4956,1585.0,COSY SLIPPER SHOES SMALL GREEN,24,1406,22,2300,894,1,44.0
4957,1586.0,COSY SLIPPER SHOES SMALL  RED ,29,374,3,400,26,1,6.0
4958,1587.0,FELTCRAFT DOLL ROSIE,14,2373,23,2400,27,1,46.0
4959,1588.0,FELTCRAFT DOLL MOLLY,29,651,7,800,149,1,14.0
4960,1589.0,FELTCRAFT DOLL EMILY,28,1644,16,1700,56,1,32.0
4961,1590.0,FELTCRAFT PRINCESS CHARLOTTE DOLL,35,281,22,2300,2019,1,44.0
4962,1591.0,FELTCRAFT PRINCESS OLIVIA DOLL,8,128,2,300,172,1,4.0
4963,1592.0,REX CASH+CARRY JUMBO SHOPPER,24,2013,25,2600,587,1,50.0
4964,1593.0,FELTCRAFT DOLL MOLLY,34,134,6,700,566,1,12.0
4965,1594.0,FELTCRAFT CUSHION OWL,11,751,21,2200,1449,1,42.0
4966,1595.0,CHRISTMAS CRAFT TREE TOP ANGEL,19,673,12,1300,627,1,24.0
4967,1596.0,CHRISTMAS CRAFT LITTLE FRIENDS,33,532,18,1900,1368,1,36.0
4968,1597.0,FELTCRAFT CUSHION RABBIT,12,145,15,1600,1455,1,30.0
4969,1598.0,FELTCRAFT CUSHION BUTTERFLY,35,300,21,2200,1900,1,42.0
4970,1599.0,12 DAISY PEGS IN WOOD BOX,34,316,4,500,184,1,8.0
4971,1600.0,PAPER CHAIN KIT 50'S CHRISTMAS ,21,1362,16,1700,338,1,32.0
4972,1601.0,FELTCRAFT CUSHION BUTTERFLY,30,615,18,1900,1285,1,36.0
4973,1602.0,12 DAISY PEGS IN WOOD BOX,27,525,9,1000,475,1,18.0
4974,1603.0,ROSE COTTAGE KEEPSAKE BOX ,22,594,25,2600,2006,1,50.0
4975,1604.0,TOTE BAG I LOVE LONDON,7,184,22,2300,2116,1,44.0
4976,1605.0,12 DAISY PEGS IN WOOD BOX,26,1072,11,1200,128,1,22.0
4977,1606.0,TOTE BAG I LOVE LONDON,11,222,3,400,178,1,6.0
4978,1607.0,FOLDING UMBRELLA PINKWHITE POLKADOT,9,448,22,2300,1852,1,44.0
4979,1608.0,FOLDING UMBRELLA CREAM POLKADOT,20,261,20,2100,1839,1,40.0
4980,1609.0,FOLDING UMBRELLA WHITE/RED POLKADOT,34,1106,21,2200,1094,1,42.0
4981,1610.0,SET 10 LIGHTS NIGHT OWL,29,898,11,1200,302,1,22.0
4982,1611.0,SMALL POPCORN HOLDER,12,333,18,1900,1567,1,36.0
4983,1612.0, SET 2 TEA TOWELS I LOVE LONDON ,5,455,4,500,45,1,8.0
4984,1613.0,FOLDING UMBRELLA RED/WHITE POLKADOT,4,276,2,300,24,1,4.0
4985,1614.0,BABUSHKA LIGHTS STRING OF 10,31,1277,23,2400,1123,1,46.0
4986,1615.0,LUNCH BAG RED RETROSPOT,33,485,6,700,215,1,12.0
4987,1616.0,S/4 VALENTINE DECOUPAGE HEART BOX,8,1877,21,2200,323,1,42.0
4988,1617.0,FOLDING UMBRELLA CREAM POLKADOT,17,248,6,700,452,1,12.0
4989,1618.0, SET 2 TEA TOWELS I LOVE LONDON ,14,472,20,2100,1628,1,40.0
4990,1619.0,FOLDING UMBRELLA RED/WHITE POLKADOT,31,833,22,2300,1467,1,44.0
4991,1620.0,SOLDIERS EGG CUP ,1,562,13,1400,838,1,26.0
4992,1621.0,S/4 VALENTINE DECOUPAGE HEART BOX,9,244,5,600,356,1,10.0
4993,1622.0,RED RETROSPOT MINI CASES,20,100,0,100,0,1,0.0
4994,1623.0,,34,666,20,2100,1434,1,40.0
4995,1624.0,60 CAKE CASES VINTAGE CHRISTMAS,7,1971,20,2100,129,1,40.0
4996,1625.0,PAPER CHAIN KIT VINTAGE CHRISTMAS,4,1806,21,2200,394,1,42.0
4997,1626.0,RIBBON REEL CHRISTMAS SOCK BAUBLE,14,287,2,300,13,1,4.0
4998,1627.0,RIBBON REEL SNOWY VILLAGE,33,1353,14,1500,147,1,28.0
4999,1628.0,RIBBON REEL MAKING SNOWMEN ,4,1548,19,2000,452,1,38.0
5000,1629.0,SET OF 20 VINTAGE CHRISTMAS NAPKINS,20,100,0,100,0,1,0.0
5001,1630.0,TURQUOISE CHRISTMAS TREE ,33,1002,13,1400,398,1,26.0
5002,1631.0,RED STAR CARD HOLDER,28,205,16,1700,1495,1,32.0
5003,1632.0,WICKER WREATH SMALL,12,808,12,1300,492,1,24.0
5004,1633.0,HEART OF WICKER LARGE,12,1175,15,1600,425,1,30.0
5005,1634.0,ADVENT CALENDAR GINGHAM SACK,32,1016,21,2200,1184,1,42.0
5006,1635.0,HEART OF WICKER SMALL,10,100,0,100,0,1,0.0
5007,1636.0,FELTCRAFT BUTTERFLY HEARTS,15,946,13,1400,454,1,26.0
5008,1637.0,PARTY CONE CHRISTMAS DECORATION ,35,121,21,2200,2079,1,42.0
5009,1638.0,VINTAGE HEADS AND TAILS CARD GAME ,19,133,1,200,67,1,2.0
5010,1639.0,WICKER STAR ,24,2226,24,2500,274,1,48.0
5011,1640.0,VINTAGE SNAP CARDS,11,477,4,500,23,1,8.0
5012,1641.0,FELTCRAFT 6 FLOWER FRIENDS,33,170,2,300,130,1,4.0
5013,1642.0, SET 2 TEA TOWELS I LOVE LONDON ,35,1274,24,2500,1226,1,48.0
5014,1643.0,JAM MAKING SET PRINTED,35,379,3,400,21,1,6.0
5015,1644.0,BIRD DECORATION RED RETROSPOT,3,1304,14,1500,196,1,28.0
5016,1645.0,CHRISTMAS GINGHAM TREE,17,1846,22,2300,454,1,44.0
5017,1646.0,CHRISTMAS GINGHAM STAR,24,100,0,100,0,1,0.0
5018,1647.0,CHRISTMAS GINGHAM HEART,30,167,9,1000,833,1,18.0
5019,1648.0,PACK OF 12 PINK POLKADOT TISSUES,13,1467,17,1800,333,1,34.0
5020,1649.0,FELTCRAFT PRINCESS LOLA DOLL,1,192,13,1400,1208,1,26.0
5021,1650.0,PACK OF 12 LONDON TISSUES ,34,368,16,1700,1332,1,32.0
5022,1651.0,PURPLE DRAWERKNOB ACRYLIC EDWARDIAN,11,147,17,1800,1653,1,34.0
5023,1652.0,CHILDREN'S APRON DOLLY GIRL ,6,177,1,200,23,1,2.0
5024,1653.0,CHILDRENS APRON SPACEBOY DESIGN,19,122,5,600,478,1,10.0
5025,1654.0,CHRISTMAS LIGHTS 10 SANTAS ,21,1582,22,2300,718,1,44.0
5026,1655.0,CHRISTMAS LIGHTS 10 REINDEER,20,1297,20,2100,803,1,40.0
5027,1656.0,PAPER CHAIN KIT 50'S CHRISTMAS ,31,594,10,1100,506,1,20.0
5028,1657.0,FELTCRAFT CHRISTMAS FAIRY,11,176,4,500,324,1,8.0
5029,1658.0,PACK OF 72 RETROSPOT CAKE CASES,11,881,11,1200,319,1,22.0
5030,1659.0,PACK OF 60 MUSHROOM CAKE CASES,10,262,2,300,38,1,4.0
5031,1660.0,60 CAKE CASES DOLLY GIRL DESIGN,35,2164,23,2400,236,1,46.0
5032,1661.0,PACK OF 60 PINK PAISLEY CAKE CASES,22,1272,21,2200,928,1,42.0
5033,1662.0,HAND WARMER BABUSHKA DESIGN,2,1958,22,2300,342,1,44.0
5034,1663.0,HAND WARMER BIRD DESIGN,33,1231,24,2500,1269,1,48.0
5035,1664.0,HAND WARMER OWL DESIGN,7,1190,20,2100,910,1,40.0
5036,1665.0,HAND WARMER RED RETROSPOT,19,810,11,1200,390,1,22.0
5037,1666.0,SET 12 RETRO WHITE CHALK STICKS,13,967,16,1700,733,1,32.0
5038,1667.0,FELTCRAFT HAIRBAND RED AND BLUE,1,198,1,200,2,1,2.0
5039,1668.0,FELTCRAFT HAIRBAND PINK AND PURPLE,24,441,4,500,59,1,8.0
5040,1669.0,FELTCRAFT HAIRBANDS PINK AND WHITE ,22,1473,22,2300,827,1,44.0
5041,1670.0,TV DINNER TRAY DOLLY GIRL,9,255,25,2600,2345,1,50.0
5042,1671.0,PLASTERS IN TIN VINTAGE PAISLEY ,16,570,23,2400,1830,1,46.0
5043,1672.0,PLASTERS IN TIN SPACEBOY,19,271,13,1400,1129,1,26.0
5044,1673.0,PLASTERS IN TIN WOODLAND ANIMALS,28,731,19,2000,1269,1,38.0
5045,1674.0,MAGIC DRAWING SLATE SPACEBOY ,16,328,8,900,572,1,16.0
5046,1675.0,MAGIC DRAWING SLATE CIRCUS PARADE  ,30,459,6,700,241,1,12.0
5047,1676.0,MAGIC DRAWING SLATE GO TO THE FAIR ,17,434,6,700,266,1,12.0
5048,1677.0,MAGIC DRAWING SLATE DOLLY GIRL ,2,730,22,2300,1570,1,44.0
5049,1678.0,CHARLIE + LOLA RED HOT WATER BOTTLE,3,108,2,300,192,1,4.0
5050,1679.0,HOT WATER BOTTLE BABUSHKA ,32,1165,18,1900,735,1,36.0
5051,1680.0,URBAN BLACK RIBBONS ,33,684,9,1000,316,1,18.0
5052,1681.0,FELTCRAFT PRINCESS CHARLOTTE DOLL,24,124,1,200,76,1,2.0
5053,1682.0,SET OF 6 T-LIGHTS TOADSTOOLS,24,371,5,600,229,1,10.0
5054,1683.0,ROTATING LEAVES T-LIGHT HOLDER,14,208,4,500,292,1,8.0
5055,1684.0,RED  HARMONICA IN BOX ,3,300,9,1000,700,1,18.0
5056,1685.0,CUPCAKE LACE PAPER SET 6,3,276,2,300,24,1,4.0
5057,1686.0,FAMILY PHOTO FRAME CORNICE,21,1766,20,2100,334,1,40.0
5058,1687.0,TRIPLE PHOTO FRAME CORNICE ,21,214,5,600,386,1,10.0
5059,1688.0,WOODEN FRAME ANTIQUE WHITE ,17,117,13,1400,1283,1,26.0
5060,1689.0,WOODEN BOX OF DOMINOES,34,294,3,400,106,1,6.0
5061,1690.0,TRADITIONAL WOODEN CATCH CUP GAME ,3,150,11,1200,1050,1,22.0
5062,1691.0,TRADITIONAL WOODEN SKIPPING ROPE,34,231,7,800,569,1,14.0
5063,1692.0,S/6 WOODEN SKITTLES IN COTTON BAG,15,337,7,800,463,1,14.0
5064,1693.0,RED METAL BEACH SPADE ,14,1779,19,2000,221,1,38.0
5065,1694.0,BOYS VINTAGE TIN SEASIDE BUCKET,18,281,18,1900,1619,1,36.0
5066,1695.0,GIRLS VINTAGE TIN SEASIDE BUCKET,4,554,13,1400,846,1,26.0
5067,1696.0,GREY HEART HOT WATER BOTTLE,30,518,25,2600,2082,1,50.0
5068,1697.0,SCOTTIE DOG HOT WATER BOTTLE,30,238,2,300,62,1,4.0
5069,1698.0,BIRD HOUSE HOT WATER BOTTLE,1,578,22,2300,1722,1,44.0
5070,1699.0,KINGS CHOICE TEA CADDY ,3,297,2,300,3,1,4.0
5071,1700.0,KINGS CHOICE BISCUIT TIN,7,101,10,1100,999,1,20.0
5072,1701.0,METAL SIGN EMPIRE TEA,31,829,20,2100,1271,1,40.0
5073,1702.0,HOMEMADE JAM SCENTED CANDLES,30,648,16,1700,1052,1,32.0
5074,1703.0,SET OF 6 SOLDIER SKITTLES,22,344,20,2100,1756,1,40.0
5075,1704.0,FAWN BLUE HOT WATER BOTTLE,23,682,13,1400,718,1,26.0
5076,1705.0,HAND WARMER RED RETROSPOT,5,1305,15,1600,295,1,30.0
5077,1706.0,HOT WATER BOTTLE BABUSHKA ,30,130,9,1000,870,1,18.0
5078,1707.0,WHITE SKULL HOT WATER BOTTLE ,29,311,25,2600,2289,1,50.0
5079,1708.0,RETROSPOT HEART HOT WATER BOTTLE,8,837,13,1400,563,1,26.0
5080,1709.0,RED WOOLLY HOTTIE WHITE HEART.,25,245,4,500,255,1,8.0
5081,1710.0,SCOTTIE DOG HOT WATER BOTTLE,24,148,1,200,52,1,2.0
5082,1711.0,GREY HEART HOT WATER BOTTLE,4,485,4,500,15,1,8.0
5083,1712.0,HOT WATER BOTTLE BABUSHKA ,22,1475,19,2000,525,1,38.0
5084,1713.0,PACK OF 6 BIRDY GIFT TAGS,14,454,10,1100,646,1,20.0
5085,1714.0,CHILLI LIGHTS,6,2064,24,2500,436,1,48.0
5086,1715.0,PIGGY BANK RETROSPOT ,16,147,1,200,53,1,2.0
5087,1716.0,CERAMIC STRAWBERRY MONEY BOX,12,100,0,100,0,1,0.0
5088,1717.0,CERAMIC STRAWBERRY CAKE MONEY BANK,23,326,5,600,274,1,10.0
5089,1718.0,CERAMIC CHERRY CAKE MONEY BANK,13,879,15,1600,721,1,30.0
5090,1719.0,CERAMIC HEART FAIRY CAKE MONEY BANK,6,845,8,900,55,1,16.0
5091,1720.0,CERAMIC PIRATE CHEST MONEY BANK,22,1469,14,1500,31,1,28.0
5092,1721.0,DOORSTOP RETROSPOT HEART,5,565,11,1200,635,1,22.0
5093,1722.0,GINGHAM HEART  DOORSTOP RED,10,187,1,200,13,1,2.0
5094,1723.0,RETROSPOT BABUSHKA DOORSTOP,12,154,6,700,546,1,12.0
5095,1724.0,SILK PURSE BABUSHKA RED,30,1559,18,1900,341,1,36.0
5096,1725.0,SILK PURSE BABUSHKA PINK,10,307,14,1500,1193,1,28.0
5097,1726.0,FAMILY PHOTO FRAME CORNICE,32,162,2,300,138,1,4.0
5098,1727.0,SWEETHEART WIRE WALL TIDY,30,934,10,1100,166,1,20.0
5099,1728.0,JAM MAKING SET PRINTED,19,848,10,1100,252,1,20.0
5100,1729.0,RED RETROSPOT OVEN GLOVE ,30,293,6,700,407,1,12.0
5101,1730.0,CREAM HEART CARD HOLDER,27,854,12,1300,446,1,24.0
5102,1731.0,NAMASTE SWAGAT INCENSE,26,1729,17,1800,71,1,34.0
5103,1732.0,CERAMIC STRAWBERRY DESIGN MUG,28,355,3,400,45,1,6.0
5104,1733.0,BLACK HEART CARD HOLDER,15,713,12,1300,587,1,24.0
5105,1734.0,CLASSICAL ROSE SMALL VASE,23,289,17,1800,1511,1,34.0
5106,1735.0,HYACINTH BULB T-LIGHT CANDLES,33,1168,13,1400,232,1,26.0
5107,1736.0,CHRISTMAS CRAFT WHITE FAIRY ,1,317,4,500,183,1,8.0
5108,1737.0,CHRISTMAS CRAFT LITTLE FRIENDS,34,331,5,600,269,1,10.0
5109,1738.0,COSY HOUR CIGAR BOX MATCHES ,2,1067,20,2100,1033,1,40.0
5110,1739.0,RED TEA TOWEL CLASSIC DESIGN,6,322,4,500,178,1,8.0
5111,1740.0,HEART FILIGREE DOVE  SMALL,12,1846,23,2400,554,1,46.0
5112,1741.0,RETROSPOT CHILDRENS APRON,25,762,7,800,38,1,14.0
5113,1742.0,COLOURING PENCILS BROWN TUBE,16,1960,19,2000,40,1,38.0
5114,1743.0,4 IVORY DINNER CANDLES SILVER FLOCK,25,1881,23,2400,519,1,46.0
5115,1744.0,HEART FILIGREE DOVE  SMALL,18,533,24,2500,1967,1,48.0
5116,1745.0,ZINC METAL HEART DECORATION,12,964,14,1500,536,1,28.0
5117,1746.0,GREEN FERN NOTEBOOK,15,509,13,1400,891,1,26.0
5118,1747.0,BLUE PAISLEY NOTEBOOK,15,1099,23,2400,1301,1,46.0
5119,1748.0,CHRYSANTHEMUM NOTEBOOK,6,312,3,400,88,1,6.0
5120,1749.0,LARGE CHINESE STYLE SCISSOR,18,1167,11,1200,33,1,22.0
5121,1750.0,SMALL CHINESE STYLE SCISSOR,9,1398,20,2100,702,1,40.0
5122,1751.0,S/6 WOODEN SKITTLES IN COTTON BAG,28,301,3,400,99,1,6.0
5123,1752.0,TRADITIONAL WOODEN SKIPPING ROPE,7,1125,23,2400,1275,1,46.0
5124,1753.0,SET OF 6 SOLDIER SKITTLES,26,101,10,1100,999,1,20.0
5125,1754.0,4 TRADITIONAL SPINNING TOPS,5,142,1,200,58,1,2.0
5126,1755.0,ROTATING SILVER ANGELS T-LIGHT HLDR,30,588,20,2100,1512,1,40.0
5127,1756.0,BLACK LOVE BIRD CANDLE,17,240,20,2100,1860,1,40.0
5128,1757.0,RETROSPOT CHILDRENS APRON,22,910,24,2500,1590,1,48.0
5129,1758.0,HANGING GLASS ETCHED TEALIGHT,34,2120,24,2500,380,1,48.0
5130,1759.0,HANGING GLASS ETCHED TEALIGHT,4,100,0,100,0,1,0.0
5131,1760.0,BLUE NEW BAROQUE CANDLESTICK CANDLE,18,888,17,1800,912,1,34.0
5132,1761.0,COOKING SET RETROSPOT,7,398,14,1500,1102,1,28.0
5133,1762.0,KINGS CHOICE GIANT TUBE MATCHES,26,402,7,800,398,1,14.0
5134,1763.0,COSY HOUR GIANT TUBE MATCHES,14,100,0,100,0,1,0.0
5135,1764.0,PLACE SETTING WHITE STAR,35,712,16,1700,988,1,32.0
5136,1765.0,HYACINTH BULB T-LIGHT CANDLES,22,268,9,1000,732,1,18.0
5137,1766.0,S/15 SILVER GLASS BAUBLES IN BAG,10,588,5,600,12,1,10.0
5138,1767.0,FRENCH WC SIGN BLUE METAL,27,464,22,2300,1836,1,44.0
5139,1768.0,KINGS CHOICE GIANT TUBE MATCHES,15,163,5,600,437,1,10.0
5140,1769.0,72 SWEETHEART FAIRY CAKE CASES,7,643,23,2400,1757,1,46.0
5141,1770.0,ASSORTED COLOUR BIRD ORNAMENT,3,200,1,200,0,1,2.0
5142,1771.0,FAIRY SOAP SOAP HOLDER,34,910,13,1400,490,1,26.0
5143,1772.0,GREEN GIANT GARDEN THERMOMETER,35,1465,18,1900,435,1,36.0
5144,1773.0,IVORY GIANT GARDEN THERMOMETER,7,969,25,2600,1631,1,50.0
5145,1774.0,BLUE GIANT GARDEN THERMOMETER,12,201,2,300,99,1,4.0
5146,1775.0,PACK OF 60 PINK PAISLEY CAKE CASES,7,378,4,500,122,1,8.0
5147,1776.0,RETROSPOT HEART HOT WATER BOTTLE,6,178,2,300,122,1,4.0
5148,1777.0,CHICK GREY HOT WATER BOTTLE,11,1207,18,1900,693,1,36.0
5149,1778.0,VICTORIAN SEWING BOX SMALL ,21,1112,14,1500,388,1,28.0
5150,1779.0,VICTORIAN SEWING BOX MEDIUM,6,279,17,1800,1521,1,34.0
5151,1780.0,SET/10 RED POLKADOT PARTY CANDLES,30,549,23,2400,1851,1,46.0
5152,1781.0,WASHROOM METAL SIGN,17,318,13,1400,1082,1,26.0
5153,1782.0,BLACK SWEETHEART BRACELET,31,480,4,500,20,1,8.0
5154,1783.0,DIAMANTE HAIR GRIP PACK/2 BLACK DIA,17,1431,14,1500,69,1,28.0
5155,1784.0,BLACK DIAMANTE EXPANDABLE RING,3,552,9,1000,448,1,18.0
5156,1785.0,DIAMANTE HAIR GRIP PACK/2 RUBY,7,1480,18,1900,420,1,36.0
5157,1786.0,DIAMANTE HAIR GRIP PACK/2 MONTANA,30,842,8,900,58,1,16.0
5158,1787.0,BLUE SWEETHEART BRACELET,7,827,8,900,73,1,16.0
5159,1788.0,PINK SWEETHEART BRACELET,30,1675,25,2600,925,1,50.0
5160,1789.0,PURPLE SWEETHEART BRACELET,34,100,0,100,0,1,0.0
5161,1790.0,JUMBO BAG PINK POLKADOT,15,129,1,200,71,1,2.0
5162,1791.0,JUMBO BAG RED RETROSPOT,31,1524,15,1600,76,1,30.0
5163,1792.0,ASSORTED COLOUR BIRD ORNAMENT,31,482,7,800,318,1,14.0
5164,1793.0,PAPER CHAIN KIT 50'S CHRISTMAS ,26,1689,16,1700,11,1,32.0
5165,1794.0,RIBBON REEL CHRISTMAS PRESENT ,34,1351,19,2000,649,1,38.0
5166,1795.0,FIRST AID TIN,22,100,0,100,0,1,0.0
5167,1796.0,MAKE YOUR OWN MONSOON CARD KIT,17,147,1,200,53,1,2.0
5168,1797.0,PACK OF 12 HEARTS DESIGN TISSUES ,1,680,12,1300,620,1,24.0
5169,1798.0,PACK OF 12 RED RETROSPOT TISSUES ,9,522,12,1300,778,1,24.0
5170,1799.0,SOLDIERS EGG CUP ,8,253,22,2300,2047,1,44.0
5171,1800.0,HEART IVORY TRELLIS SMALL,3,452,6,700,248,1,12.0
5172,1801.0,HEART FILIGREE DOVE  SMALL,11,257,4,500,243,1,8.0
5173,1802.0,HEART FILIGREE DOVE LARGE,7,382,4,500,118,1,8.0
5174,1803.0,PACK 3 BOXES BIRD PANNETONE ,10,1842,22,2300,458,1,44.0
5175,1804.0,PACK 3 BOXES CHRISTMAS PANNETONE,24,1965,23,2400,435,1,46.0
5176,1805.0,SMALL POPCORN HOLDER,19,100,0,100,0,1,0.0
5177,1806.0,PACK OF 60 PINK PAISLEY CAKE CASES,21,1909,23,2400,491,1,46.0
5178,1807.0,SET OF 6 SOLDIER SKITTLES,31,434,25,2600,2166,1,50.0
5179,1808.0,SWIRLY CIRCULAR RUBBERS IN BAG,6,100,0,100,0,1,0.0
5180,1809.0,VINTAGE PAISLEY STATIONERY SET,24,455,5,600,145,1,10.0
5181,1810.0,PAPER CHAIN KIT VINTAGE CHRISTMAS,33,191,1,200,9,1,2.0
5182,1811.0,SET/10 BLUE POLKADOT PARTY CANDLES,15,1097,11,1200,103,1,22.0
5183,1812.0,RIBBON REEL SOCKS AND MITTENS,27,630,22,2300,1670,1,44.0
5184,1813.0,60 CAKE CASES VINTAGE CHRISTMAS,6,115,1,200,85,1,2.0
5185,1814.0,CHRISTMAS METAL TAGS ASSORTED ,4,186,8,900,714,1,16.0
5186,1815.0,CHRISTMAS TREE T-LIGHT HOLDER,20,769,7,800,31,1,14.0
5187,1816.0,STAR  T-LIGHT HOLDER ,17,866,11,1200,334,1,22.0
5188,1817.0,HEART T-LIGHT HOLDER ,16,452,21,2200,1748,1,42.0
5189,1818.0,MINI FUNKY DESIGN TAPES,9,975,15,1600,625,1,30.0
5190,1819.0,SET OF 6 T-LIGHTS SNOWMEN,23,939,20,2100,1161,1,40.0
5191,1820.0,STAR WOODEN CHRISTMAS DECORATION,30,264,2,300,36,1,4.0
5192,1821.0,WOODEN HEART CHRISTMAS SCANDINAVIAN,22,432,13,1400,968,1,26.0
5193,1822.0,CHRISTMAS RETROSPOT TREE WOOD,6,1651,18,1900,249,1,36.0
5194,1823.0,SET OF 6 T-LIGHTS SANTA,6,173,2,300,127,1,4.0
5195,1824.0,SET/9 CHRISTMAS T-LIGHTS SCENTED ,35,948,24,2500,1552,1,48.0
5196,1825.0,BLUE ROSE FABRIC MIRROR,10,142,6,700,558,1,12.0
5197,1826.0,THREE CANVAS LUGGAGE TAGS,22,1328,17,1800,472,1,34.0
5198,1827.0,RETROSPOT PARTY BAG + STICKER SET,34,1775,20,2100,325,1,40.0
5199,1828.0,PLASTERS IN TIN VINTAGE PAISLEY ,29,710,16,1700,990,1,32.0
5200,1829.0,RETROSPOT SMALL TUBE MATCHES,11,978,18,1900,922,1,36.0
5201,1830.0,HAND WARMER SCOTTY DOG DESIGN,19,296,6,700,404,1,12.0
5202,1831.0,3D CHRISTMAS STAMPS STICKERS ,33,170,7,800,630,1,14.0
5203,1832.0,HAND WARMER SCOTTY DOG DESIGN,9,267,3,400,133,1,6.0
5204,1833.0,HAND WARMER SCOTTY DOG DESIGN,35,107,6,700,593,1,12.0
5205,1834.0,CLOTHES PEGS RETROSPOT PACK 24 ,9,1031,12,1300,269,1,24.0
5206,1835.0,36 FOIL HEART CAKE CASES,15,1088,17,1800,712,1,34.0
5207,1836.0,CHRISTMAS METAL TAGS ASSORTED ,34,2061,25,2600,539,1,50.0
5208,1837.0,PACK OF 6 SWEETIE GIFT BOXES,16,359,14,1500,1141,1,28.0
5209,1838.0,PACK OF 72 RETROSPOT CAKE CASES,7,224,5,600,376,1,10.0
5210,1839.0,PACK OF 72 RETROSPOT CAKE CASES,18,868,15,1600,732,1,30.0
5211,1840.0,PACK OF 6 BIRDY GIFT TAGS,33,2208,23,2400,192,1,46.0
5212,1841.0,SET/10 RED POLKADOT PARTY CANDLES,25,1328,17,1800,472,1,34.0
5213,1842.0,SET/10 PINK POLKADOT PARTY CANDLES,13,1166,14,1500,334,1,28.0
5214,1843.0,SET OF 3 NOTEBOOKS IN PARCEL,17,224,5,600,376,1,10.0
5215,1844.0,STAR  T-LIGHT HOLDER ,29,1475,20,2100,625,1,40.0
5216,1845.0,CINAMMON SET OF 9 T-LIGHTS,17,1019,13,1400,381,1,26.0
5217,1846.0,ORANGE SCENTED SET/9 T-LIGHTS,3,622,6,700,78,1,12.0
5218,1847.0,RIBBON REEL STRIPES DESIGN ,19,833,10,1100,267,1,20.0
5219,1848.0,SET OF 2 TINS JARDIN DE PROVENCE,28,137,10,1100,963,1,20.0
5220,1849.0,MAKE YOUR OWN PLAYTIME CARD KIT,30,651,6,700,49,1,12.0
5221,1850.0,DINOSAURS  WRITING SET ,17,1415,20,2100,685,1,40.0
5222,1851.0,BALLOONS  WRITING SET ,13,472,7,800,328,1,14.0
5223,1852.0,SKULLS WRITING SET ,2,1005,23,2400,1395,1,46.0
5224,1853.0,VINTAGE PAISLEY STATIONERY SET,27,807,12,1300,493,1,24.0
5225,1854.0,COSY SLIPPER SHOES SMALL  RED ,3,437,25,2600,2163,1,50.0
5226,1855.0,DOORMAT BLACK FLOCK ,16,1951,24,2500,549,1,48.0
5227,1856.0,JUMBO  BAG BAROQUE BLACK WHITE,31,233,5,600,367,1,10.0
5228,1857.0,JAM MAKING SET WITH JARS,33,146,2,300,154,1,4.0
5229,1858.0,ORANGE SCENTED SET/9 T-LIGHTS,19,126,1,200,74,1,2.0
5230,1859.0,CINAMMON SET OF 9 T-LIGHTS,34,703,12,1300,597,1,24.0
5231,1860.0,HAND WARMER SCOTTY DOG DESIGN,17,157,2,300,143,1,4.0
5232,1861.0,CHRISTMAS DECOUPAGE CANDLE,2,735,8,900,165,1,16.0
5233,1862.0,HEART T-LIGHT HOLDER ,11,625,7,800,175,1,14.0
5234,1863.0,GROW YOUR OWN BASIL IN ENAMEL MUG,13,287,22,2300,2013,1,44.0
5235,1864.0,OFFICE MUG WARMER POLKADOT,16,140,9,1000,860,1,18.0
5236,1865.0,SMALL POPCORN HOLDER,26,107,3,400,293,1,6.0
5237,1866.0,JUMBO BAG DOLLY GIRL DESIGN,24,1129,21,2200,1071,1,42.0
5238,1867.0,JAM MAKING SET WITH JARS,19,100,0,100,0,1,0.0
5239,1868.0,JAM MAKING SET PRINTED,31,1840,25,2600,760,1,50.0
5240,1869.0,SMALL GLASS HEART TRINKET POT,9,114,3,400,286,1,6.0
5241,1870.0,RED WOOLLY HOTTIE WHITE HEART.,34,225,9,1000,775,1,18.0
5242,1871.0,BLACK RECORD COVER FRAME,24,392,6,700,308,1,12.0
5243,1872.0,"RECORD FRAME 7"" SINGLE SIZE ",20,1106,19,2000,894,1,38.0
5244,1873.0,36 PENCILS TUBE RED RETROSPOT,27,1096,10,1100,4,1,20.0
5245,1874.0,36 PENCILS TUBE WOODLAND,35,105,11,1200,1095,1,22.0
5246,1875.0,SET OF 6 SOLDIER SKITTLES,20,1112,11,1200,88,1,22.0
5247,1876.0,ROCKING HORSE RED CHRISTMAS ,15,134,16,1700,1566,1,32.0
5248,1877.0,CHRISTMAS GINGHAM HEART,28,686,20,2100,1414,1,40.0
5249,1878.0,CHRISTMAS GINGHAM STAR,10,808,14,1500,692,1,28.0
5250,1879.0,HAND WARMER UNION JACK,28,115,2,300,185,1,4.0
5251,1880.0,HAND WARMER RED RETROSPOT,6,419,5,600,181,1,10.0
5252,1881.0,REGENCY CAKESTAND 3 TIER,15,885,8,900,15,1,16.0
5253,1882.0,JUMBO SHOPPER VINTAGE RED PAISLEY,14,640,12,1300,660,1,24.0
5254,1883.0,RIBBON REEL SNOWY VILLAGE,33,1810,21,2200,390,1,42.0
5255,1884.0,VINTAGE UNION JACK BUNTING,7,1214,20,2100,886,1,40.0
5256,1885.0,JAM MAKING SET WITH JARS,3,799,10,1100,301,1,20.0
5257,1886.0,RIBBON REEL STRIPES DESIGN ,26,1283,22,2300,1017,1,44.0
5258,1887.0,RETRO LONGBOARD IRONING BOARD COVER,20,1471,14,1500,29,1,28.0
5259,1888.0,3D DOG PICTURE PLAYING CARDS,6,144,1,200,56,1,2.0
5260,1889.0,RETROSPOT CIGAR BOX MATCHES ,20,689,15,1600,911,1,30.0
5261,1890.0,SET/9 CHRISTMAS T-LIGHTS SCENTED ,28,822,12,1300,478,1,24.0
5262,1891.0,ROTATING SILVER ANGELS T-LIGHT HLDR,25,896,8,900,4,1,16.0
5263,1892.0,ROTATING SILVER ANGELS T-LIGHT HLDR,4,258,22,2300,2042,1,44.0
5264,1893.0,SAVE THE PLANET COTTON TOTE BAG,1,1636,20,2100,464,1,40.0
5265,1894.0,SET OF 20 VINTAGE CHRISTMAS NAPKINS,34,236,3,400,164,1,6.0
5266,1895.0,PAPER BUNTING WHITE LACE,11,778,17,1800,1022,1,34.0
5267,1896.0,GENTLEMAN SHIRT REPAIR KIT ,8,783,16,1700,917,1,32.0
5268,1897.0,CARD I LOVE LONDON ,17,248,5,600,352,1,10.0
5269,1898.0,PAPER CHAIN KIT VINTAGE CHRISTMAS,14,624,6,700,76,1,12.0
5270,1899.0,MIRRORED WALL ART FOXY,15,106,6,700,594,1,12.0
5271,1900.0,MIRRORED WALL ART GENTS,7,116,11,1200,1084,1,22.0
5272,1901.0,AIRLINE BAG VINTAGE JET SET WHITE,5,1486,14,1500,14,1,28.0
5273,1902.0,JAM MAKING SET PRINTED,14,308,7,800,492,1,14.0
5274,1903.0,POTTING SHED SOW 'N' GROW SET,20,800,21,2200,1400,1,42.0
5275,1904.0,BABUSHKA LIGHTS STRING OF 10,27,297,4,500,203,1,8.0
5276,1905.0,REX CASH+CARRY JUMBO SHOPPER,12,534,5,600,66,1,10.0
5277,1906.0,AIRLINE BAG VINTAGE WORLD CHAMPION ,15,603,10,1100,497,1,20.0
5278,1907.0,HAND WARMER BIRD DESIGN,23,1460,18,1900,440,1,36.0
5279,1908.0,CHRISTMAS CRAFT LITTLE FRIENDS,32,237,11,1200,963,1,22.0
5280,1909.0,PINK HEARTS PAPER GARLAND,18,1802,18,1900,98,1,36.0
5281,1910.0,POTTING SHED SEED ENVELOPES,19,1132,15,1600,468,1,30.0
5282,1911.0,HI TEC ALPINE HAND WARMER,5,324,17,1800,1476,1,34.0
5283,1912.0,FELTCRAFT CHRISTMAS FAIRY,5,1483,23,2400,917,1,46.0
5284,1913.0,HI TEC ALPINE HAND WARMER,31,1597,22,2300,703,1,44.0
5285,1914.0,ROTATING SILVER ANGELS T-LIGHT HLDR,14,115,4,500,385,1,8.0
5286,1915.0,3 STRIPEY MICE FELTCRAFT,11,804,8,900,96,1,16.0
5287,1916.0,FELTCRAFT 6 FLOWER FRIENDS,5,1438,22,2300,862,1,44.0
5288,1917.0,CHRISTMAS CRAFT LITTLE FRIENDS,23,1091,13,1400,309,1,26.0
5289,1918.0,VINTAGE UNION JACK CUSHION COVER,29,269,7,800,531,1,14.0
5290,1919.0,POLYESTER FILLER PAD 45x45cm,17,332,20,2100,1768,1,40.0
5291,1920.0,DOLLY GIRL LUNCH BOX,23,189,7,800,611,1,14.0
5292,1921.0,PACK OF 12 LONDON TISSUES ,28,947,22,2300,1353,1,44.0
5293,1922.0,CARD DOLLY GIRL ,22,102,3,400,298,1,6.0
5294,1923.0,CARD BILLBOARD FONT,24,1770,22,2300,530,1,44.0
5295,1924.0,RAINY LADIES BIRTHDAY CARD,31,2289,23,2400,111,1,46.0
5296,1925.0,GREY HEART HOT WATER BOTTLE,18,1325,16,1700,375,1,32.0
5297,1926.0,RED WOOLLY HOTTIE WHITE HEART.,1,699,7,800,101,1,14.0
5298,1927.0,RED WHITE SCARF  HOT WATER BOTTLE,9,737,14,1500,763,1,28.0
5299,1928.0, SET 2 TEA TOWELS I LOVE LONDON ,16,357,20,2100,1743,1,40.0
5300,1929.0,SET OF 2 TEA TOWELS APPLE AND PEARS,16,233,14,1500,1267,1,28.0
5301,1930.0,SET/2 RED RETROSPOT TEA TOWELS ,3,106,16,1700,1594,1,32.0
5302,1931.0,LOVE BUILDING BLOCK WORD,31,1265,16,1700,435,1,32.0
5303,1932.0,HOME BUILDING BLOCK WORD,20,676,18,1900,1224,1,36.0
5304,1933.0,ASSORTED COLOUR BIRD ORNAMENT,23,1343,17,1800,457,1,34.0
5305,1934.0,LANTERN CREAM GAZEBO ,20,1099,25,2600,1501,1,50.0
5306,1935.0,BLUE BIRDHOUSE DECORATION,2,1961,22,2300,339,1,44.0
5307,1936.0,WHITE HANGING HEART T-LIGHT HOLDER,7,167,3,400,233,1,6.0
5308,1937.0,REGENCY CAKESTAND 3 TIER,25,281,15,1600,1319,1,30.0
5309,1938.0,ANTIQUE SILVER TEA GLASS ENGRAVED,4,800,21,2200,1400,1,42.0
5310,1939.0,AGED GLASS SILVER T-LIGHT HOLDER,1,1458,25,2600,1142,1,50.0
5311,1940.0,JAM MAKING SET WITH JARS,18,100,0,100,0,1,0.0
5312,1941.0,HAND WARMER OWL DESIGN,19,881,15,1600,719,1,30.0
5313,1942.0,SET OF 2 WOODEN MARKET CRATES,2,1419,18,1900,481,1,36.0
5314,1943.0,SET OF 6 T-LIGHTS TOADSTOOLS,10,195,2,300,105,1,4.0
5315,1944.0,HAND WARMER UNION JACK,29,664,23,2400,1736,1,46.0
5316,1945.0,HAND WARMER SCOTTY DOG DESIGN,14,327,5,600,273,1,10.0
5317,1946.0,CLASSIC FRENCH STYLE BASKET NATURAL,9,247,12,1300,1053,1,24.0
5318,1947.0,CRAZY DAISY HEART DECORATION,25,481,21,2200,1719,1,42.0
5319,1948.0,GIN + TONIC DIET METAL SIGN,28,1401,20,2100,699,1,40.0
5320,1949.0,IVORY GIANT GARDEN THERMOMETER,15,107,2,300,193,1,4.0
5321,1950.0,CARD HOLDER GINGHAM HEART,14,230,21,2200,1970,1,42.0
5322,1951.0,SMALL STRIPES CHOCOLATE GIFT BAG ,26,281,20,2100,1819,1,40.0
5323,1952.0,S/6 WOODEN SKITTLES IN COTTON BAG,11,407,7,800,393,1,14.0
5324,1953.0,HAND WARMER RED RETROSPOT,16,216,9,1000,784,1,18.0
5325,1954.0,HAND WARMER UNION JACK,26,989,11,1200,211,1,22.0
5326,1955.0,FRENCH WC SIGN BLUE METAL,6,126,2,300,174,1,4.0
5327,1956.0,PINK UNION JACK  LUGGAGE TAG,9,616,25,2600,1984,1,50.0
5328,1957.0,"TRAY, BREAKFAST IN BED",17,1575,19,2000,425,1,38.0
5329,1958.0,PIZZA PLATE IN BOX,30,563,15,1600,1037,1,30.0
5330,1959.0,HEART OF WICKER LARGE,1,153,2,300,147,1,4.0
5331,1960.0,PINK HEART DOTS HOT WATER BOTTLE,34,1646,24,2500,854,1,48.0
5332,1961.0,PLACE SETTING WHITE HEART,19,454,7,800,346,1,14.0
5333,1962.0,SET OF 4 NAPKIN CHARMS LEAVES   ,32,523,17,1800,1277,1,34.0
5334,1963.0,SET OF 4 NAPKIN CHARMS STARS   ,17,2125,25,2600,475,1,50.0
5335,1964.0,SET OF 4 NAPKIN CHARMS CUTLERY,10,893,25,2600,1707,1,50.0
5336,1965.0,CARAVAN SQUARE TISSUE BOX,25,696,9,1000,304,1,18.0
5337,1966.0,PLASTERS IN TIN SKULLS,29,847,23,2400,1553,1,46.0
5338,1967.0,PLASTERS IN TIN SPACEBOY,22,1073,13,1400,327,1,26.0
5339,1968.0,BUTTON BOX ,11,1183,19,2000,817,1,38.0
5340,1969.0,PLASTERS IN TIN VINTAGE PAISLEY ,14,239,2,300,61,1,4.0
5341,1970.0,12 MESSAGE CARDS WITH ENVELOPES,32,597,7,800,203,1,14.0
5342,1971.0,SMALL RED BABUSHKA NOTEBOOK ,22,442,5,600,158,1,10.0
5343,1972.0,CUPCAKE LACE PAPER SET 6,17,245,15,1600,1355,1,30.0
5344,1973.0,PACK 3 BOXES CHRISTMAS PANNETONE,7,1778,17,1800,22,1,34.0
5345,1974.0,HERB MARKER MINT,30,100,0,100,0,1,0.0
5346,1975.0,HERB MARKER ROSEMARY,4,100,0,100,0,1,0.0
5347,1976.0,HERB MARKER BASIL,6,116,12,1300,1184,1,24.0
5348,1977.0,HERB MARKER CHIVES ,26,405,11,1200,795,1,22.0
5349,1978.0,HERB MARKER PARSLEY,33,568,8,900,332,1,16.0
5350,1979.0,HERB MARKER THYME,27,187,1,200,13,1,2.0
5351,1980.0,WHITE HANGING HEART T-LIGHT HOLDER,25,100,0,100,0,1,0.0
5352,1981.0,METAL MERRY CHRISTMAS WREATH,24,176,1,200,24,1,2.0
5353,1982.0,WHITE CHRISTMAS GARLAND STARS TREES,27,456,13,1400,944,1,26.0
5354,1983.0,RETROSPOT SMALL TUBE MATCHES,14,146,7,800,654,1,14.0
5355,1984.0,RETROSPOT GIANT TUBE MATCHES,34,288,2,300,12,1,4.0
5356,1985.0,PLACE SETTING WHITE STAR,26,482,5,600,118,1,10.0
5357,1986.0,GROW YOUR OWN BASIL IN ENAMEL MUG,29,371,12,1300,929,1,24.0
5358,1987.0,36 FOIL STAR CAKE CASES ,12,1792,25,2600,808,1,50.0
5359,1988.0,36 FOIL HEART CAKE CASES,33,193,7,800,607,1,14.0
5360,1989.0,PACK OF 6 SWEETIE GIFT BOXES,9,1302,15,1600,298,1,30.0
5361,1990.0,PACK OF 6 HANDBAG GIFT BOXES,17,451,6,700,249,1,12.0
5362,1991.0,GARLAND WOODEN HAPPY EASTER,17,1118,12,1300,182,1,24.0
5363,1992.0,CALENDAR PAPER CUT DESIGN,21,672,11,1200,528,1,22.0
5364,1993.0,CALENDAR IN SEASON DESIGN,14,254,22,2300,2046,1,44.0
5365,1994.0,SMALL POPCORN HOLDER,8,896,9,1000,104,1,18.0
5366,1995.0,BLUE PAISLEY TISSUE BOX,34,686,11,1200,514,1,22.0
5367,1996.0,HEART OF WICKER SMALL,16,2447,25,2600,153,1,50.0
5368,1997.0,SKULLS SQUARE TISSUE BOX,9,521,24,2500,1979,1,48.0
5369,1998.0,SKULLS SQUARE TISSUE BOX,15,430,4,500,70,1,8.0
5370,1999.0,WHITE HANGING HEART T-LIGHT HOLDER,5,692,10,1100,408,1,20.0
5371,2000.0,WHITE METAL LANTERN,9,1521,25,2600,1079,1,50.0
5372,2001.0,CREAM CUPID HEARTS COAT HANGER,1,106,8,900,794,1,16.0
5373,2002.0,KNITTED UNION FLAG HOT WATER BOTTLE,4,284,18,1900,1616,1,36.0
5374,2003.0,RED WOOLLY HOTTIE WHITE HEART.,10,396,10,1100,704,1,20.0
5375,2004.0,SET 7 BABUSHKA NESTING BOXES,4,100,0,100,0,1,0.0
5376,2005.0,GLASS STAR FROSTED T-LIGHT HOLDER,7,179,2,300,121,1,4.0
5377,2006.0,HAND WARMER UNION JACK,1,2571,25,2600,29,1,50.0
5378,2007.0,HAND WARMER RED POLKA DOT,4,669,12,1300,631,1,24.0
5379,2008.0,ASSORTED COLOUR BIRD ORNAMENT,9,100,0,100,0,1,0.0
5380,2009.0,POPPY'S PLAYHOUSE BEDROOM ,8,337,10,1100,763,1,20.0
5381,2010.0,POPPY'S PLAYHOUSE KITCHEN,4,2132,22,2300,168,1,44.0
5382,2011.0,FELTCRAFT PRINCESS CHARLOTTE DOLL,9,224,16,1700,1476,1,32.0
5383,2012.0,IVORY KNITTED MUG COSY ,10,2554,25,2600,46,1,50.0
5384,2013.0,BOX OF 6 ASSORTED COLOUR TEASPOONS,9,194,1,200,6,1,2.0
5385,2014.0,BOX OF VINTAGE JIGSAW BLOCKS ,6,1633,20,2100,467,1,40.0
5386,2015.0,BOX OF VINTAGE ALPHABET BLOCKS,6,259,5,600,341,1,10.0
5387,2016.0,HOME BUILDING BLOCK WORD,7,1087,10,1100,13,1,20.0
5388,2017.0,LOVE BUILDING BLOCK WORD,7,213,7,800,587,1,14.0
5389,2018.0,RECIPE BOX WITH METAL HEART,7,335,3,400,65,1,6.0
5390,2019.0,DOORMAT NEW ENGLAND,10,1284,13,1400,116,1,26.0
5391,2020.0,JAM MAKING SET WITH JARS,3,474,17,1800,1326,1,34.0
5392,2021.0,RED COAT RACK PARIS FASHION,3,923,9,1000,77,1,18.0
5393,2022.0,YELLOW COAT RACK PARIS FASHION,5,423,21,2200,1777,1,42.0
5394,2023.0,BLUE COAT RACK PARIS FASHION,3,932,15,1600,668,1,30.0
5395,2024.0,BATH BUILDING BLOCK WORD,5,228,2,300,72,1,4.0
5396,2025.0,ALARM CLOCK BAKELIKE PINK,1,559,16,1700,1141,1,32.0
5397,2026.0,ALARM CLOCK BAKELIKE RED ,6,405,6,700,295,1,12.0
5398,2027.0,ALARM CLOCK BAKELIKE GREEN,8,745,22,2300,1555,1,44.0
5399,2028.0,PANDA AND BUNNIES STICKER SHEET,9,208,4,500,292,1,8.0
5400,2029.0,STARS GIFT TAPE ,6,1138,13,1400,262,1,26.0
5401,2030.0,INFLATABLE POLITICAL GLOBE ,5,201,24,2500,2299,1,48.0
5402,2031.0,VINTAGE HEADS AND TAILS CARD GAME ,6,486,4,500,14,1,8.0
5403,2032.0,SET/2 RED RETROSPOT TEA TOWELS ,1,597,23,2400,1803,1,46.0
5404,2033.0,ROUND SNACK BOXES SET OF4 WOODLAND ,9,1575,19,2000,425,1,38.0
5405,2034.0,SPACEBOY LUNCH BOX ,2,204,4,500,296,1,8.0
5406,2035.0,LUNCH BOX I LOVE LONDON,4,505,5,600,95,1,10.0
5407,2036.0,CIRCUS PARADE LUNCH BOX ,6,1250,21,2200,950,1,42.0
5408,2037.0,CHARLOTTE BAG DOLLY GIRL DESIGN,4,175,8,900,725,1,16.0
5409,2038.0,RED TOADSTOOL LED NIGHT LIGHT,5,392,16,1700,1308,1,32.0
5410,2039.0, SET 2 TEA TOWELS I LOVE LONDON ,1,1480,17,1800,320,1,34.0
5411,2040.0,VINTAGE SEASIDE JIGSAW PUZZLES,8,109,7,800,691,1,14.0
5412,2041.0,MINI JIGSAW CIRCUS PARADE ,5,904,17,1800,896,1,34.0
5413,2042.0,MINI JIGSAW SPACEBOY,1,1944,23,2400,456,1,46.0
5414,2043.0,MINI PAINT SET VINTAGE ,10,128,1,200,72,1,2.0
5415,2044.0,POSTAGE,5,179,2,300,121,1,4.0
5416,2045.0,PAPER CHAIN KIT 50'S CHRISTMAS ,4,283,5,600,317,1,10.0
5417,2046.0,HAND WARMER RED POLKA DOT,6,384,3,400,16,1,6.0
5418,2047.0,HAND WARMER UNION JACK,10,591,9,1000,409,1,18.0
5419,2048.0,WHITE HANGING HEART T-LIGHT HOLDER,8,202,23,2400,2198,1,46.0
5420,2049.0,WHITE METAL LANTERN,7,696,25,2600,1904,1,50.0
5421,2050.0,CREAM CUPID HEARTS COAT HANGER,7,963,24,2500,1537,1,48.0
5422,2051.0,EDWARDIAN PARASOL RED,9,515,7,800,285,1,14.0
5423,2052.0,RETRO COFFEE MUGS ASSORTED,8,2205,25,2600,395,1,50.0
5424,2053.0,SAVE THE PLANET MUG,9,681,15,1600,919,1,30.0
5425,2054.0,VINTAGE BILLBOARD DRINK ME MUG,4,560,19,2000,1440,1,38.0
5426,2055.0,VINTAGE BILLBOARD LOVE/HATE MUG,10,1560,16,1700,140,1,32.0
5427,2056.0,WOOD 2 DRAWER CABINET WHITE FINISH,3,1627,22,2300,673,1,44.0
5428,2057.0,WOOD S/3 CABINET ANT WHITE FINISH,6,576,15,1600,1024,1,30.0
5429,2058.0,WOODEN PICTURE FRAME WHITE FINISH,1,111,22,2300,2189,1,44.0
5430,2059.0,WOODEN FRAME ANTIQUE WHITE ,6,533,5,600,67,1,10.0
5431,2060.0,KNITTED UNION FLAG HOT WATER BOTTLE,9,344,3,400,56,1,6.0
5432,2061.0,RED WOOLLY HOTTIE WHITE HEART.,3,1033,23,2400,1367,1,46.0
5433,2062.0,SET 7 BABUSHKA NESTING BOXES,7,840,15,1600,760,1,30.0
5434,2063.0,GLASS STAR FROSTED T-LIGHT HOLDER,9,444,13,1400,956,1,26.0
5435,2064.0,VICTORIAN SEWING BOX LARGE,8,426,9,1000,574,1,18.0
5436,2065.0,WHITE HANGING HEART T-LIGHT HOLDER,2,667,18,1900,1233,1,36.0
5437,2066.0,WHITE METAL LANTERN,6,363,4,500,137,1,8.0
5438,2067.0,CREAM CUPID HEARTS COAT HANGER,4,114,11,1200,1086,1,22.0
5439,2068.0,EDWARDIAN PARASOL RED,9,232,10,1100,868,1,20.0
5440,2069.0,RETRO COFFEE MUGS ASSORTED,7,1326,24,2500,1174,1,48.0
5441,2070.0,SAVE THE PLANET MUG,5,100,0,100,0,1,0.0
5442,2071.0,VINTAGE BILLBOARD DRINK ME MUG,3,143,8,900,757,1,16.0
5443,2072.0,VINTAGE BILLBOARD LOVE/HATE MUG,7,1466,17,1800,334,1,34.0
5444,2073.0,WOOD 2 DRAWER CABINET WHITE FINISH,9,809,10,1100,291,1,20.0
5445,2074.0,WOOD S/3 CABINET ANT WHITE FINISH,9,755,11,1200,445,1,22.0
5446,2075.0,WOODEN PICTURE FRAME WHITE FINISH,4,539,6,700,161,1,12.0
5447,2076.0,WOODEN FRAME ANTIQUE WHITE ,10,848,11,1200,352,1,22.0
5448,2077.0,KNITTED UNION FLAG HOT WATER BOTTLE,4,215,8,900,685,1,16.0
5449,2078.0,RED WOOLLY HOTTIE WHITE HEART.,8,202,5,600,398,1,10.0
5450,2079.0,SET 7 BABUSHKA NESTING BOXES,5,1083,24,2500,1417,1,48.0
5451,2080.0,GLASS STAR FROSTED T-LIGHT HOLDER,6,759,8,900,141,1,16.0
5452,2081.0,HOT WATER BOTTLE TEA AND SYMPATHY,6,1066,21,2200,1134,1,42.0
5453,2082.0,RED HANGING HEART T-LIGHT HOLDER,7,1067,11,1200,133,1,22.0
5454,2083.0,HAND WARMER RED POLKA DOT,3,364,10,1100,736,1,20.0
5455,2084.0,HAND WARMER UNION JACK,3,409,17,1800,1391,1,34.0
5456,2085.0,JUMBO BAG PINK POLKADOT,3,435,10,1100,665,1,20.0
5457,2086.0,JUMBO  BAG BAROQUE BLACK WHITE,8,208,2,300,92,1,4.0
5458,2087.0,JUMBO BAG CHARLIE AND LOLA TOYS,8,160,2,300,140,1,4.0
5459,2088.0,STRAWBERRY CHARLOTTE BAG,10,100,0,100,0,1,0.0
5460,2089.0,RED 3 PIECE RETROSPOT CUTLERY SET,1,1034,23,2400,1366,1,46.0
5461,2090.0,BLUE 3 PIECE POLKADOT CUTLERY SET,3,434,6,700,266,1,12.0
5462,2091.0,SET/6 RED SPOTTY PAPER PLATES,5,305,10,1100,795,1,20.0
5463,2092.0,LUNCH BAG RED RETROSPOT,10,609,10,1100,491,1,20.0
5464,2093.0,STRAWBERRY LUNCH BOX WITH CUTLERY,9,1172,13,1400,228,1,26.0
5465,2094.0,LUNCH BOX WITH CUTLERY RETROSPOT ,9,1393,14,1500,107,1,28.0
5466,2095.0,PACK OF 72 RETROSPOT CAKE CASES,9,1497,17,1800,303,1,34.0
5467,2096.0,PACK OF 60 DINOSAUR CAKE CASES,2,281,9,1000,719,1,18.0
5468,2097.0,PACK OF 60 PINK PAISLEY CAKE CASES,10,163,2,300,137,1,4.0
5469,2098.0,61 TEATIME FAIRY CAKE CASES,2,1159,14,1500,341,1,28.0
5470,2099.0,TOMATO CHARLIE+LOLA COASTER SET,2,1252,16,1700,448,1,32.0
5471,2100.0,CHARLIE & LOLA WASTEPAPER BIN FLORA,8,890,23,2400,1510,1,46.0
5472,2101.0,RED CHARLIE+LOLA PERSONAL DOORSIGN,2,289,5,600,311,1,10.0
5473,2102.0,JUMBO STORAGE BAG SUKI,10,728,8,900,172,1,16.0
5474,2103.0,JUMBO BAG PINK VINTAGE PAISLEY,4,2026,21,2200,174,1,42.0
5475,2104.0,JAM MAKING SET PRINTED,3,444,15,1600,1156,1,30.0
5476,2105.0,RETROSPOT TEA SET CERAMIC 11 PC ,3,169,2,300,131,1,4.0
5477,2106.0,GIRLY PINK TOOL SET,6,1180,14,1500,320,1,28.0
5478,2107.0,JUMBO SHOPPER VINTAGE RED PAISLEY,3,919,15,1600,681,1,30.0
5479,2108.0,"AIRLINE LOUNGE,METAL SIGN",5,1945,24,2500,555,1,48.0
5480,2109.0,WHITE SPOT RED CERAMIC DRAWER KNOB,10,487,13,1400,913,1,26.0
5481,2110.0,RED DRAWER KNOB ACRYLIC EDWARDIAN,9,529,20,2100,1571,1,40.0
5482,2111.0,CLEAR DRAWER KNOB ACRYLIC EDWARDIAN,2,758,15,1600,842,1,30.0
5483,2112.0,PHOTO CLIP LINE,4,1110,18,1900,790,1,36.0
5484,2113.0,FELT EGG COSY CHICKEN,1,167,22,2300,2133,1,44.0
5485,2114.0,PIGGY BANK RETROSPOT ,2,1799,24,2500,701,1,48.0
5486,2115.0,SKULL SHOULDER BAG,6,230,12,1300,1070,1,24.0
5487,2116.0,YOU'RE CONFUSING ME METAL SIGN ,1,601,11,1200,599,1,22.0
5488,2117.0,COOK WITH WINE METAL SIGN ,5,101,1,200,99,1,2.0
5489,2118.0,GIN + TONIC DIET METAL SIGN,1,344,3,400,56,1,6.0
5490,2119.0,YELLOW BREAKFAST CUP AND SAUCER,2,1442,22,2300,858,1,44.0
5491,2120.0,PINK BREAKFAST CUP AND SAUCER ,5,789,7,800,11,1,14.0
5492,2121.0,PAPER CHAIN KIT 50'S CHRISTMAS ,10,1719,24,2500,781,1,48.0
5493,2122.0,PAPER CHAIN KIT RETROSPOT,9,556,25,2600,2044,1,50.0
5494,2123.0,SMALL HEART FLOWERS HOOK ,8,438,4,500,62,1,8.0
5495,2124.0,PHOTO CLIP LINE,6,538,6,700,162,1,12.0
5496,2125.0,TEA TIME DES TEA COSY,8,462,7,800,338,1,14.0
5497,2126.0,FELT EGG COSY WHITE RABBIT ,5,144,14,1500,1356,1,28.0
5498,2127.0,ZINC WILLIE WINKIE  CANDLE STICK,10,1892,23,2400,508,1,46.0
5499,2128.0,CERAMIC CHERRY CAKE MONEY BANK,9,876,18,1900,1024,1,36.0
5500,2129.0,RETROSPOT LARGE MILK JUG,7,1340,21,2200,860,1,42.0
5501,2130.0,SET OF 6 FUNKY BEAKERS,4,491,7,800,309,1,14.0
5502,2131.0,EDWARDIAN PARASOL BLACK,10,1091,16,1700,609,1,32.0
5503,2132.0,EDWARDIAN PARASOL NATURAL,5,312,9,1000,688,1,18.0
5504,2133.0,CERAMIC STRAWBERRY CAKE MONEY BANK,3,1078,18,1900,822,1,36.0
5505,2134.0,BLUE OWL SOFT TOY,3,426,10,1100,674,1,20.0
5506,2135.0,BALLOON ART MAKE YOUR OWN FLOWERS,8,232,7,800,568,1,14.0
5507,2136.0,RED TOADSTOOL LED NIGHT LIGHT,2,1006,12,1300,294,1,24.0
5508,2137.0,GLASS CLOCHE SMALL,6,1704,25,2600,896,1,50.0
5509,2138.0,GUMBALL MONOCHROME COAT RACK,8,174,5,600,426,1,10.0
5510,2139.0,DOORMAT FANCY FONT HOME SWEET HOME,6,130,15,1600,1470,1,30.0
5511,2140.0,Discount,10,701,11,1200,499,1,22.0
5512,2141.0,INFLATABLE POLITICAL GLOBE ,5,162,9,1000,838,1,18.0
5513,2142.0,VINTAGE SNAKES & LADDERS,2,851,23,2400,1549,1,46.0
5514,2143.0,CHOCOLATE CALCULATOR,7,1410,18,1900,490,1,36.0
5515,2144.0,JUMBO SHOPPER VINTAGE RED PAISLEY,1,1280,25,2600,1320,1,50.0
5516,2145.0,RECYCLING BAG RETROSPOT ,3,478,24,2500,2022,1,48.0
5517,2146.0,TOY TIDY PINK POLKADOT,8,128,8,900,772,1,16.0
5518,2147.0,ANTIQUE GLASS DRESSING TABLE POT,2,446,4,500,54,1,8.0
5519,2148.0,ALARM CLOCK BAKELIKE GREEN,8,868,12,1300,432,1,24.0
5520,2149.0,IVORY GIANT GARDEN THERMOMETER,2,756,22,2300,1544,1,44.0
5521,2150.0,4 TIER CAKE TIN GREEN AND CREAM,4,1893,23,2400,507,1,46.0
5522,2151.0,4 TIER CAKE TIN RED AND CREAM,6,166,1,200,34,1,2.0
5523,2152.0,SET 3 WICKER OVAL BASKETS W LIDS,7,114,1,200,86,1,2.0
5524,2153.0,SET OF 3 COLOURED  FLYING DUCKS,8,214,8,900,686,1,16.0
5525,2154.0,WOOD BLACK BOARD ANT WHITE FINISH,7,623,9,1000,377,1,18.0
5526,2155.0,COLOUR GLASS T-LIGHT HOLDER HANGING,3,134,19,2000,1866,1,38.0
5527,2156.0,HANGING METAL HEART LANTERN,8,828,16,1700,872,1,32.0
5528,2157.0,HANGING MEDINA LANTERN SMALL,3,1393,13,1400,7,1,26.0
5529,2158.0,NATURAL SLATE HEART CHALKBOARD ,8,100,0,100,0,1,0.0
5530,2159.0,HEART OF WICKER SMALL,9,215,2,300,85,1,4.0
5531,2160.0,HEART OF WICKER LARGE,6,1628,16,1700,72,1,32.0
5532,2161.0,WHITE LOVEBIRD LANTERN,1,476,25,2600,2124,1,50.0
5533,2162.0,CLASSIC METAL BIRDCAGE PLANT HOLDER,2,513,19,2000,1487,1,38.0
5534,2163.0,CREAM HEART CARD HOLDER,3,861,19,2000,1139,1,38.0
5535,2164.0,ENAMEL FLOWER JUG CREAM,5,380,4,500,120,1,8.0
5536,2165.0,ENAMEL FIRE BUCKET CREAM,10,455,18,1900,1445,1,36.0
5537,2166.0,ENAMEL BREAD BIN CREAM,2,1156,22,2300,1144,1,44.0
5538,2167.0,SET 3 WICKER OVAL BASKETS W LIDS,5,970,20,2100,1130,1,40.0
5539,2168.0,JAM MAKING SET PRINTED,3,1138,20,2100,962,1,40.0
5540,2169.0,JAM MAKING SET WITH JARS,8,1453,21,2200,747,1,42.0
5541,2170.0,JUMBO BAG DOLLY GIRL DESIGN,9,2127,24,2500,373,1,48.0
5542,2171.0,TRADITIONAL CHRISTMAS RIBBONS,6,615,25,2600,1985,1,50.0
5543,2172.0,ORGANISER WOOD ANTIQUE WHITE ,1,381,15,1600,1219,1,30.0
5544,2173.0,LUNCH BAG DOLLY GIRL DESIGN,4,112,16,1700,1588,1,32.0
5545,2174.0,WHITE WIRE EGG HOLDER,5,838,24,2500,1662,1,48.0
5546,2175.0,JUMBO  BAG BAROQUE BLACK WHITE,5,137,10,1100,963,1,20.0
5547,2176.0,JUMBO BAG RED RETROSPOT,10,1420,24,2500,1080,1,48.0
5548,2177.0,CHILLI LIGHTS,3,331,3,400,69,1,6.0
5549,2178.0,LIGHT GARLAND BUTTERFILES PINK,8,553,7,800,247,1,14.0
5550,2179.0,WOODEN OWLS LIGHT GARLAND ,8,854,15,1600,746,1,30.0
5551,2180.0,FAIRY TALE COTTAGE NIGHTLIGHT,4,951,19,2000,1049,1,38.0
5552,2181.0,RED TOADSTOOL LED NIGHT LIGHT,6,583,7,800,217,1,14.0
5553,2182.0,HOME BUILDING BLOCK WORD,9,137,1,200,63,1,2.0
5554,2183.0,LOVE BUILDING BLOCK WORD,7,110,4,500,390,1,8.0
5555,2184.0,DOORMAT FANCY FONT HOME SWEET HOME,7,342,6,700,358,1,12.0
5556,2185.0,HOME SMALL WOOD LETTERS,1,100,0,100,0,1,0.0
5557,2186.0,GINGHAM HEART  DOORSTOP RED,8,115,8,900,785,1,16.0
5558,2187.0,FIVE HEART HANGING DECORATION,10,1323,19,2000,677,1,38.0
5559,2188.0,HANGING METAL HEART LANTERN,10,250,2,300,50,1,4.0
5560,2189.0,ASSORTED BOTTLE TOP  MAGNETS ,5,170,17,1800,1630,1,34.0
5561,2190.0,FRIDGE MAGNETS US DINER ASSORTED,3,925,19,2000,1075,1,38.0
5562,2191.0,HOMEMADE JAM SCENTED CANDLES,7,147,1,200,53,1,2.0
5563,2192.0,FRIDGE MAGNETS LES ENFANTS ASSORTED,6,287,2,300,13,1,4.0
5564,2193.0,ROSE CARAVAN DOORSTOP,2,519,16,1700,1181,1,32.0
5565,2194.0,HEART OF WICKER SMALL,1,171,18,1900,1729,1,36.0
5566,2195.0,6 HOOK HANGER MAGIC TOADSTOOL,3,181,5,600,419,1,10.0
5567,2196.0,CHRISTMAS LIGHTS 10 REINDEER,2,627,8,900,273,1,16.0
5568,2197.0,VINTAGE UNION JACK CUSHION COVER,8,619,13,1400,781,1,26.0
5569,2198.0,VINTAGE HEADS AND TAILS CARD GAME ,4,100,0,100,0,1,0.0
5570,2199.0,SET OF 3 COLOURED  FLYING DUCKS,5,152,2,300,148,1,4.0
5571,2200.0,SET OF 3 GOLD FLYING DUCKS,1,593,11,1200,607,1,22.0
5572,2201.0,RED RETROSPOT UMBRELLA,4,1148,17,1800,652,1,34.0
5573,2202.0,BLACK/BLUE POLKADOT UMBRELLA,1,100,5,600,500,1,10.0
5574,2203.0,RED DINER WALL CLOCK,2,160,7,800,640,1,14.0
5575,2204.0,ALARM CLOCK BAKELIKE GREEN,7,1088,23,2400,1312,1,46.0
5576,2205.0,ALARM CLOCK BAKELIKE RED ,6,466,10,1100,634,1,20.0
5577,2206.0,BLUE DINER WALL CLOCK,9,111,5,600,489,1,10.0
5578,2207.0,IVORY DINER WALL CLOCK,2,331,18,1900,1569,1,36.0
5579,2208.0,LARGE HEART MEASURING SPOONS,10,1300,16,1700,400,1,32.0
5580,2209.0,SMALL HEART MEASURING SPOONS,5,364,9,1000,636,1,18.0
5581,2210.0,CHRISTMAS LIGHTS 10 REINDEER,4,684,14,1500,816,1,28.0
5582,2211.0,JAM MAKING SET WITH JARS,9,383,12,1300,917,1,24.0
5583,2212.0,JAM MAKING SET PRINTED,3,471,7,800,329,1,14.0
5584,2213.0,JAM JAR WITH PINK LID,5,556,25,2600,2044,1,50.0
5585,2214.0,JAM JAR WITH GREEN LID,9,210,2,300,90,1,4.0
5586,2215.0,ROSE COTTAGE KEEPSAKE BOX ,5,1239,12,1300,61,1,24.0
5587,2216.0,HANGING HEART ZINC T-LIGHT HOLDER,10,167,4,500,333,1,8.0
5588,2217.0,PAPER CHAIN KIT VINTAGE CHRISTMAS,6,113,1,200,87,1,2.0
5589,2218.0,DISCO BALL CHRISTMAS DECORATION,5,100,0,100,0,1,0.0
5590,2219.0,WHITE HANGING HEART T-LIGHT HOLDER,10,625,20,2100,1475,1,40.0
5591,2220.0,SMALL POPCORN HOLDER,10,390,23,2400,2010,1,46.0
5592,2221.0,LARGE POPCORN HOLDER ,3,412,5,600,188,1,10.0
5593,2222.0,RETROSPOT LARGE MILK JUG,10,291,8,900,609,1,16.0
5594,2223.0,SET/20 RED RETROSPOT PAPER NAPKINS ,4,1623,23,2400,777,1,46.0
5595,2224.0,SET/6 RED SPOTTY PAPER PLATES,5,633,9,1000,367,1,18.0
5596,2225.0,SET/6 RED SPOTTY PAPER CUPS,6,732,16,1700,968,1,32.0
5597,2226.0,POLKADOT RAIN HAT ,1,1719,21,2200,481,1,42.0
5598,2227.0,DELUXE SEWING KIT ,8,2258,22,2300,42,1,44.0
5599,2228.0,RETROSPOT HEART HOT WATER BOTTLE,9,116,2,300,184,1,4.0
5600,2229.0,KNITTED UNION FLAG HOT WATER BOTTLE,1,111,1,200,89,1,2.0
5601,2230.0,ENGLISH ROSE HOT WATER BOTTLE,9,100,0,100,0,1,0.0
5602,2231.0,PHOTO CUBE,3,697,16,1700,1003,1,32.0
5603,2232.0,HOMEMADE JAM SCENTED CANDLES,4,1915,19,2000,85,1,38.0
5604,2233.0,JUMBO BAG RED RETROSPOT,8,271,25,2600,2329,1,50.0
5605,2234.0,PLASTERS IN TIN CIRCUS PARADE ,3,1524,17,1800,276,1,34.0
5606,2235.0,PACK OF 12 PINK PAISLEY TISSUES ,3,374,12,1300,926,1,24.0
5607,2236.0,PACK OF 12 BLUE PAISLEY TISSUES ,10,100,0,100,0,1,0.0
5608,2237.0,PACK OF 12 RED RETROSPOT TISSUES ,9,1691,19,2000,309,1,38.0
5609,2238.0,CHICK GREY HOT WATER BOTTLE,4,427,21,2200,1773,1,42.0
5610,2239.0,PLASTERS IN TIN VINTAGE PAISLEY ,4,225,10,1100,875,1,20.0
5611,2240.0,PLASTERS IN TIN SKULLS,3,1636,25,2600,964,1,50.0
5612,2241.0,4 STRIPEY MICE FELTCRAFT,8,275,23,2400,2125,1,46.0
5613,2242.0,SET OF 6 SOLDIER SKITTLES,4,390,21,2200,1810,1,42.0
5614,2243.0,TRADITIONAL WOODEN SKIPPING ROPE,3,1006,11,1200,194,1,22.0
5615,2244.0,WOODEN BOX OF DOMINOES,3,1280,15,1600,320,1,30.0
5616,2245.0,RUSTIC  SEVENTEEN DRAWER SIDEBOARD,5,257,9,1000,743,1,18.0
5617,2246.0,PARTY CONES CARNIVAL ASSORTED,8,1069,14,1500,431,1,28.0
5618,2247.0,PARTY CONES CANDY ASSORTED,2,833,22,2300,1467,1,44.0
5619,2248.0,PICNIC BASKET WICKER SMALL,8,1192,11,1200,8,1,22.0
5620,2249.0,ASSORTED COLOUR BIRD ORNAMENT,3,1500,14,1500,0,1,28.0
5621,2250.0,STAR DECORATION PAINTED ZINC ,4,477,24,2500,2023,1,48.0
5622,2251.0,RETROSPOT LAMP,5,415,7,800,385,1,14.0
5623,2252.0,"FANCY FONT BIRTHDAY CARD, ",2,424,4,500,76,1,8.0
5624,2253.0,HAND WARMER UNION JACK,1,190,1,200,10,1,2.0
5625,2254.0,HAND WARMER SCOTTY DOG DESIGN,1,282,3,400,118,1,6.0
5626,2255.0,HAND WARMER OWL DESIGN,7,1045,14,1500,455,1,28.0
5627,2256.0,HAND WARMER RED RETROSPOT,6,742,11,1200,458,1,22.0
5628,2257.0,RETROSPOT HEART HOT WATER BOTTLE,5,757,10,1100,343,1,20.0
5629,2258.0,DOG BOWL CHASING BALL DESIGN,6,1061,10,1100,39,1,20.0
5630,2259.0,CLOTHES PEGS RETROSPOT PACK 25,2,169,1,200,31,1,2.0
5631,2260.0,HAND OVER THE CHOCOLATE   SIGN ,5,732,11,1200,468,1,22.0
5632,2261.0,WHITE HANGING HEART T-LIGHT HOLDER,2,112,22,2300,2188,1,44.0
5633,2262.0,TRAVEL SEWING KIT,8,724,9,1000,276,1,18.0
5634,2263.0,BLACK HEART CARD HOLDER,3,597,9,1000,403,1,18.0
5635,2264.0,ASSORTED COLOUR BIRD ORNAMENT,7,450,10,1100,650,1,20.0
5636,2265.0,PACK OF 60 PINK PAISLEY CAKE CASES,2,2318,25,2600,282,1,50.0
5637,2266.0,61 TEATIME FAIRY CAKE CASES,7,178,2,300,122,1,4.0
5638,2267.0,PACK OF 72 RETROSPOT CAKE CASES,8,524,23,2400,1876,1,46.0
5639,2268.0,CHICK GREY HOT WATER BOTTLE,4,788,22,2300,1512,1,44.0
5640,2269.0,SMALL GLASS HEART TRINKET POT,4,475,10,1100,625,1,20.0
5641,2270.0,ALARM CLOCK BAKELIKE IVORY,9,190,8,900,710,1,16.0
5642,2271.0,ALARM CLOCK BAKELIKE RED ,9,201,6,700,499,1,12.0
5643,2272.0,ALARM CLOCK BAKELIKE ORANGE,3,108,12,1300,1192,1,24.0
5644,2273.0,ALARM CLOCK BAKELIKE GREEN,8,897,19,2000,1103,1,38.0
5645,2274.0,HOT WATER BOTTLE TEA AND SYMPATHY,2,294,7,800,506,1,14.0
5646,2275.0,HAND WARMER BIRD DESIGN,2,111,1,200,89,1,2.0
5647,2276.0,HAND WARMER SCOTTY DOG DESIGN,1,2294,23,2400,106,1,46.0
5648,2277.0,WHITE HANGING HEART T-LIGHT HOLDER,8,2045,20,2100,55,1,40.0
5649,2278.0,WHITE METAL LANTERN,7,627,6,700,73,1,12.0
5650,2279.0,CREAM CUPID HEARTS COAT HANGER,9,1881,18,1900,19,1,36.0
5651,2280.0,EDWARDIAN PARASOL BLACK,5,1694,20,2100,406,1,40.0
5652,2281.0,EDWARDIAN PARASOL RED,4,100,0,100,0,1,0.0
5653,2282.0,RETRO COFFEE MUGS ASSORTED,7,1539,25,2600,1061,1,50.0
5654,2283.0,SAVE THE PLANET MUG,6,356,6,700,344,1,12.0
5655,2284.0,VINTAGE BILLBOARD DRINK ME MUG,1,375,3,400,25,1,6.0
5656,2285.0,VINTAGE BILLBOARD LOVE/HATE MUG,2,1410,15,1600,190,1,30.0
5657,2286.0,WOOD 2 DRAWER CABINET WHITE FINISH,4,954,22,2300,1346,1,44.0
5658,2287.0,WOOD S/3 CABINET ANT WHITE FINISH,4,105,17,1800,1695,1,34.0
5659,2288.0,WOODEN PICTURE FRAME WHITE FINISH,2,138,5,600,462,1,10.0
5660,2289.0,WOODEN FRAME ANTIQUE WHITE ,10,1090,14,1500,410,1,28.0
5661,2290.0,KNITTED UNION FLAG HOT WATER BOTTLE,7,1244,15,1600,356,1,30.0
5662,2291.0,RED WOOLLY HOTTIE WHITE HEART.,6,305,21,2200,1895,1,42.0
5663,2292.0,SET 7 BABUSHKA NESTING BOXES,9,290,8,900,610,1,16.0
5664,2293.0,IVORY EMBROIDERED QUILT ,3,707,16,1700,993,1,32.0
5665,2294.0,GLASS STAR FROSTED T-LIGHT HOLDER,2,449,17,1800,1351,1,34.0
5666,2295.0,SET OF 3 BLACK FLYING DUCKS,9,175,1,200,25,1,2.0
5667,2296.0,SET OF 3 COLOURED  FLYING DUCKS,7,282,4,500,218,1,8.0
5668,2297.0,PACK OF 12 RED RETROSPOT TISSUES ,4,544,9,1000,456,1,18.0
5669,2298.0,RED RETROSPOT MUG,7,127,8,900,773,1,16.0
5670,2299.0,BABUSHKA LIGHTS STRING OF 11,4,1349,15,1600,251,1,30.0
5671,2300.0,PIGGY BANK RETROSPOT ,1,1558,23,2400,842,1,46.0
5672,2301.0,SET 7 BABUSHKA NESTING BOXES,2,539,14,1500,961,1,28.0
5673,2302.0,DOORMAT FAIRY CAKE,4,960,12,1300,340,1,24.0
5674,2303.0,HAND WARMER RED RETROSPOT,3,1013,10,1100,87,1,20.0
5675,2304.0,HAND WARMER SCOTTY DOG DESIGN,9,1011,24,2500,1489,1,48.0
5676,2305.0,HAND WARMER OWL DESIGN,5,435,5,600,165,1,10.0
5677,2306.0,STRAWBERRY CERAMIC TRINKET BOX,1,795,8,900,105,1,16.0
5678,2307.0,PINK DOUGHNUT TRINKET POT ,10,543,6,700,157,1,12.0
5679,2308.0,SILK PURSE BABUSHKA PINK,8,100,0,100,0,1,0.0
5680,2309.0,HOT WATER BOTTLE TEA AND SYMPATHY,2,2030,20,2100,70,1,40.0
5681,2310.0,HOT WATER BOTTLE I AM SO POORLY,7,243,2,300,57,1,4.0
5682,2311.0,CHOCOLATE HOT WATER BOTTLE,7,119,21,2200,2081,1,42.0
5683,2312.0,WHITE SKULL HOT WATER BOTTLE ,5,942,10,1100,158,1,20.0
5684,2313.0,SCOTTIE DOG HOT WATER BOTTLE,9,583,23,2400,1817,1,46.0
5685,2314.0,HAND WARMER RED POLKA DOT,1,368,13,1400,1032,1,26.0
5686,2315.0,HAND WARMER UNION JACK,5,210,7,800,590,1,14.0
5687,2316.0,HOMEMADE JAM SCENTED CANDLES,4,2045,20,2100,55,1,40.0
5688,2317.0,BIRD HOUSE HOT WATER BOTTLE,7,711,14,1500,789,1,28.0
5689,2318.0,BOUDOIR SQUARE TISSUE BOX,5,205,2,300,95,1,4.0
5690,2319.0,SKULLS SQUARE TISSUE BOX,1,122,4,500,378,1,8.0
5691,2320.0,PHOTO FRAME CORNICE,4,386,9,1000,614,1,18.0
5692,2321.0,SILK PURSE BABUSHKA RED,1,2232,24,2500,268,1,48.0
5693,2322.0,PICTURE DOMINOES,5,388,3,400,12,1,6.0
5694,2323.0,S/6 SEW ON CROCHET FLOWERS,4,526,10,1100,574,1,20.0
5695,2324.0,SCANDINAVIAN REDS RIBBONS,5,100,0,100,0,1,0.0
5696,2325.0,BALLOONS  WRITING SET ,1,100,0,100,0,1,0.0
5697,2326.0,JAM MAKING SET PRINTED,8,1249,23,2400,1151,1,46.0
5698,2327.0,LAVENDER INCENSE IN TIN,10,453,6,700,247,1,12.0
5699,2328.0,TV DINNER TRAY VINTAGE PAISLEY,7,679,10,1100,421,1,20.0
5700,2329.0,SET OF 4 ENGLISH ROSE PLACEMATS,1,424,20,2100,1676,1,40.0
5701,2330.0,SET OF 4 ENGLISH ROSE COASTERS,2,175,23,2400,2225,1,46.0
5702,2331.0,TRIPLE PHOTO FRAME CORNICE ,10,1884,20,2100,216,1,40.0
5703,2332.0,FAMILY PHOTO FRAME CORNICE,6,1031,18,1900,869,1,36.0
5704,2333.0,MIRRORED DISCO BALL ,4,133,1,200,67,1,2.0
5705,2334.0,DISCO BALL ROTATOR BATTERY OPERATED,3,549,21,2200,1651,1,42.0
5706,2335.0,SILVER LOOKING MIRROR,10,417,5,600,183,1,10.0
5707,2336.0,LADIES & GENTLEMEN METAL SIGN,5,1355,24,2500,1145,1,48.0
5708,2337.0,METAL SIGN HER DINNER IS SERVED ,3,188,1,200,12,1,2.0
5709,2338.0,YOU'RE CONFUSING ME METAL SIGN ,6,891,8,900,9,1,16.0
5710,2339.0,DOORMAT TOPIARY,3,2004,20,2100,96,1,40.0
5711,2340.0,BATHROOM METAL SIGN,3,754,8,900,146,1,16.0
5712,2341.0,KITCHEN METAL SIGN,3,144,1,200,56,1,2.0
5713,2342.0,TOILET METAL SIGN,6,786,8,900,114,1,16.0
5714,2343.0,METAL SIGN TAKE IT OR LEAVE IT ,5,379,9,1000,621,1,18.0
5715,2344.0,I'M ON HOLIDAY METAL SIGN,7,335,7,800,465,1,14.0
5716,2345.0,GROW YOUR OWN BASIL IN ENAMEL MUG,5,143,16,1700,1557,1,32.0
5717,2346.0,SET/10 PINK POLKADOT PARTY CANDLES,2,200,1,200,0,1,2.0
5718,2347.0,SET 20 NAPKINS FAIRY CAKES DESIGN ,3,1630,16,1700,70,1,32.0
5719,2348.0,61 TEATIME FAIRY CAKE CASES,6,854,12,1300,446,1,24.0
5720,2349.0,SET OF 6 T-LIGHTS SNOWMEN,4,333,14,1500,1167,1,28.0
5721,2350.0,SET OF 6 T-LIGHTS SANTA,10,404,4,500,96,1,8.0
5722,2351.0,SET OF 9 HEART SHAPED BALLOONS,4,418,4,500,82,1,8.0
5723,2352.0,SANDWICH BATH SPONGE,9,387,7,800,413,1,14.0
5724,2353.0,APPLE BATH SPONGE,3,247,17,1800,1553,1,34.0
5725,2354.0,STRAWBERRY BATH SPONGE ,10,877,9,1000,123,1,18.0
5726,2355.0,BLACK PIRATE TREASURE CHEST,8,1012,24,2500,1488,1,48.0
5727,2356.0,STAR PORTABLE TABLE LIGHT ,8,170,1,200,30,1,2.0
5728,2357.0,SNOWFLAKE PORTABLE TABLE LIGHT ,7,100,0,100,0,1,0.0
5729,2358.0,PINK OVAL JEWELLED MIRROR,4,1361,17,1800,439,1,34.0
5730,2359.0,RETROSPOT CIGAR BOX MATCHES ,9,947,19,2000,1053,1,38.0
5731,2360.0,COSY HOUR GIANT TUBE MATCHES,6,798,18,1900,1102,1,36.0
5732,2361.0,JAZZ HEARTS PURSE NOTEBOOK,7,155,9,1000,845,1,18.0
5733,2362.0,LUNCH BAG DOLLY GIRL DESIGN,3,1257,25,2600,1343,1,50.0
5734,2363.0,WHITE HANGING HEART T-LIGHT HOLDER,1,798,10,1100,302,1,20.0
5735,2364.0,CANDLEHOLDER PINK HANGING HEART,5,241,5,600,359,1,10.0
5736,2365.0,WOOD 2 DRAWER CABINET WHITE FINISH,9,922,14,1500,578,1,28.0
5737,2366.0,ASSORTED COLOUR MINI CASES,1,158,17,1800,1642,1,34.0
5738,2367.0,LUNCH BAG RED RETROSPOT,8,396,6,700,304,1,12.0
5739,2368.0,LUNCH BAG SPACEBOY DESIGN ,8,307,24,2500,2193,1,48.0
5740,2369.0,LUNCH BAG WOODLAND,6,700,20,2100,1400,1,40.0
5741,2370.0,LUNCH BAG PINK POLKADOT,1,395,21,2200,1805,1,42.0
5742,2371.0,GUMBALL COAT RACK,5,1360,19,2000,640,1,38.0
5743,2372.0,BLUE NEW BAROQUE CANDLESTICK CANDLE,9,353,5,600,247,1,10.0
5744,2373.0,PINK NEW BAROQUECANDLESTICK CANDLE,7,939,15,1600,661,1,30.0
5745,2374.0,FAIRY CAKE FLANNEL ASSORTED COLOUR,10,395,5,600,205,1,10.0
5746,2375.0,BREAD BIN DINER STYLE PINK,5,124,1,200,76,1,2.0
5747,2376.0,JUMBO BAG CHARLIE AND LOLA TOYS,8,260,5,600,340,1,10.0
5748,2377.0,TEA TIME TABLE CLOTH,6,566,5,600,34,1,10.0
5749,2378.0,ENGLISH ROSE HOT WATER BOTTLE,5,368,17,1800,1432,1,34.0
5750,2379.0,ENAMEL FIRE BUCKET CREAM,3,235,16,1700,1465,1,32.0
5751,2380.0,PICNIC BASKET WICKER SMALL,8,263,3,400,137,1,6.0
5752,2381.0,PAPER CHAIN KIT 50'S CHRISTMAS ,5,1245,14,1500,255,1,28.0
5753,2382.0,PAPER CHAIN KIT VINTAGE CHRISTMAS,8,325,5,600,275,1,10.0
5754,2383.0,HOT WATER BOTTLE BABUSHKA ,8,368,6,700,332,1,12.0
5755,2384.0,HAND WARMER BIRD DESIGN,2,1587,22,2300,713,1,44.0
5756,2385.0,POSTAGE,4,100,0,100,0,1,0.0
5757,2386.0,HEART IVORY TRELLIS SMALL,7,975,15,1600,625,1,30.0
5758,2387.0,CLEAR DRAWER KNOB ACRYLIC EDWARDIAN,8,342,20,2100,1758,1,40.0
5759,2388.0,PINK DRAWER KNOB ACRYLIC EDWARDIAN,6,100,0,100,0,1,0.0
5760,2389.0,GREEN DRAWER KNOB ACRYLIC EDWARDIAN,5,742,23,2400,1658,1,46.0
5761,2390.0,BLUE DRAWER KNOB ACRYLIC EDWARDIAN,1,1029,11,1200,171,1,22.0
5762,2391.0,HEART OF WICKER SMALL,6,635,20,2100,1465,1,40.0
5763,2392.0,SMALL POPCORN HOLDER,8,126,3,400,274,1,6.0
5764,2393.0,SET 6 FOOTBALL CELEBRATION CANDLES,1,333,14,1500,1167,1,28.0
5765,2394.0,SET OF 6 GIRLS CELEBRATION CANDLES,1,509,6,700,191,1,12.0
5766,2395.0,ROMANTIC PINKS RIBBONS ,7,1288,14,1500,212,1,28.0
5767,2396.0,BRIGHT BLUES RIBBONS ,9,197,1,200,3,1,2.0
5768,2397.0,SCANDINAVIAN REDS RIBBONS,8,1386,14,1500,114,1,28.0
5769,2398.0,CHOCOLATE BOX RIBBONS ,2,415,15,1600,1185,1,30.0
5770,2399.0,PARTY INVITES FOOTBALL,2,2161,23,2400,239,1,46.0
5771,2400.0,PARTY INVITES JAZZ HEARTS,6,1315,15,1600,285,1,30.0
5772,2401.0,PARTY INVITES SPACEMAN,4,705,9,1000,295,1,18.0
5773,2402.0,SET OF 3 BUTTERFLY COOKIE CUTTERS,3,831,8,900,69,1,16.0
5774,2403.0,SET OF 3 HEART COOKIE CUTTERS,8,1406,19,2000,594,1,38.0
5775,2404.0,4 PIECE SPACEBOY COOKIE CUTTER SET,3,2179,24,2500,321,1,48.0
5776,2405.0,PACK OF 72 SKULL CAKE CASES,2,537,23,2400,1863,1,46.0
5777,2406.0,PACK OF 60 SPACEBOY CAKE CASES,1,2240,25,2600,360,1,50.0
5778,2407.0,PACK OF 72 RETROSPOT CAKE CASES,1,678,12,1300,622,1,24.0
5779,2408.0,73 SWEETHEART FAIRY CAKE CASES,1,1372,18,1900,528,1,36.0
5780,2409.0,PACK OF 60 DINOSAUR CAKE CASES,4,768,16,1700,932,1,32.0
5781,2410.0,LUNCH BAG SUKI  DESIGN ,3,235,5,600,365,1,10.0
5782,2411.0,LUNCH BAG CARS BLUE,5,710,11,1200,490,1,22.0
5783,2412.0,LUNCH BAG  BLACK SKULL.,3,679,7,800,121,1,14.0
5784,2413.0,HEART IVORY TRELLIS LARGE,5,784,17,1800,1016,1,34.0
5785,2414.0,SET/5 RED RETROSPOT LID GLASS BOWLS,9,365,25,2600,2235,1,50.0
5786,2415.0,WHITE HANGING HEART T-LIGHT HOLDER,9,1950,23,2400,450,1,46.0
5787,2416.0,WHITE METAL LANTERN,5,172,2,300,128,1,4.0
5788,2417.0,CREAM CUPID HEARTS COAT HANGER,6,1229,12,1300,71,1,24.0
5789,2418.0,EDWARDIAN PARASOL RED,5,755,13,1400,645,1,26.0
5790,2419.0,RETRO COFFEE MUGS ASSORTED,2,271,23,2400,2129,1,46.0
5791,2420.0,SAVE THE PLANET MUG,2,552,22,2300,1748,1,44.0
5792,2421.0,VINTAGE BILLBOARD DRINK ME MUG,6,1273,20,2100,827,1,40.0
5793,2422.0,VINTAGE BILLBOARD LOVE/HATE MUG,8,796,22,2300,1504,1,44.0
5794,2423.0,WOOD 2 DRAWER CABINET WHITE FINISH,2,205,10,1100,895,1,20.0
5795,2424.0,WOOD S/3 CABINET ANT WHITE FINISH,7,226,2,300,74,1,4.0
5796,2425.0,WOODEN PICTURE FRAME WHITE FINISH,8,443,4,500,57,1,8.0
5797,2426.0,WOODEN FRAME ANTIQUE WHITE ,8,545,24,2500,1955,1,48.0
5798,2427.0,KNITTED UNION FLAG HOT WATER BOTTLE,8,762,18,1900,1138,1,36.0
5799,2428.0,RED WOOLLY HOTTIE WHITE HEART.,2,366,5,600,234,1,10.0
5800,2429.0,SET 7 BABUSHKA NESTING BOXES,5,406,8,900,494,1,16.0
5801,2430.0,IVORY EMBROIDERED QUILT ,8,1301,13,1400,99,1,26.0
5802,2431.0,GLASS STAR FROSTED T-LIGHT HOLDER,8,623,6,700,77,1,12.0
5803,2432.0,HAND WARMER RED POLKA DOT,10,743,21,2200,1457,1,42.0
5804,2433.0,HAND WARMER UNION JACK,9,691,6,700,9,1,12.0
5805,2434.0,MAGIC DRAWING SLATE DINOSAUR,6,1575,23,2400,825,1,46.0
5806,2435.0,MAGIC DRAWING SLATE BAKE A CAKE ,4,1724,17,1800,76,1,34.0
5807,2436.0,13 PENCILS TALL TUBE SKULLS,1,344,7,800,456,1,14.0
5808,2437.0,CHOCOLATE CALCULATOR,1,2356,24,2500,144,1,48.0
5809,2438.0,RED  HARMONICA IN BOX ,7,106,17,1800,1694,1,34.0
5810,2439.0,BLUE HARMONICA IN BOX ,3,224,5,600,376,1,10.0
5811,2440.0,SKULLS  WATER TRANSFER TATTOOS ,5,549,19,2000,1451,1,38.0
5812,2441.0,PACK 3 BOXES BIRD PANNETONE ,5,1054,23,2400,1346,1,46.0
5813,2442.0,HOT WATER BOTTLE TEA AND SYMPATHY,6,436,12,1300,864,1,24.0
5814,2443.0,RED WOOLLY HOTTIE WHITE HEART.,5,559,24,2500,1941,1,48.0
5815,2444.0,WHITE SKULL HOT WATER BOTTLE ,9,175,2,300,125,1,4.0
5816,2445.0,4 PIECE SPACEBOY COOKIE CUTTER SET,5,785,11,1200,415,1,22.0
5817,2446.0,SET OF 20 KIDS COOKIE CUTTERS,4,1356,20,2100,744,1,40.0
5818,2447.0,11 COLOUR SPACEBOY PEN,9,125,4,500,375,1,8.0
5819,2448.0,VICTORIAN GLASS HANGING T-LIGHT,9,142,1,200,58,1,2.0
5820,2449.0,SINGLE HEART ZINC T-LIGHT HOLDER,6,282,6,700,418,1,12.0
5821,2450.0,RED HANGING HEART T-LIGHT HOLDER,2,131,22,2300,2169,1,44.0
5822,2451.0,HANGING METAL STAR LANTERN,5,412,4,500,88,1,8.0
5823,2452.0,SILVER HANGING T-LIGHT HOLDER,10,266,4,500,234,1,8.0
5824,2453.0,DOORMAT RED RETROSPOT,1,756,12,1300,544,1,24.0
5825,2454.0,DOORMAT HEARTS,2,639,21,2200,1561,1,42.0
5826,2455.0,NATURAL SLATE RECTANGLE CHALKBOARD,7,391,4,500,109,1,8.0
5827,2456.0,LOVEBIRD HANGING DECORATION WHITE ,5,1457,22,2300,843,1,44.0
5828,2457.0,ASSORTED COLOUR BIRD ORNAMENT,5,1261,15,1600,339,1,30.0
5829,2458.0,HOME BUILDING BLOCK WORD,9,814,13,1400,586,1,26.0
5830,2459.0,LOVE BUILDING BLOCK WORD,5,954,24,2500,1546,1,48.0
5831,2460.0,PHOTO FRAME CORNICE,4,262,18,1900,1638,1,36.0
5832,2461.0,PENS ASSORTED FUNNY FACE,9,1921,25,2600,679,1,50.0
5833,2462.0,CARD CIRCUS PARADE,7,991,12,1300,309,1,24.0
5834,2463.0,WRAP COWBOYS  ,9,156,1,200,44,1,2.0
5835,2464.0,AIRLINE BAG VINTAGE TOKYO 79,7,570,22,2300,1730,1,44.0
5836,2465.0,RED RETROSPOT UMBRELLA,3,1794,21,2200,406,1,42.0
5837,2466.0,BLACK/BLUE POLKADOT UMBRELLA,10,111,10,1100,989,1,20.0
5838,2467.0,RED 3 PIECE RETROSPOT CUTLERY SET,10,764,8,900,136,1,16.0
5839,2468.0,PACK OF 72 RETROSPOT CAKE CASES,5,199,12,1300,1101,1,24.0
5840,2469.0,SET OF 72 RETROSPOT PAPER  DOILIES,9,100,7,800,700,1,14.0
5841,2470.0,BLUE COAT RACK PARIS FASHION,10,1628,18,1900,272,1,36.0
5842,2471.0,PLASTERS IN TIN SKULLS,10,2246,23,2400,154,1,46.0
5843,2472.0,SLEEPING CAT ERASERS,1,488,11,1200,712,1,22.0
5844,2473.0,CARD BIRTHDAY COWBOY,10,128,22,2300,2172,1,44.0
5845,2474.0,PACK 3 BOXES CHRISTMAS PANNETONE,2,1990,21,2200,210,1,42.0
5846,2475.0,ROTATING SILVER ANGELS T-LIGHT HLDR,9,213,16,1700,1487,1,32.0
5847,2476.0,COSY HOUR GIANT TUBE MATCHES,7,785,13,1400,615,1,26.0
5848,2477.0,RIBBON REEL MAKING SNOWMEN ,2,162,21,2200,2038,1,42.0
5849,2478.0,MINI PAINT SET VINTAGE ,3,428,5,600,172,1,10.0
5850,2479.0,5 TRADITIONAL SPINNING TOPS,3,380,8,900,520,1,16.0
5851,2480.0,SET OF 6 SOLDIER SKITTLES,6,566,11,1200,634,1,22.0
5852,2481.0,BAG 500g SWIRLY MARBLES,2,2117,21,2200,83,1,42.0
5853,2482.0,6 STRAND GLASS NECKLACE CRYSTAL,4,613,23,2400,1787,1,46.0
5854,2483.0,WHITE SKULL HOT WATER BOTTLE ,10,1423,20,2100,677,1,40.0
5855,2484.0,SCOTTIE DOG HOT WATER BOTTLE,2,534,9,1000,466,1,18.0
5856,2485.0,SQUARECUSHION COVER PINK UNION FLAG,3,100,0,100,0,1,0.0
5857,2486.0,SPACEBOY CHILDRENS EGG CUP,3,1570,18,1900,330,1,36.0
5858,2487.0,CHILDREN'S SPACEBOY MUG,8,1867,22,2300,433,1,44.0
5859,2488.0,HAND WARMER SCOTTY DOG DESIGN,4,385,10,1100,715,1,20.0
5860,2489.0,FELTCRAFT CUSHION OWL,8,1892,20,2100,208,1,40.0
5861,2490.0,BLACK CANDELABRA T-LIGHT HOLDER,6,124,11,1200,1076,1,22.0
5862,2491.0,TOY TIDY DOLLY GIRL DESIGN,2,437,5,600,163,1,10.0
5863,2492.0,SET 12 LAVENDER  BOTANICAL T-LIGHTS,6,1578,18,1900,322,1,36.0
5864,2493.0,UNION JACK FLAG LUGGAGE TAG,4,100,0,100,0,1,0.0
5865,2494.0,RED HEART LUGGAGE TAG,9,100,0,100,0,1,0.0
5866,2495.0,RED GLASS TASSLE BAG CHARM,4,159,19,2000,1841,1,38.0
5867,2496.0,CLEAR ACRYLIC FACETED BANGLE,5,244,15,1600,1356,1,30.0
5868,2497.0,6 STRAND GLASS NECKLACE CRYSTAL,3,967,20,2100,1133,1,40.0
5869,2498.0,DOORMAT UNION JACK GUNS AND ROSES,7,791,15,1600,809,1,30.0
5870,2499.0,VANILLA SCENT CANDLE JEWELLED BOX,5,191,17,1800,1609,1,34.0
5871,2500.0,FULL ENGLISH BREAKFAST PLATE,8,922,22,2300,1378,1,44.0
5872,2501.0,BLACK CANDELABRA T-LIGHT HOLDER,3,708,8,900,192,1,16.0
5873,2502.0,MAGIC DRAWING SLATE CIRCUS PARADE  ,7,380,9,1000,620,1,18.0
5874,2503.0,CHRISTMAS HANGING HEART WITH BELL,2,209,6,700,491,1,12.0
5875,2504.0,CAKE STAND VICTORIAN FILIGREE MED,3,1123,21,2200,1077,1,42.0
5876,2505.0,PAISLEY PATTERN  STICKERS,5,1392,19,2000,608,1,38.0
5877,2506.0,FLOWERS  STICKERS,1,1470,19,2000,530,1,38.0
5878,2507.0,PINK NEW BAROQUECANDLESTICK CANDLE,4,638,19,2000,1362,1,38.0
5879,2508.0,BLUE NEW BAROQUE CANDLESTICK CANDLE,6,794,13,1400,606,1,26.0
5880,2509.0,JUMBO STORAGE BAG SUKI,10,2382,24,2500,118,1,48.0
5881,2510.0,BLACK LOVE BIRD CANDLE,6,1492,24,2500,1008,1,48.0
5882,2511.0,PARTY TIME PENCIL ERASERS,8,366,7,800,434,1,14.0
5883,2512.0,DISCO BALL CHRISTMAS DECORATION,5,1182,24,2500,1318,1,48.0
5884,2513.0,PINK B'FLY C/COVER W BOBBLES,7,370,4,500,130,1,8.0
5885,2514.0,PINK UNION JACK  LUGGAGE TAG,6,1275,16,1700,425,1,32.0
5886,2515.0,7 RIBBONS ELEGANT CHRISTMAS ,5,378,3,400,22,1,6.0
5887,2516.0,UNION JACK FLAG LUGGAGE TAG,8,247,4,500,253,1,8.0
5888,2517.0,AGED GLASS SILVER T-LIGHT HOLDER,10,1556,18,1900,344,1,36.0
5889,2518.0,BOOM BOX SPEAKER GIRLS,9,1270,23,2400,1130,1,46.0
5890,2519.0,7 RIBBONS SHIMMERING PINKS ,6,2016,25,2600,584,1,50.0
5891,2520.0, SET 2 TEA TOWELS I LOVE LONDON ,6,220,13,1400,1180,1,26.0
5892,2521.0,JUMBO BAG OWLS,4,100,0,100,0,1,0.0
5893,2522.0,SANDWICH BATH SPONGE,2,294,11,1200,906,1,22.0
5894,2523.0,OWL DOORSTOP,8,929,14,1500,571,1,28.0
5895,2524.0,6 STRAND GLASS NECKLACE CRYSTAL,3,1763,18,1900,137,1,36.0
5896,2525.0,HAND WARMER UNION JACK,9,148,12,1300,1152,1,24.0
5897,2526.0,HAND WARMER SCOTTY DOG DESIGN,5,139,1,200,61,1,2.0
5898,2527.0,LARGE POPCORN HOLDER ,7,168,3,400,232,1,6.0
5899,2528.0,PAINTED METAL STAR WITH HOLLY BELLS,4,1846,21,2200,354,1,42.0
5900,2529.0,PAINTED METAL HEART WITH HOLLY BELL,4,323,13,1400,1077,1,26.0
5901,2530.0,ANGEL DECORATION STARS ON DRESS,4,225,9,1000,775,1,18.0
5902,2531.0,SMALL POPCORN HOLDER,3,224,18,1900,1676,1,36.0
5903,2532.0,JUMBO BAG RED RETROSPOT,2,176,3,400,224,1,6.0
5904,2533.0,JUMBO BAG STRAWBERRY,7,161,16,1700,1539,1,32.0
5905,2534.0,STRAWBERRY SHOPPER BAG,9,691,6,700,9,1,12.0
5906,2535.0,STRAWBERRY CHARLOTTE BAG,7,100,0,100,0,1,0.0
5907,2536.0, SET 2 TEA TOWELS I LOVE LONDON ,1,178,3,400,222,1,6.0
5908,2537.0,PACK OF 12 RED RETROSPOT TISSUES ,6,1357,15,1600,243,1,30.0
5909,2538.0,SCOTTIE DOG HOT WATER BOTTLE,8,473,23,2400,1927,1,46.0
5910,2539.0,CHOCOLATE HOT WATER BOTTLE,9,892,22,2300,1408,1,44.0
5911,2540.0,LUNCH BAG CARS BLUE,1,155,2,300,145,1,4.0
5912,2541.0,LUNCH BAG SPACEBOY DESIGN ,8,363,4,500,137,1,8.0
5913,2542.0,ROUND SNACK BOXES SET OF4 WOODLAND ,10,376,8,900,524,1,16.0
5914,2543.0,LUNCH BAG DOLLY GIRL DESIGN,9,312,8,900,588,1,16.0
5915,2544.0,LUNCH BAG SUKI  DESIGN ,8,100,0,100,0,1,0.0
5916,2545.0,LUNCH BAG  BLACK SKULL.,3,100,0,100,0,1,0.0
5917,2546.0,ROUND SNACK BOXES SET OF 4 FRUITS ,6,408,5,600,192,1,10.0
5918,2547.0,ROUND SNACK BOXES SET OF 4 SKULLS,2,1069,17,1800,731,1,34.0
5919,2548.0,DOLLY GIRL LUNCH BOX,3,1624,16,1700,76,1,32.0
5920,2549.0,SPACEBOY LUNCH BOX ,6,323,10,1100,777,1,20.0
5921,2550.0,GREEN POLKADOT PLATE ,2,1286,12,1300,14,1,24.0
5922,2551.0,BLUE POLKADOT PLATE ,9,1876,24,2500,624,1,48.0
5923,2552.0,RED RETROSPOT PLATE ,8,486,5,600,114,1,10.0
5924,2553.0,PINK  POLKADOT PLATE ,5,1122,13,1400,278,1,26.0
5925,2554.0,ROUND SNACK BOXES SET OF 4 SKULLS,10,939,12,1300,361,1,24.0
5926,2555.0,FELTCRAFT DOLL MOLLY,7,104,6,700,596,1,12.0
5927,2556.0,FELTCRAFT CHRISTMAS FAIRY,6,1306,24,2500,1194,1,48.0
5928,2557.0,TRAVEL SEWING KIT,6,1154,17,1800,646,1,34.0
5929,2558.0,SET OF 3 NOTEBOOKS IN PARCEL,9,1932,21,2200,268,1,42.0
5930,2559.0,RED RETROSPOT TAPE,7,1755,25,2600,845,1,50.0
5931,2560.0,COSY SLIPPER SHOES SMALL  RED ,10,112,2,300,188,1,4.0
5932,2561.0,7 RIBBONS RUSTIC CHARM,5,180,3,400,220,1,6.0
5933,2562.0,SCANDINAVIAN REDS RIBBONS,10,166,9,1000,834,1,18.0
5934,2563.0,JAM MAKING SET PRINTED,2,1026,11,1200,174,1,22.0
5935,2564.0,13 DAISY PEGS IN WOOD BOX,3,138,3,400,262,1,6.0
5936,2565.0,HOT WATER BOTTLE BABUSHKA ,1,125,11,1200,1075,1,22.0
5937,2566.0,FELTCRAFT PRINCESS CHARLOTTE DOLL,8,762,16,1700,938,1,32.0
5938,2567.0,FELTCRAFT CHRISTMAS FAIRY,4,274,2,300,26,1,4.0
5939,2568.0,FELTCRAFT PRINCESS CHARLOTTE DOLL,2,1513,16,1700,187,1,32.0
5940,2569.0,7 RIBBONS RUSTIC CHARM,4,152,1,200,48,1,2.0
5941,2570.0,COSY SLIPPER SHOES SMALL  RED ,2,1388,14,1500,112,1,28.0
5942,2571.0,SCANDINAVIAN REDS RIBBONS,2,486,8,900,414,1,16.0
5943,2572.0,6 HOOK HANGER RED MAGIC TOADSTOOL,3,263,13,1400,1137,1,26.0
5944,2573.0,CHRISTMAS CRAFT TREE TOP ANGEL,9,230,3,400,170,1,6.0
5945,2574.0,CHRISTMAS CRAFT LITTLE FRIENDS,5,194,2,300,106,1,4.0
5946,2575.0,6 HOOK HANGER RED MAGIC TOADSTOOL,9,110,7,800,690,1,14.0
5947,2576.0,7 RIBBONS RUSTIC CHARM,8,1413,18,1900,487,1,36.0
5948,2577.0,13 DAISY PEGS IN WOOD BOX,6,182,15,1600,1418,1,30.0
5949,2578.0,SET OF 3 NOTEBOOKS IN PARCEL,5,141,1,200,59,1,2.0
5950,2579.0,6 HOOK HANGER MAGIC TOADSTOOL,10,449,6,700,251,1,12.0
5951,2580.0,SCANDINAVIAN REDS RIBBONS,10,1112,21,2200,1088,1,42.0
5952,2581.0,RED TOADSTOOL LED NIGHT LIGHT,7,161,3,400,239,1,6.0
5953,2582.0,6 HOOK HANGER RED MAGIC TOADSTOOL,7,217,8,900,683,1,16.0
5954,2583.0,COSY SLIPPER SHOES SMALL GREEN,7,570,6,700,130,1,12.0
5955,2584.0,COSY SLIPPER SHOES SMALL  RED ,9,114,1,200,86,1,2.0
5956,2585.0,FELTCRAFT DOLL ROSIE,1,1013,11,1200,187,1,22.0
5957,2586.0,FELTCRAFT DOLL MOLLY,1,467,12,1300,833,1,24.0
5958,2587.0,FELTCRAFT DOLL EMILY,5,173,1,200,27,1,2.0
5959,2588.0,FELTCRAFT PRINCESS CHARLOTTE DOLL,8,1182,16,1700,518,1,32.0
5960,2589.0,FELTCRAFT PRINCESS OLIVIA DOLL,2,847,20,2100,1253,1,40.0
5961,2590.0,REX CASH+CARRY JUMBO SHOPPER,7,505,14,1500,995,1,28.0
5962,2591.0,FELTCRAFT DOLL MOLLY,5,481,14,1500,1019,1,28.0
5963,2592.0,FELTCRAFT CUSHION OWL,7,100,0,100,0,1,0.0
5964,2593.0,CHRISTMAS CRAFT TREE TOP ANGEL,9,1238,24,2500,1262,1,48.0
5965,2594.0,CHRISTMAS CRAFT LITTLE FRIENDS,8,964,14,1500,536,1,28.0
5966,2595.0,FELTCRAFT CUSHION RABBIT,2,972,17,1800,828,1,34.0
5967,2596.0,FELTCRAFT CUSHION BUTTERFLY,3,151,3,400,249,1,6.0
5968,2597.0,13 DAISY PEGS IN WOOD BOX,7,266,9,1000,734,1,18.0
5969,2598.0,PAPER CHAIN KIT 50'S CHRISTMAS ,7,1212,13,1400,188,1,26.0
5970,2599.0,FELTCRAFT CUSHION BUTTERFLY,5,1895,19,2000,105,1,38.0
5971,2600.0,13 DAISY PEGS IN WOOD BOX,6,412,21,2200,1788,1,42.0
5972,2601.0,ROSE COTTAGE KEEPSAKE BOX ,8,845,8,900,55,1,16.0
5973,2602.0,TOTE BAG I LOVE LONDON,1,642,13,1400,758,1,26.0
5974,2603.0,13 DAISY PEGS IN WOOD BOX,7,511,10,1100,589,1,20.0
5975,2604.0,TOTE BAG I LOVE LONDON,3,2042,23,2400,358,1,46.0
5976,2605.0,FOLDING UMBRELLA PINKWHITE POLKADOT,3,477,19,2000,1523,1,38.0
5977,2606.0,FOLDING UMBRELLA CREAM POLKADOT,1,596,5,600,4,1,10.0
5978,2607.0,FOLDING UMBRELLA WHITE/RED POLKADOT,4,706,18,1900,1194,1,36.0
5979,2608.0,SET 10 LIGHTS NIGHT OWL,5,554,24,2500,1946,1,48.0
5980,2609.0,SMALL POPCORN HOLDER,6,389,13,1400,1011,1,26.0
5981,2610.0, SET 2 TEA TOWELS I LOVE LONDON ,8,488,4,500,12,1,8.0
5982,2611.0,FOLDING UMBRELLA RED/WHITE POLKADOT,1,1486,17,1800,314,1,34.0
5983,2612.0,BABUSHKA LIGHTS STRING OF 11,5,983,16,1700,717,1,32.0
5984,2613.0,LUNCH BAG RED RETROSPOT,7,1444,24,2500,1056,1,48.0
5985,2614.0,S/4 VALENTINE DECOUPAGE HEART BOX,3,1503,19,2000,497,1,38.0
5986,2615.0,FOLDING UMBRELLA CREAM POLKADOT,6,1542,23,2400,858,1,46.0
5987,2616.0, SET 2 TEA TOWELS I LOVE LONDON ,6,943,10,1100,157,1,20.0
5988,2617.0,FOLDING UMBRELLA RED/WHITE POLKADOT,10,648,16,1700,1052,1,32.0
5989,2618.0,SOLDIERS EGG CUP ,8,1640,20,2100,460,1,40.0
5990,2619.0,S/4 VALENTINE DECOUPAGE HEART BOX,1,154,3,400,246,1,6.0
5991,2620.0,RED RETROSPOT MINI CASES,7,1532,21,2200,668,1,42.0
5992,2621.0,,6,406,23,2400,1994,1,46.0
5993,2622.0,61 CAKE CASES VINTAGE CHRISTMAS,8,1527,15,1600,73,1,30.0
5994,2623.0,PAPER CHAIN KIT VINTAGE CHRISTMAS,9,1660,24,2500,840,1,48.0
5995,2624.0,RIBBON REEL CHRISTMAS SOCK BAUBLE,6,262,3,400,138,1,6.0
5996,2625.0,RIBBON REEL SNOWY VILLAGE,5,622,7,800,178,1,14.0
5997,2626.0,RIBBON REEL MAKING SNOWMEN ,5,599,6,700,101,1,12.0
5998,2627.0,SET OF 20 VINTAGE CHRISTMAS NAPKINS,5,916,10,1100,184,1,20.0
5999,2628.0,TURQUOISE CHRISTMAS TREE ,4,583,7,800,217,1,14.0
6000,2629.0,RED STAR CARD HOLDER,10,533,11,1200,667,1,22.0
6001,2630.0,WICKER WREATH SMALL,4,159,1,200,41,1,2.0
6002,2631.0,HEART OF WICKER LARGE,2,459,25,2600,2141,1,50.0
6003,2632.0,ADVENT CALENDAR GINGHAM SACK,5,100,0,100,0,1,0.0
6004,2633.0,HEART OF WICKER SMALL,6,1364,25,2600,1236,1,50.0
6005,2634.0,FELTCRAFT BUTTERFLY HEARTS,6,1186,19,2000,814,1,38.0
6006,2635.0,PARTY CONE CHRISTMAS DECORATION ,10,161,14,1500,1339,1,28.0
6007,2636.0,VINTAGE HEADS AND TAILS CARD GAME ,10,563,15,1600,1037,1,30.0
6008,2637.0,WICKER STAR ,3,875,11,1200,325,1,22.0
6009,2638.0,VINTAGE SNAP CARDS,9,504,5,600,96,1,10.0
6010,2639.0,FELTCRAFT 6 FLOWER FRIENDS,5,565,10,1100,535,1,20.0
6011,2640.0, SET 2 TEA TOWELS I LOVE LONDON ,10,1091,25,2600,1509,1,50.0
6012,2641.0,JAM MAKING SET PRINTED,9,537,11,1200,663,1,22.0
6013,2642.0,BIRD DECORATION RED RETROSPOT,6,157,21,2200,2043,1,42.0
6014,2643.0,CHRISTMAS GINGHAM TREE,7,195,4,500,305,1,8.0
6015,2644.0,CHRISTMAS GINGHAM STAR,8,1543,20,2100,557,1,40.0
6016,2645.0,CHRISTMAS GINGHAM HEART,9,1862,22,2300,438,1,44.0
6017,2646.0,PACK OF 12 PINK POLKADOT TISSUES,7,809,20,2100,1291,1,40.0
6018,2647.0,FELTCRAFT PRINCESS LOLA DOLL,4,100,0,100,0,1,0.0
6019,2648.0,PACK OF 12 LONDON TISSUES ,9,143,1,200,57,1,2.0
6020,2649.0,PURPLE DRAWERKNOB ACRYLIC EDWARDIAN,7,616,7,800,184,1,14.0
6021,2650.0,CHILDREN'S APRON DOLLY GIRL ,4,223,11,1200,977,1,22.0
6022,2651.0,CHILDRENS APRON SPACEBOY DESIGN,1,760,7,800,40,1,14.0
6023,2652.0,CHRISTMAS LIGHTS 10 SANTAS ,9,172,1,200,28,1,2.0
6024,2653.0,CHRISTMAS LIGHTS 10 REINDEER,6,136,9,1000,864,1,18.0
6025,2654.0,PAPER CHAIN KIT 50'S CHRISTMAS ,3,977,12,1300,323,1,24.0
6026,2655.0,FELTCRAFT CHRISTMAS FAIRY,5,2186,25,2600,414,1,50.0
6027,2656.0,PACK OF 72 RETROSPOT CAKE CASES,3,525,23,2400,1875,1,46.0
6028,2657.0,PACK OF 60 MUSHROOM CAKE CASES,4,572,5,600,28,1,10.0
6029,2658.0,61 CAKE CASES DOLLY GIRL DESIGN,3,1403,24,2500,1097,1,48.0
6030,2659.0,PACK OF 60 PINK PAISLEY CAKE CASES,5,291,22,2300,2009,1,44.0
6031,2660.0,HAND WARMER BABUSHKA DESIGN,10,100,0,100,0,1,0.0
6032,2661.0,HAND WARMER BIRD DESIGN,5,907,19,2000,1093,1,38.0
6033,2662.0,HAND WARMER OWL DESIGN,5,1545,20,2100,555,1,40.0
6034,2663.0,HAND WARMER RED RETROSPOT,7,100,0,100,0,1,0.0
6035,2664.0,SET 12 RETRO WHITE CHALK STICKS,10,728,15,1600,872,1,30.0
6036,2665.0,FELTCRAFT HAIRBAND RED AND BLUE,7,743,16,1700,957,1,32.0
6037,2666.0,FELTCRAFT HAIRBAND PINK AND PURPLE,1,352,9,1000,648,1,18.0
6038,2667.0,FELTCRAFT HAIRBANDS PINK AND WHITE ,6,110,4,500,390,1,8.0
6039,2668.0,TV DINNER TRAY DOLLY GIRL,10,243,20,2100,1857,1,40.0
6040,2669.0,PLASTERS IN TIN VINTAGE PAISLEY ,4,762,13,1400,638,1,26.0
6041,2670.0,PLASTERS IN TIN SPACEBOY,8,429,4,500,71,1,8.0
6042,2671.0,PLASTERS IN TIN WOODLAND ANIMALS,10,453,8,900,447,1,16.0
6043,2672.0,MAGIC DRAWING SLATE SPACEBOY ,6,100,0,100,0,1,0.0
6044,2673.0,MAGIC DRAWING SLATE CIRCUS PARADE  ,1,238,24,2500,2262,1,48.0
6045,2674.0,MAGIC DRAWING SLATE GO TO THE FAIR ,8,478,11,1200,722,1,22.0
6046,2675.0,MAGIC DRAWING SLATE DOLLY GIRL ,9,1014,11,1200,186,1,22.0
6047,2676.0,CHARLIE + LOLA RED HOT WATER BOTTLE,10,277,11,1200,923,1,22.0
6048,2677.0,HOT WATER BOTTLE BABUSHKA ,2,187,17,1800,1613,1,34.0
6049,2678.0,URBAN BLACK RIBBONS ,8,400,14,1500,1100,1,28.0
6050,2679.0,FELTCRAFT PRINCESS CHARLOTTE DOLL,8,331,8,900,569,1,16.0
6051,2680.0,SET OF 6 T-LIGHTS TOADSTOOLS,10,868,20,2100,1232,1,40.0
6052,2681.0,ROTATING LEAVES T-LIGHT HOLDER,3,1165,15,1600,435,1,30.0
6053,2682.0,RED  HARMONICA IN BOX ,5,482,9,1000,518,1,18.0
6054,2683.0,CUPCAKE LACE PAPER SET 7,1,1128,12,1300,172,1,24.0
6055,2684.0,FAMILY PHOTO FRAME CORNICE,5,1542,18,1900,358,1,36.0
6056,2685.0,TRIPLE PHOTO FRAME CORNICE ,3,1255,21,2200,945,1,42.0
6057,2686.0,WOODEN FRAME ANTIQUE WHITE ,9,1577,18,1900,323,1,36.0
6058,2687.0,WOODEN BOX OF DOMINOES,7,178,18,1900,1722,1,36.0
6059,2688.0,TRADITIONAL WOODEN CATCH CUP GAME ,2,627,7,800,173,1,14.0
6060,2689.0,TRADITIONAL WOODEN SKIPPING ROPE,6,911,24,2500,1589,1,48.0
6061,2690.0,S/6 WOODEN SKITTLES IN COTTON BAG,4,1511,21,2200,689,1,42.0
6062,2691.0,RED METAL BEACH SPADE ,5,149,21,2200,2051,1,42.0
6063,2692.0,BOYS VINTAGE TIN SEASIDE BUCKET,1,1159,13,1400,241,1,26.0
6064,2693.0,GIRLS VINTAGE TIN SEASIDE BUCKET,1,292,3,400,108,1,6.0
6065,2694.0,GREY HEART HOT WATER BOTTLE,10,315,3,400,85,1,6.0
6066,2695.0,SCOTTIE DOG HOT WATER BOTTLE,7,560,8,900,340,1,16.0
6067,2696.0,BIRD HOUSE HOT WATER BOTTLE,4,622,9,1000,378,1,18.0
6068,2697.0,KINGS CHOICE TEA CADDY ,1,465,22,2300,1835,1,44.0
6069,2698.0,KINGS CHOICE BISCUIT TIN,1,1622,23,2400,778,1,46.0
6070,2699.0,METAL SIGN EMPIRE TEA,10,432,14,1500,1068,1,28.0
6071,2700.0,HOMEMADE JAM SCENTED CANDLES,10,1759,23,2400,641,1,46.0
6072,2701.0,SET OF 6 SOLDIER SKITTLES,1,128,1,200,72,1,2.0
6073,2702.0,FAWN BLUE HOT WATER BOTTLE,10,104,10,1100,996,1,20.0
6074,2703.0,HAND WARMER RED RETROSPOT,6,967,14,1500,533,1,28.0
6075,2704.0,HOT WATER BOTTLE BABUSHKA ,5,751,9,1000,249,1,18.0
6076,2705.0,WHITE SKULL HOT WATER BOTTLE ,3,849,13,1400,551,1,26.0
6077,2706.0,RETROSPOT HEART HOT WATER BOTTLE,2,508,7,800,292,1,14.0
6078,2707.0,RED WOOLLY HOTTIE WHITE HEART.,8,796,18,1900,1104,1,36.0
6079,2708.0,SCOTTIE DOG HOT WATER BOTTLE,10,100,0,100,0,1,0.0
6080,2709.0,GREY HEART HOT WATER BOTTLE,7,631,9,1000,369,1,18.0
6081,2710.0,HOT WATER BOTTLE BABUSHKA ,7,2316,23,2400,84,1,46.0
6082,2711.0,PACK OF 6 BIRDY GIFT TAGS,5,518,12,1300,782,1,24.0
6083,2712.0,CHILLI LIGHTS,7,100,0,100,0,1,0.0
6084,2713.0,PIGGY BANK RETROSPOT ,4,680,12,1300,620,1,24.0
6085,2714.0,CERAMIC STRAWBERRY MONEY BOX,10,524,9,1000,476,1,18.0
6086,2715.0,CERAMIC STRAWBERRY CAKE MONEY BANK,5,496,6,700,204,1,12.0
6087,2716.0,CERAMIC CHERRY CAKE MONEY BANK,9,912,10,1100,188,1,20.0
6088,2717.0,CERAMIC HEART FAIRY CAKE MONEY BANK,3,766,12,1300,534,1,24.0
6089,2718.0,CERAMIC PIRATE CHEST MONEY BANK,1,1011,11,1200,189,1,22.0
6090,2719.0,DOORSTOP RETROSPOT HEART,3,1486,25,2600,1114,1,50.0
6091,2720.0,GINGHAM HEART  DOORSTOP RED,4,911,24,2500,1589,1,48.0
6092,2721.0,RETROSPOT BABUSHKA DOORSTOP,5,101,20,2100,1999,1,40.0
6093,2722.0,SILK PURSE BABUSHKA RED,8,132,5,600,468,1,10.0
6094,2723.0,SILK PURSE BABUSHKA PINK,10,100,0,100,0,1,0.0
6095,2724.0,FAMILY PHOTO FRAME CORNICE,8,700,13,1400,700,1,26.0
6096,2725.0,SWEETHEART WIRE WALL TIDY,7,398,5,600,202,1,10.0
6097,2726.0,JAM MAKING SET PRINTED,10,377,4,500,123,1,8.0
6098,2727.0,RED RETROSPOT OVEN GLOVE ,7,416,9,1000,584,1,18.0
6099,2728.0,CREAM HEART CARD HOLDER,10,753,10,1100,347,1,20.0
6100,2729.0,NAMASTE SWAGAT INCENSE,7,2104,25,2600,496,1,50.0
6101,2730.0,CERAMIC STRAWBERRY DESIGN MUG,3,1666,24,2500,834,1,48.0
6102,2731.0,BLACK HEART CARD HOLDER,6,1899,24,2500,601,1,48.0
6103,2732.0,CLASSICAL ROSE SMALL VASE,3,110,7,800,690,1,14.0
6104,2733.0,HYACINTH BULB T-LIGHT CANDLES,1,638,13,1400,762,1,26.0
6105,2734.0,CHRISTMAS CRAFT WHITE FAIRY ,2,622,21,2200,1578,1,42.0
6106,2735.0,CHRISTMAS CRAFT LITTLE FRIENDS,1,139,3,400,261,1,6.0
6107,2736.0,COSY HOUR CIGAR BOX MATCHES ,1,116,11,1200,1084,1,22.0
6108,2737.0,RED TEA TOWEL CLASSIC DESIGN,7,708,18,1900,1192,1,36.0
6109,2738.0,HEART FILIGREE DOVE  SMALL,6,604,13,1400,796,1,26.0
6110,2739.0,RETROSPOT CHILDRENS APRON,6,270,16,1700,1430,1,32.0
6111,2740.0,COLOURING PENCILS BROWN TUBE,9,333,19,2000,1667,1,38.0
6112,2741.0,5 IVORY DINNER CANDLES SILVER FLOCK,9,121,1,200,79,1,2.0
6113,2742.0,HEART FILIGREE DOVE  SMALL,2,2076,23,2400,324,1,46.0
6114,2743.0,ZINC METAL HEART DECORATION,7,222,2,300,78,1,4.0
6115,2744.0,GREEN FERN NOTEBOOK,6,721,14,1500,779,1,28.0
6116,2745.0,BLUE PAISLEY NOTEBOOK,10,1062,14,1500,438,1,28.0
6117,2746.0,CHRYSANTHEMUM NOTEBOOK,7,225,4,500,275,1,8.0
6118,2747.0,LARGE CHINESE STYLE SCISSOR,10,638,9,1000,362,1,18.0
6119,2748.0,SMALL CHINESE STYLE SCISSOR,5,445,12,1300,855,1,24.0
6120,2749.0,S/6 WOODEN SKITTLES IN COTTON BAG,2,928,13,1400,472,1,26.0
6121,2750.0,TRADITIONAL WOODEN SKIPPING ROPE,7,1949,19,2000,51,1,38.0
6122,2751.0,SET OF 6 SOLDIER SKITTLES,2,2096,25,2600,504,1,50.0
6123,2752.0,5 TRADITIONAL SPINNING TOPS,7,323,15,1600,1277,1,30.0
6124,2753.0,ROTATING SILVER ANGELS T-LIGHT HLDR,1,925,16,1700,775,1,32.0
6125,2754.0,BLACK LOVE BIRD CANDLE,5,389,3,400,11,1,6.0
6126,2755.0,RETROSPOT CHILDRENS APRON,1,1816,21,2200,384,1,42.0
6127,2756.0,HANGING GLASS ETCHED TEALIGHT,7,1045,10,1100,55,1,20.0
6128,2757.0,HANGING GLASS ETCHED TEALIGHT,2,200,14,1500,1300,1,28.0
6129,2758.0,BLUE NEW BAROQUE CANDLESTICK CANDLE,5,1108,21,2200,1092,1,42.0
6130,2759.0,COOKING SET RETROSPOT,9,168,7,800,632,1,14.0
6131,2760.0,KINGS CHOICE GIANT TUBE MATCHES,1,187,10,1100,913,1,20.0
6132,2761.0,COSY HOUR GIANT TUBE MATCHES,10,179,15,1600,1421,1,30.0
6133,2762.0,PLACE SETTING WHITE STAR,2,857,18,1900,1043,1,36.0
6134,2763.0,HYACINTH BULB T-LIGHT CANDLES,4,157,3,400,243,1,6.0
6135,2764.0,S/15 SILVER GLASS BAUBLES IN BAG,5,273,18,1900,1627,1,36.0
6136,2765.0,FRENCH WC SIGN BLUE METAL,5,132,2,300,168,1,4.0
6137,2766.0,KINGS CHOICE GIANT TUBE MATCHES,7,240,24,2500,2260,1,48.0
6138,2767.0,73 SWEETHEART FAIRY CAKE CASES,6,448,7,800,352,1,14.0
6139,2768.0,ASSORTED COLOUR BIRD ORNAMENT,4,128,4,500,372,1,8.0
6140,2769.0,FAIRY SOAP SOAP HOLDER,4,1923,21,2200,277,1,42.0
6141,2770.0,GREEN GIANT GARDEN THERMOMETER,4,349,25,2600,2251,1,50.0
6142,2771.0,IVORY GIANT GARDEN THERMOMETER,9,274,2,300,26,1,4.0
6143,2772.0,BLUE GIANT GARDEN THERMOMETER,3,1197,12,1300,103,1,24.0
6144,2773.0,PACK OF 60 PINK PAISLEY CAKE CASES,6,111,3,400,289,1,6.0
6145,2774.0,RETROSPOT HEART HOT WATER BOTTLE,2,412,8,900,488,1,16.0
6146,2775.0,CHICK GREY HOT WATER BOTTLE,8,516,18,1900,1384,1,36.0
6147,2776.0,VICTORIAN SEWING BOX SMALL ,9,951,21,2200,1249,1,42.0
6148,2777.0,VICTORIAN SEWING BOX MEDIUM,4,1594,17,1800,206,1,34.0
6149,2778.0,SET/10 RED POLKADOT PARTY CANDLES,5,1059,10,1100,41,1,20.0
6150,2779.0,WASHROOM METAL SIGN,1,272,2,300,28,1,4.0
6151,2780.0,BLACK SWEETHEART BRACELET,6,1382,19,2000,618,1,38.0
6152,2781.0,DIAMANTE HAIR GRIP PACK/2 BLACK DIA,2,512,9,1000,488,1,18.0
6153,2782.0,BLACK DIAMANTE EXPANDABLE RING,7,772,11,1200,428,1,22.0
6154,2783.0,DIAMANTE HAIR GRIP PACK/2 RUBY,10,661,12,1300,639,1,24.0
6155,2784.0,DIAMANTE HAIR GRIP PACK/2 MONTANA,3,869,15,1600,731,1,30.0
6156,2785.0,BLUE SWEETHEART BRACELET,5,237,3,400,163,1,6.0
6157,2786.0,PINK SWEETHEART BRACELET,3,660,18,1900,1240,1,36.0
6158,2787.0,PURPLE SWEETHEART BRACELET,3,685,12,1300,615,1,24.0
6159,2788.0,JUMBO BAG PINK POLKADOT,2,199,23,2400,2201,1,46.0
6160,2789.0,JUMBO BAG RED RETROSPOT,3,1539,19,2000,461,1,38.0
6161,2790.0,ASSORTED COLOUR BIRD ORNAMENT,6,1074,11,1200,126,1,22.0
6162,2791.0,PAPER CHAIN KIT 50'S CHRISTMAS ,2,100,0,100,0,1,0.0
6163,2792.0,RIBBON REEL CHRISTMAS PRESENT ,1,724,12,1300,576,1,24.0
6164,2793.0,FIRST AID TIN,9,131,2,300,169,1,4.0
6165,2794.0,MAKE YOUR OWN MONSOON CARD KIT,3,734,17,1800,1066,1,34.0
6166,2795.0,PACK OF 12 HEARTS DESIGN TISSUES ,1,212,4,500,288,1,8.0
6167,2796.0,PACK OF 12 RED RETROSPOT TISSUES ,2,1905,25,2600,695,1,50.0
6168,2797.0,SOLDIERS EGG CUP ,5,1340,16,1700,360,1,32.0
6169,2798.0,HEART IVORY TRELLIS SMALL,2,1010,14,1500,490,1,28.0
6170,2799.0,HEART FILIGREE DOVE  SMALL,2,217,4,500,283,1,8.0
6171,2800.0,HEART FILIGREE DOVE LARGE,9,1065,12,1300,235,1,24.0
6172,2801.0,PACK 3 BOXES BIRD PANNETONE ,8,987,12,1300,313,1,24.0
6173,2802.0,PACK 3 BOXES CHRISTMAS PANNETONE,5,968,11,1200,232,1,22.0
6174,2803.0,SMALL POPCORN HOLDER,1,1798,17,1800,2,1,34.0
6175,2804.0,PACK OF 60 PINK PAISLEY CAKE CASES,5,2053,22,2300,247,1,44.0
6176,2805.0,SET OF 6 SOLDIER SKITTLES,4,100,0,100,0,1,0.0
6177,2806.0,SWIRLY CIRCULAR RUBBERS IN BAG,7,851,12,1300,449,1,24.0
6178,2807.0,VINTAGE PAISLEY STATIONERY SET,1,191,16,1700,1509,1,32.0
6179,2808.0,PAPER CHAIN KIT VINTAGE CHRISTMAS,8,678,6,700,22,1,12.0
6180,2809.0,SET/10 BLUE POLKADOT PARTY CANDLES,1,449,10,1100,651,1,20.0
6181,2810.0,RIBBON REEL SOCKS AND MITTENS,10,331,9,1000,669,1,18.0
6182,2811.0,61 CAKE CASES VINTAGE CHRISTMAS,4,520,23,2400,1880,1,46.0
6183,2812.0,CHRISTMAS METAL TAGS ASSORTED ,5,447,7,800,353,1,14.0
6184,2813.0,CHRISTMAS TREE T-LIGHT HOLDER,3,150,17,1800,1650,1,34.0
6185,2814.0,STAR  T-LIGHT HOLDER ,6,529,8,900,371,1,16.0
6186,2815.0,HEART T-LIGHT HOLDER ,10,1049,13,1400,351,1,26.0
6187,2816.0,MINI FUNKY DESIGN TAPES,9,219,4,500,281,1,8.0
6188,2817.0,SET OF 6 T-LIGHTS SNOWMEN,9,1122,23,2400,1278,1,46.0
6189,2818.0,STAR WOODEN CHRISTMAS DECORATION,1,1037,23,2400,1363,1,46.0
6190,2819.0,WOODEN HEART CHRISTMAS SCANDINAVIAN,9,182,13,1400,1218,1,26.0
6191,2820.0,CHRISTMAS RETROSPOT TREE WOOD,9,590,21,2200,1610,1,42.0
6192,2821.0,SET OF 6 T-LIGHTS SANTA,7,876,14,1500,624,1,28.0
6193,2822.0,SET/9 CHRISTMAS T-LIGHTS SCENTED ,3,627,22,2300,1673,1,44.0
6194,2823.0,BLUE ROSE FABRIC MIRROR,4,612,7,800,188,1,14.0
6195,2824.0,THREE CANVAS LUGGAGE TAGS,2,858,17,1800,942,1,34.0
6196,2825.0,RETROSPOT PARTY BAG + STICKER SET,2,100,0,100,0,1,0.0
6197,2826.0,PLASTERS IN TIN VINTAGE PAISLEY ,2,628,10,1100,472,1,20.0
6198,2827.0,RETROSPOT SMALL TUBE MATCHES,1,307,12,1300,993,1,24.0
6199,2828.0,HAND WARMER SCOTTY DOG DESIGN,5,374,4,500,126,1,8.0
6200,2829.0,3D CHRISTMAS STAMPS STICKERS ,5,391,11,1200,809,1,22.0
6201,2830.0,HAND WARMER SCOTTY DOG DESIGN,3,1435,15,1600,165,1,30.0
6202,2831.0,HAND WARMER SCOTTY DOG DESIGN,10,305,3,400,95,1,6.0
6203,2832.0,CLOTHES PEGS RETROSPOT PACK 25,1,1452,18,1900,448,1,36.0
6204,2833.0,37 FOIL HEART CAKE CASES,5,750,9,1000,250,1,18.0
6205,2834.0,CHRISTMAS METAL TAGS ASSORTED ,3,863,8,900,37,1,16.0
6206,2835.0,PACK OF 6 SWEETIE GIFT BOXES,5,615,19,2000,1385,1,38.0
6207,2836.0,PACK OF 72 RETROSPOT CAKE CASES,9,159,6,700,541,1,12.0
6208,2837.0,PACK OF 72 RETROSPOT CAKE CASES,7,280,8,900,620,1,16.0
6209,2838.0,PACK OF 6 BIRDY GIFT TAGS,5,1187,20,2100,913,1,40.0
6210,2839.0,SET/10 RED POLKADOT PARTY CANDLES,8,270,3,400,130,1,6.0
6211,2840.0,SET/10 PINK POLKADOT PARTY CANDLES,8,373,8,900,527,1,16.0
6212,2841.0,SET OF 3 NOTEBOOKS IN PARCEL,2,665,10,1100,435,1,20.0
6213,2842.0,STAR  T-LIGHT HOLDER ,7,465,9,1000,535,1,18.0
6214,2843.0,CINAMMON SET OF 9 T-LIGHTS,3,568,25,2600,2032,1,50.0
6215,2844.0,ORANGE SCENTED SET/9 T-LIGHTS,5,326,4,500,174,1,8.0
6216,2845.0,RIBBON REEL STRIPES DESIGN ,5,176,1,200,24,1,2.0
6217,2846.0,SET OF 2 TINS JARDIN DE PROVENCE,4,799,7,800,1,1,14.0
6218,2847.0,MAKE YOUR OWN PLAYTIME CARD KIT,1,129,4,500,371,1,8.0
6219,2848.0,DINOSAURS  WRITING SET ,3,549,15,1600,1051,1,30.0
6220,2849.0,BALLOONS  WRITING SET ,2,738,23,2400,1662,1,46.0
6221,2850.0,SKULLS WRITING SET ,4,195,3,400,205,1,6.0
6222,2851.0,VINTAGE PAISLEY STATIONERY SET,3,650,14,1500,850,1,28.0
6223,2852.0,COSY SLIPPER SHOES SMALL  RED ,8,100,0,100,0,1,0.0
6224,2853.0,DOORMAT BLACK FLOCK ,3,914,17,1800,886,1,34.0
6225,2854.0,JUMBO  BAG BAROQUE BLACK WHITE,10,316,24,2500,2184,1,48.0
6226,2855.0,JAM MAKING SET WITH JARS,8,1015,21,2200,1185,1,42.0
6227,2856.0,ORANGE SCENTED SET/9 T-LIGHTS,4,554,6,700,146,1,12.0
6228,2857.0,CINAMMON SET OF 9 T-LIGHTS,4,1358,23,2400,1042,1,46.0
6229,2858.0,HAND WARMER SCOTTY DOG DESIGN,5,467,8,900,433,1,16.0
6230,2859.0,CHRISTMAS DECOUPAGE CANDLE,8,506,5,600,94,1,10.0
6231,2860.0,HEART T-LIGHT HOLDER ,3,199,10,1100,901,1,20.0
6232,2861.0,GROW YOUR OWN BASIL IN ENAMEL MUG,6,298,23,2400,2102,1,46.0
6233,2862.0,OFFICE MUG WARMER POLKADOT,3,343,17,1800,1457,1,34.0
6234,2863.0,SMALL POPCORN HOLDER,2,283,13,1400,1117,1,26.0
6235,2864.0,JUMBO BAG DOLLY GIRL DESIGN,4,1597,17,1800,203,1,34.0
6236,2865.0,JAM MAKING SET WITH JARS,7,176,16,1700,1524,1,32.0
6237,2866.0,JAM MAKING SET PRINTED,6,674,16,1700,1026,1,32.0
6238,2867.0,SMALL GLASS HEART TRINKET POT,6,536,22,2300,1764,1,44.0
6239,2868.0,RED WOOLLY HOTTIE WHITE HEART.,6,442,15,1600,1158,1,30.0
6240,2869.0,BLACK RECORD COVER FRAME,2,1145,20,2100,955,1,40.0
6241,2870.0,"RECORD FRAME 7"" SINGLE SIZE ",6,1474,20,2100,626,1,40.0
6242,2871.0,37 PENCILS TUBE RED RETROSPOT,2,354,7,800,446,1,14.0
6243,2872.0,37 PENCILS TUBE WOODLAND,3,245,2,300,55,1,4.0
6244,2873.0,SET OF 6 SOLDIER SKITTLES,5,886,16,1700,814,1,32.0
6245,2874.0,ROCKING HORSE RED CHRISTMAS ,8,1733,22,2300,567,1,44.0
6246,2875.0,CHRISTMAS GINGHAM HEART,8,1766,20,2100,334,1,40.0
6247,2876.0,CHRISTMAS GINGHAM STAR,10,469,13,1400,931,1,26.0
6248,2877.0,HAND WARMER UNION JACK,5,238,2,300,62,1,4.0
6249,2878.0,HAND WARMER RED RETROSPOT,6,2358,24,2500,142,1,48.0
6250,2879.0,REGENCY CAKESTAND 3 TIER,9,907,9,1000,93,1,18.0
6251,2880.0,JUMBO SHOPPER VINTAGE RED PAISLEY,9,413,5,600,187,1,10.0
6252,2881.0,RIBBON REEL SNOWY VILLAGE,10,257,16,1700,1443,1,32.0
6253,2882.0,VINTAGE UNION JACK BUNTING,5,541,5,600,59,1,10.0
6254,2883.0,JAM MAKING SET WITH JARS,8,838,8,900,62,1,16.0
6255,2884.0,RIBBON REEL STRIPES DESIGN ,1,924,22,2300,1376,1,44.0
6256,2885.0,RETRO LONGBOARD IRONING BOARD COVER,2,1109,13,1400,291,1,26.0
6257,2886.0,3D DOG PICTURE PLAYING CARDS,2,1567,16,1700,133,1,32.0
6258,2887.0,RETROSPOT CIGAR BOX MATCHES ,9,462,23,2400,1938,1,46.0
6259,2888.0,SET/9 CHRISTMAS T-LIGHTS SCENTED ,9,1778,24,2500,722,1,48.0
6260,2889.0,ROTATING SILVER ANGELS T-LIGHT HLDR,5,142,2,300,158,1,4.0
6261,2890.0,ROTATING SILVER ANGELS T-LIGHT HLDR,4,952,9,1000,48,1,18.0
6262,2891.0,SAVE THE PLANET COTTON TOTE BAG,7,211,16,1700,1489,1,32.0
6263,2892.0,SET OF 20 VINTAGE CHRISTMAS NAPKINS,7,386,17,1800,1414,1,34.0
6264,2893.0,PAPER BUNTING WHITE LACE,10,984,21,2200,1216,1,42.0
6265,2894.0,GENTLEMAN SHIRT REPAIR KIT ,4,1242,21,2200,958,1,42.0
6266,2895.0,CARD I LOVE LONDON ,5,210,6,700,490,1,12.0
6267,2896.0,PAPER CHAIN KIT VINTAGE CHRISTMAS,10,293,2,300,7,1,4.0
6268,2897.0,MIRRORED WALL ART FOXY,3,116,1,200,84,1,2.0
6269,2898.0,MIRRORED WALL ART GENTS,6,814,15,1600,786,1,30.0
6270,2899.0,AIRLINE BAG VINTAGE JET SET WHITE,9,835,11,1200,365,1,22.0
6271,2900.0,JAM MAKING SET PRINTED,1,425,5,600,175,1,10.0
6272,2901.0,POTTING SHED SOW 'N' GROW SET,1,138,13,1400,1262,1,26.0
6273,2902.0,BABUSHKA LIGHTS STRING OF 11,2,1021,10,1100,79,1,20.0
6274,2903.0,REX CASH+CARRY JUMBO SHOPPER,2,910,20,2100,1190,1,40.0
6275,2904.0,AIRLINE BAG VINTAGE WORLD CHAMPION ,7,421,19,2000,1579,1,38.0
6276,2905.0,HAND WARMER BIRD DESIGN,9,284,8,900,616,1,16.0
6277,2906.0,CHRISTMAS CRAFT LITTLE FRIENDS,9,1200,17,1800,600,1,34.0
6278,2907.0,PINK HEARTS PAPER GARLAND,10,217,16,1700,1483,1,32.0
6279,2908.0,POTTING SHED SEED ENVELOPES,10,1186,19,2000,814,1,38.0
6280,2909.0,HI TEC ALPINE HAND WARMER,8,1494,19,2000,506,1,38.0
6281,2910.0,FELTCRAFT CHRISTMAS FAIRY,2,558,7,800,242,1,14.0
6282,2911.0,HI TEC ALPINE HAND WARMER,5,687,14,1500,813,1,28.0
6283,2912.0,ROTATING SILVER ANGELS T-LIGHT HLDR,2,842,22,2300,1458,1,44.0
6284,2913.0,4 STRIPEY MICE FELTCRAFT,1,714,8,900,186,1,16.0
6285,2914.0,FELTCRAFT 6 FLOWER FRIENDS,8,208,7,800,592,1,14.0
6286,2915.0,CHRISTMAS CRAFT LITTLE FRIENDS,3,100,0,100,0,1,0.0
6287,2916.0,VINTAGE UNION JACK CUSHION COVER,7,1607,23,2400,793,1,46.0
6288,2917.0,POLYESTER FILLER PAD 45x45cm,5,107,19,2000,1893,1,38.0
6289,2918.0,DOLLY GIRL LUNCH BOX,4,1569,22,2300,731,1,44.0
6290,2919.0,PACK OF 12 LONDON TISSUES ,4,989,19,2000,1011,1,38.0
6291,2920.0,CARD DOLLY GIRL ,5,179,4,500,321,1,8.0
6292,2921.0,CARD BILLBOARD FONT,2,762,12,1300,538,1,24.0
6293,2922.0,RAINY LADIES BIRTHDAY CARD,8,1139,22,2300,1161,1,44.0
6294,2923.0,GREY HEART HOT WATER BOTTLE,4,1560,15,1600,40,1,30.0
6295,2924.0,RED WOOLLY HOTTIE WHITE HEART.,5,360,3,400,40,1,6.0
6296,2925.0,RED WHITE SCARF  HOT WATER BOTTLE,6,292,2,300,8,1,4.0
6297,2926.0, SET 2 TEA TOWELS I LOVE LONDON ,9,195,3,400,205,1,6.0
6298,2927.0,SET OF 2 TEA TOWELS APPLE AND PEARS,10,118,12,1300,1182,1,24.0
6299,2928.0,SET/2 RED RETROSPOT TEA TOWELS ,8,221,25,2600,2379,1,50.0
6300,2929.0,LOVE BUILDING BLOCK WORD,3,1876,23,2400,524,1,46.0
6301,2930.0,HOME BUILDING BLOCK WORD,5,533,14,1500,967,1,28.0
6302,2931.0,ASSORTED COLOUR BIRD ORNAMENT,10,269,15,1600,1331,1,30.0
6303,2932.0,LANTERN CREAM GAZEBO ,6,356,7,800,444,1,14.0
6304,2933.0,BLUE BIRDHOUSE DECORATION,10,1850,24,2500,650,1,48.0
6305,2934.0,WHITE HANGING HEART T-LIGHT HOLDER,2,500,4,500,0,1,8.0
6306,2935.0,REGENCY CAKESTAND 3 TIER,10,195,2,300,105,1,4.0
6307,2936.0,ANTIQUE SILVER TEA GLASS ENGRAVED,3,100,0,100,0,1,0.0
6308,2937.0,AGED GLASS SILVER T-LIGHT HOLDER,4,805,13,1400,595,1,26.0
6309,2938.0,JAM MAKING SET WITH JARS,3,166,9,1000,834,1,18.0
6310,2939.0,HAND WARMER OWL DESIGN,9,464,9,1000,536,1,18.0
6311,2940.0,SET OF 2 WOODEN MARKET CRATES,1,1043,24,2500,1457,1,48.0
6312,2941.0,SET OF 6 T-LIGHTS TOADSTOOLS,1,1233,15,1600,367,1,30.0
6313,2942.0,HAND WARMER UNION JACK,10,698,19,2000,1302,1,38.0
6314,2943.0,HAND WARMER SCOTTY DOG DESIGN,6,495,8,900,405,1,16.0
6315,2944.0,CLASSIC FRENCH STYLE BASKET NATURAL,5,425,4,500,75,1,8.0
6316,2945.0,CRAZY DAISY HEART DECORATION,10,1477,22,2300,823,1,44.0
6317,2946.0,GIN + TONIC DIET METAL SIGN,7,232,10,1100,868,1,20.0
6318,2947.0,IVORY GIANT GARDEN THERMOMETER,8,1034,16,1700,666,1,32.0
6319,2948.0,CARD HOLDER GINGHAM HEART,4,862,10,1100,238,1,20.0
6320,2949.0,SMALL STRIPES CHOCOLATE GIFT BAG ,6,109,14,1500,1391,1,28.0
6321,2950.0,S/6 WOODEN SKITTLES IN COTTON BAG,8,379,22,2300,1921,1,44.0
6322,2951.0,HAND WARMER RED RETROSPOT,10,557,12,1300,743,1,24.0
6323,2952.0,HAND WARMER UNION JACK,2,554,25,2600,2046,1,50.0
6324,2953.0,FRENCH WC SIGN BLUE METAL,10,322,3,400,78,1,6.0
6325,2954.0,PINK UNION JACK  LUGGAGE TAG,4,250,12,1300,1050,1,24.0
6326,2955.0,"TRAY, BREAKFAST IN BED",1,1327,13,1400,73,1,26.0
6327,2956.0,PIZZA PLATE IN BOX,6,343,18,1900,1557,1,36.0
6328,2957.0,HEART OF WICKER LARGE,3,389,3,400,11,1,6.0
6329,2958.0,PINK HEART DOTS HOT WATER BOTTLE,2,716,9,1000,284,1,18.0
6330,2959.0,PLACE SETTING WHITE HEART,10,228,3,400,172,1,6.0
6331,2960.0,SET OF 4 NAPKIN CHARMS LEAVES   ,9,284,4,500,216,1,8.0
6332,2961.0,SET OF 4 NAPKIN CHARMS STARS   ,7,722,19,2000,1278,1,38.0
6333,2962.0,SET OF 4 NAPKIN CHARMS CUTLERY,2,319,17,1800,1481,1,34.0
6334,2963.0,CARAVAN SQUARE TISSUE BOX,4,191,1,200,9,1,2.0
6335,2964.0,PLASTERS IN TIN SKULLS,5,895,20,2100,1205,1,40.0
6336,2965.0,PLASTERS IN TIN SPACEBOY,2,302,8,900,598,1,16.0
6337,2966.0,BUTTON BOX ,1,230,9,1000,770,1,18.0
6338,2967.0,PLASTERS IN TIN VINTAGE PAISLEY ,2,355,3,400,45,1,6.0
6339,2968.0,13 MESSAGE CARDS WITH ENVELOPES,3,160,1,200,40,1,2.0
6340,2969.0,SMALL RED BABUSHKA NOTEBOOK ,6,227,8,900,673,1,16.0
6341,2970.0,CUPCAKE LACE PAPER SET 7,8,881,19,2000,1119,1,38.0
6342,2971.0,PACK 3 BOXES CHRISTMAS PANNETONE,10,578,5,600,22,1,10.0
6343,2972.0,HERB MARKER MINT,3,1274,16,1700,426,1,32.0
6344,2973.0,HERB MARKER ROSEMARY,7,1727,21,2200,473,1,42.0
6345,2974.0,HERB MARKER BASIL,2,785,9,1000,215,1,18.0
6346,2975.0,HERB MARKER CHIVES ,3,886,10,1100,214,1,20.0
6347,2976.0,HERB MARKER PARSLEY,2,730,22,2300,1570,1,44.0
6348,2977.0,HERB MARKER THYME,9,739,24,2500,1761,1,48.0
6349,2978.0,WHITE HANGING HEART T-LIGHT HOLDER,5,100,0,100,0,1,0.0
6350,2979.0,METAL MERRY CHRISTMAS WREATH,6,146,5,600,454,1,10.0
6351,2980.0,WHITE CHRISTMAS GARLAND STARS TREES,5,1048,12,1300,252,1,24.0
6352,2981.0,RETROSPOT SMALL TUBE MATCHES,10,112,6,700,588,1,12.0
6353,2982.0,RETROSPOT GIANT TUBE MATCHES,8,732,9,1000,268,1,18.0
6354,2983.0,PLACE SETTING WHITE STAR,2,457,12,1300,843,1,24.0
6355,2984.0,GROW YOUR OWN BASIL IN ENAMEL MUG,5,793,14,1500,707,1,28.0
6356,2985.0,37 FOIL STAR CAKE CASES ,2,252,18,1900,1648,1,36.0
6357,2986.0,37 FOIL HEART CAKE CASES,7,2154,23,2400,246,1,46.0
6358,2987.0,PACK OF 6 SWEETIE GIFT BOXES,3,169,1,200,31,1,2.0
6359,2988.0,PACK OF 6 HANDBAG GIFT BOXES,6,134,4,500,366,1,8.0
6360,2989.0,GARLAND WOODEN HAPPY EASTER,3,245,6,700,455,1,12.0
6361,2990.0,CALENDAR PAPER CUT DESIGN,7,257,2,300,43,1,4.0
6362,2991.0,CALENDAR IN SEASON DESIGN,9,894,15,1600,706,1,30.0
6363,2992.0,SMALL POPCORN HOLDER,5,373,5,600,227,1,10.0
6364,2993.0,BLUE PAISLEY TISSUE BOX,3,1212,25,2600,1388,1,50.0
6365,2994.0,HEART OF WICKER SMALL,2,367,4,500,133,1,8.0
6366,2995.0,SKULLS SQUARE TISSUE BOX,9,108,10,1100,992,1,20.0
6367,2996.0,SKULLS SQUARE TISSUE BOX,7,277,5,600,323,1,10.0
6368,2997.0,WHITE HANGING HEART T-LIGHT HOLDER,3,2427,24,2500,73,1,48.0
6369,2998.0,WHITE METAL LANTERN,8,136,17,1800,1664,1,34.0
6370,2999.0,CREAM CUPID HEARTS COAT HANGER,1,182,3,400,218,1,6.0
6371,3000.0,KNITTED UNION FLAG HOT WATER BOTTLE,3,389,3,400,11,1,6.0
6372,3001.0,RED WOOLLY HOTTIE WHITE HEART.,2,437,16,1700,1263,1,32.0
6373,3002.0,SET 7 BABUSHKA NESTING BOXES,2,211,16,1700,1489,1,32.0
6374,3003.0,GLASS STAR FROSTED T-LIGHT HOLDER,8,371,4,500,129,1,8.0
6375,3004.0,HAND WARMER UNION JACK,4,1804,24,2500,696,1,48.0
6376,3005.0,HAND WARMER RED POLKA DOT,10,355,24,2500,2145,1,48.0
6377,3006.0,ASSORTED COLOUR BIRD ORNAMENT,2,455,7,800,345,1,14.0
6378,3007.0,POPPY'S PLAYHOUSE BEDROOM ,10,306,7,800,494,1,14.0
6379,3008.0,POPPY'S PLAYHOUSE KITCHEN,4,388,10,1100,712,1,20.0
6380,3009.0,FELTCRAFT PRINCESS CHARLOTTE DOLL,8,198,17,1800,1602,1,34.0
6381,3010.0,IVORY KNITTED MUG COSY ,6,125,1,200,75,1,2.0
6382,3011.0,BOX OF 6 ASSORTED COLOUR TEASPOONS,10,1947,19,2000,53,1,38.0
6383,3012.0,BOX OF VINTAGE JIGSAW BLOCKS ,2,222,3,400,178,1,6.0
6384,3013.0,BOX OF VINTAGE ALPHABET BLOCKS,9,1712,18,1900,188,1,36.0
6385,3014.0,HOME BUILDING BLOCK WORD,2,496,5,600,104,1,10.0
6386,3015.0,LOVE BUILDING BLOCK WORD,5,398,4,500,102,1,8.0
6387,3016.0,RECIPE BOX WITH METAL HEART,2,830,20,2100,1270,1,40.0
6388,3017.0,DOORMAT NEW ENGLAND,5,1137,12,1300,163,1,24.0
6389,3018.0,JAM MAKING SET WITH JARS,2,1659,20,2100,441,1,40.0
6390,3019.0,RED COAT RACK PARIS FASHION,4,809,13,1400,591,1,26.0
6391,3020.0,YELLOW COAT RACK PARIS FASHION,2,1063,13,1400,337,1,26.0
6392,3021.0,BLUE COAT RACK PARIS FASHION,7,469,5,600,131,1,10.0
6393,3022.0,BATH BUILDING BLOCK WORD,8,635,22,2300,1665,1,44.0
6394,3023.0,ALARM CLOCK BAKELIKE PINK,8,232,15,1600,1368,1,30.0
6395,3024.0,ALARM CLOCK BAKELIKE RED ,5,1269,12,1300,31,1,24.0
6396,3025.0,ALARM CLOCK BAKELIKE GREEN,6,336,8,900,564,1,16.0
6397,3026.0,PANDA AND BUNNIES STICKER SHEET,7,490,7,800,310,1,14.0
6398,3027.0,STARS GIFT TAPE ,6,1025,13,1400,375,1,26.0
6399,3028.0,INFLATABLE POLITICAL GLOBE ,4,913,10,1100,187,1,20.0
6400,3029.0,VINTAGE HEADS AND TAILS CARD GAME ,9,1998,20,2100,102,1,40.0
6401,3030.0,SET/2 RED RETROSPOT TEA TOWELS ,2,174,9,1000,826,1,18.0
6402,3031.0,ROUND SNACK BOXES SET OF4 WOODLAND ,2,787,9,1000,213,1,18.0
6403,3032.0,SPACEBOY LUNCH BOX ,6,192,20,2100,1908,1,40.0
6404,3033.0,LUNCH BOX I LOVE LONDON,3,239,5,600,361,1,10.0
6405,3034.0,CIRCUS PARADE LUNCH BOX ,5,644,21,2200,1556,1,42.0
6406,3035.0,CHARLOTTE BAG DOLLY GIRL DESIGN,6,441,10,1100,659,1,20.0
6407,3036.0,RED TOADSTOOL LED NIGHT LIGHT,5,135,1,200,65,1,2.0
6408,3037.0, SET 2 TEA TOWELS I LOVE LONDON ,7,924,23,2400,1476,1,46.0
6409,3038.0,VINTAGE SEASIDE JIGSAW PUZZLES,6,599,7,800,201,1,14.0
6410,3039.0,MINI JIGSAW CIRCUS PARADE ,6,407,8,900,493,1,16.0
6411,3040.0,MINI JIGSAW SPACEBOY,1,411,11,1200,789,1,22.0
6412,3041.0,MINI PAINT SET VINTAGE ,6,346,6,700,354,1,12.0
6413,3042.0,POSTAGE,1,120,4,500,380,1,8.0
6414,3043.0,PAPER CHAIN KIT 50'S CHRISTMAS ,10,201,25,2600,2399,1,50.0
6415,3044.0,HAND WARMER RED POLKA DOT,7,881,9,1000,119,1,18.0
6416,3045.0,HAND WARMER UNION JACK,7,1380,16,1700,320,1,32.0
6417,3046.0,WHITE HANGING HEART T-LIGHT HOLDER,1,583,18,1900,1317,1,36.0
6418,3047.0,WHITE METAL LANTERN,8,514,22,2300,1786,1,44.0
6419,3048.0,CREAM CUPID HEARTS COAT HANGER,8,949,10,1100,151,1,20.0
6420,3049.0,EDWARDIAN PARASOL RED,5,827,16,1700,873,1,32.0
6421,3050.0,RETRO COFFEE MUGS ASSORTED,4,1649,19,2000,351,1,38.0
6422,3051.0,SAVE THE PLANET MUG,6,1933,19,2000,67,1,38.0
6423,3052.0,VINTAGE BILLBOARD DRINK ME MUG,7,747,8,900,153,1,16.0
6424,3053.0,VINTAGE BILLBOARD LOVE/HATE MUG,9,1292,16,1700,408,1,32.0
6425,3054.0,WOOD 2 DRAWER CABINET WHITE FINISH,1,754,21,2200,1446,1,42.0
6426,3055.0,WOOD S/3 CABINET ANT WHITE FINISH,4,2370,25,2600,230,1,50.0
6427,3056.0,WOODEN PICTURE FRAME WHITE FINISH,3,251,4,500,249,1,8.0
6428,3057.0,WOODEN FRAME ANTIQUE WHITE ,10,355,13,1400,1045,1,26.0
6429,3058.0,KNITTED UNION FLAG HOT WATER BOTTLE,7,132,8,900,768,1,16.0
6430,3059.0,RED WOOLLY HOTTIE WHITE HEART.,5,553,8,900,347,1,16.0
6431,3060.0,SET 7 BABUSHKA NESTING BOXES,3,749,17,1800,1051,1,34.0
6432,3061.0,GLASS STAR FROSTED T-LIGHT HOLDER,8,1526,18,1900,374,1,36.0
6433,3062.0,VICTORIAN SEWING BOX LARGE,8,1210,15,1600,390,1,30.0
6434,3063.0,WHITE HANGING HEART T-LIGHT HOLDER,8,375,8,900,525,1,16.0
6435,3064.0,WHITE METAL LANTERN,4,187,16,1700,1513,1,32.0
6436,3065.0,CREAM CUPID HEARTS COAT HANGER,2,406,20,2100,1694,1,40.0
6437,3066.0,EDWARDIAN PARASOL RED,2,185,15,1600,1415,1,30.0
6438,3067.0,RETRO COFFEE MUGS ASSORTED,9,153,1,200,47,1,2.0
6439,3068.0,SAVE THE PLANET MUG,3,445,9,1000,555,1,18.0
6440,3069.0,VINTAGE BILLBOARD DRINK ME MUG,2,1753,23,2400,647,1,46.0
6441,3070.0,VINTAGE BILLBOARD LOVE/HATE MUG,9,577,10,1100,523,1,20.0
6442,3071.0,WOOD 2 DRAWER CABINET WHITE FINISH,7,332,11,1200,868,1,22.0
6443,3072.0,WOOD S/3 CABINET ANT WHITE FINISH,3,275,2,300,25,1,4.0
6444,3073.0,WOODEN PICTURE FRAME WHITE FINISH,4,360,13,1400,1040,1,26.0
6445,3074.0,WOODEN FRAME ANTIQUE WHITE ,2,206,2,300,94,1,4.0
6446,3075.0,KNITTED UNION FLAG HOT WATER BOTTLE,3,315,8,900,585,1,16.0
6447,3076.0,RED WOOLLY HOTTIE WHITE HEART.,6,131,21,2200,2069,1,42.0
6448,3077.0,SET 7 BABUSHKA NESTING BOXES,6,809,22,2300,1491,1,44.0
6449,3078.0,GLASS STAR FROSTED T-LIGHT HOLDER,9,1338,18,1900,562,1,36.0
6450,3079.0,HOT WATER BOTTLE TEA AND SYMPATHY,1,100,2,300,200,1,4.0
6451,3080.0,RED HANGING HEART T-LIGHT HOLDER,4,1188,19,2000,812,1,38.0
6452,3081.0,HAND WARMER RED POLKA DOT,3,462,8,900,438,1,16.0
6453,3082.0,HAND WARMER UNION JACK,7,514,20,2100,1586,1,40.0
6454,3083.0,JUMBO BAG PINK POLKADOT,7,283,5,600,317,1,10.0
6455,3084.0,JUMBO  BAG BAROQUE BLACK WHITE,3,712,22,2300,1588,1,44.0
6456,3085.0,JUMBO BAG CHARLIE AND LOLA TOYS,6,210,2,300,90,1,4.0
6457,3086.0,STRAWBERRY CHARLOTTE BAG,5,100,0,100,0,1,0.0
6458,3087.0,RED 3 PIECE RETROSPOT CUTLERY SET,6,353,4,500,147,1,8.0
6459,3088.0,BLUE 3 PIECE POLKADOT CUTLERY SET,6,778,21,2200,1422,1,42.0
6460,3089.0,SET/6 RED SPOTTY PAPER PLATES,6,783,7,800,17,1,14.0
6461,3090.0,LUNCH BAG RED RETROSPOT,6,382,9,1000,618,1,18.0
6462,3091.0,STRAWBERRY LUNCH BOX WITH CUTLERY,3,438,7,800,362,1,14.0
6463,3092.0,LUNCH BOX WITH CUTLERY RETROSPOT ,6,442,4,500,58,1,8.0
6464,3093.0,PACK OF 72 RETROSPOT CAKE CASES,4,281,2,300,19,1,4.0
6465,3094.0,PACK OF 60 DINOSAUR CAKE CASES,7,699,16,1700,1001,1,32.0
6466,3095.0,PACK OF 60 PINK PAISLEY CAKE CASES,1,329,25,2600,2271,1,50.0
6467,3096.0,62 TEATIME FAIRY CAKE CASES,8,584,9,1000,416,1,18.0
6468,3097.0,TOMATO CHARLIE+LOLA COASTER SET,8,1534,16,1700,166,1,32.0
6469,3098.0,CHARLIE & LOLA WASTEPAPER BIN FLORA,5,581,15,1600,1019,1,30.0
6470,3099.0,RED CHARLIE+LOLA PERSONAL DOORSIGN,5,165,9,1000,835,1,18.0
6471,3100.0,JUMBO STORAGE BAG SUKI,6,144,15,1600,1456,1,30.0
6472,3101.0,JUMBO BAG PINK VINTAGE PAISLEY,6,885,8,900,15,1,16.0
6473,3102.0,JAM MAKING SET PRINTED,7,312,5,600,288,1,10.0
6474,3103.0,RETROSPOT TEA SET CERAMIC 11 PC ,2,159,1,200,41,1,2.0
6475,3104.0,GIRLY PINK TOOL SET,5,455,8,900,445,1,16.0
6476,3105.0,JUMBO SHOPPER VINTAGE RED PAISLEY,4,481,6,700,219,1,12.0
6477,3106.0,"AIRLINE LOUNGE,METAL SIGN",7,1236,13,1400,164,1,26.0
6478,3107.0,WHITE SPOT RED CERAMIC DRAWER KNOB,5,1291,24,2500,1209,1,48.0
6479,3108.0,RED DRAWER KNOB ACRYLIC EDWARDIAN,6,844,8,900,56,1,16.0
6480,3109.0,CLEAR DRAWER KNOB ACRYLIC EDWARDIAN,6,605,20,2100,1495,1,40.0
6481,3110.0,PHOTO CLIP LINE,4,131,1,200,69,1,2.0
6482,3111.0,FELT EGG COSY CHICKEN,2,449,23,2400,1951,1,46.0
6483,3112.0,PIGGY BANK RETROSPOT ,1,214,6,700,486,1,12.0
6484,3113.0,SKULL SHOULDER BAG,5,812,11,1200,388,1,22.0
6485,3114.0,YOU'RE CONFUSING ME METAL SIGN ,1,672,16,1700,1028,1,32.0
6486,3115.0,COOK WITH WINE METAL SIGN ,2,222,4,500,278,1,8.0
6487,3116.0,GIN + TONIC DIET METAL SIGN,3,315,16,1700,1385,1,32.0
6488,3117.0,YELLOW BREAKFAST CUP AND SAUCER,4,344,3,400,56,1,6.0
6489,3118.0,PINK BREAKFAST CUP AND SAUCER ,4,823,10,1100,277,1,20.0
6490,3119.0,PAPER CHAIN KIT 50'S CHRISTMAS ,2,718,11,1200,482,1,22.0
6491,3120.0,PAPER CHAIN KIT RETROSPOT,5,281,19,2000,1719,1,38.0
6492,3121.0,SMALL HEART FLOWERS HOOK ,6,172,4,500,328,1,8.0
6493,3122.0,PHOTO CLIP LINE,5,108,1,200,92,1,2.0
6494,3123.0,TEA TIME DES TEA COSY,6,352,24,2500,2148,1,48.0
6495,3124.0,FELT EGG COSY WHITE RABBIT ,8,596,11,1200,604,1,22.0
6496,3125.0,ZINC WILLIE WINKIE  CANDLE STICK,1,353,4,500,147,1,8.0
6497,3126.0,CERAMIC CHERRY CAKE MONEY BANK,6,193,6,700,507,1,12.0
6498,3127.0,RETROSPOT LARGE MILK JUG,4,336,6,700,364,1,12.0
6499,3128.0,SET OF 6 FUNKY BEAKERS,7,351,18,1900,1549,1,36.0
6500,3129.0,EDWARDIAN PARASOL BLACK,4,1067,12,1300,233,1,24.0
6501,3130.0,EDWARDIAN PARASOL NATURAL,1,615,14,1500,885,1,28.0
6502,3131.0,CERAMIC STRAWBERRY CAKE MONEY BANK,1,1004,15,1600,596,1,30.0
6503,3132.0,BLUE OWL SOFT TOY,7,223,4,500,277,1,8.0
6504,3133.0,BALLOON ART MAKE YOUR OWN FLOWERS,2,100,0,100,0,1,0.0
6505,3134.0,RED TOADSTOOL LED NIGHT LIGHT,6,100,0,100,0,1,0.0
6506,3135.0,GLASS CLOCHE SMALL,1,1080,20,2100,1020,1,40.0
6507,3136.0,GUMBALL MONOCHROME COAT RACK,8,673,24,2500,1827,1,48.0
6508,3137.0,DOORMAT FANCY FONT HOME SWEET HOME,1,397,3,400,3,1,6.0
6509,3138.0,Discount,3,1074,20,2100,1026,1,40.0
6510,3139.0,INFLATABLE POLITICAL GLOBE ,10,1156,13,1400,244,1,26.0
6511,3140.0,VINTAGE SNAKES & LADDERS,2,873,14,1500,627,1,28.0
6512,3141.0,CHOCOLATE CALCULATOR,9,197,8,900,703,1,16.0
6513,3142.0,JUMBO SHOPPER VINTAGE RED PAISLEY,2,534,6,700,166,1,12.0
6514,3143.0,RECYCLING BAG RETROSPOT ,10,847,9,1000,153,1,18.0
6515,3144.0,TOY TIDY PINK POLKADOT,5,535,8,900,365,1,16.0
6516,3145.0,ANTIQUE GLASS DRESSING TABLE POT,9,777,18,1900,1123,1,36.0
6517,3146.0,ALARM CLOCK BAKELIKE GREEN,9,1219,20,2100,881,1,40.0
6518,3147.0,IVORY GIANT GARDEN THERMOMETER,1,611,8,900,289,1,16.0
6519,3148.0,5 TIER CAKE TIN GREEN AND CREAM,5,1275,14,1500,225,1,28.0
6520,3149.0,5 TIER CAKE TIN RED AND CREAM,9,963,16,1700,737,1,32.0
6521,3150.0,SET 3 WICKER OVAL BASKETS W LIDS,6,154,15,1600,1446,1,30.0
6522,3151.0,SET OF 3 COLOURED  FLYING DUCKS,3,1600,25,2600,1000,1,50.0
6523,3152.0,WOOD BLACK BOARD ANT WHITE FINISH,3,365,10,1100,735,1,20.0
6524,3153.0,COLOUR GLASS T-LIGHT HOLDER HANGING,10,1218,13,1400,182,1,26.0
6525,3154.0,HANGING METAL HEART LANTERN,2,409,23,2400,1991,1,46.0
6526,3155.0,HANGING MEDINA LANTERN SMALL,6,128,12,1300,1172,1,24.0
6527,3156.0,NATURAL SLATE HEART CHALKBOARD ,1,143,3,400,257,1,6.0
6528,3157.0,HEART OF WICKER SMALL,5,373,21,2200,1827,1,42.0
6529,3158.0,HEART OF WICKER LARGE,6,623,8,900,277,1,16.0
6530,3159.0,WHITE LOVEBIRD LANTERN,7,122,7,800,678,1,14.0
6531,3160.0,CLASSIC METAL BIRDCAGE PLANT HOLDER,2,984,24,2500,1516,1,48.0
6532,3161.0,CREAM HEART CARD HOLDER,7,353,8,900,547,1,16.0
6533,3162.0,ENAMEL FLOWER JUG CREAM,6,1604,24,2500,896,1,48.0
6534,3163.0,ENAMEL FIRE BUCKET CREAM,1,1007,16,1700,693,1,32.0
6535,3164.0,ENAMEL BREAD BIN CREAM,5,150,19,2000,1850,1,38.0
6536,3165.0,SET 3 WICKER OVAL BASKETS W LIDS,2,1405,21,2200,795,1,42.0
6537,3166.0,JAM MAKING SET PRINTED,9,250,3,400,150,1,6.0
6538,3167.0,JAM MAKING SET WITH JARS,4,660,16,1700,1040,1,32.0
6539,3168.0,JUMBO BAG DOLLY GIRL DESIGN,7,589,7,800,211,1,14.0
6540,3169.0,TRADITIONAL CHRISTMAS RIBBONS,9,468,17,1800,1332,1,34.0
6541,3170.0,ORGANISER WOOD ANTIQUE WHITE ,8,267,22,2300,2033,1,44.0
6542,3171.0,LUNCH BAG DOLLY GIRL DESIGN,3,486,5,600,114,1,10.0
6543,3172.0,WHITE WIRE EGG HOLDER,7,489,8,900,411,1,16.0
6544,3173.0,JUMBO  BAG BAROQUE BLACK WHITE,4,1723,24,2500,777,1,48.0
6545,3174.0,JUMBO BAG RED RETROSPOT,6,479,8,900,421,1,16.0
6546,3175.0,CHILLI LIGHTS,10,606,8,900,294,1,16.0
6547,3176.0,LIGHT GARLAND BUTTERFILES PINK,4,1325,19,2000,675,1,38.0
6548,3177.0,WOODEN OWLS LIGHT GARLAND ,9,521,5,600,79,1,10.0
6549,3178.0,FAIRY TALE COTTAGE NIGHTLIGHT,5,501,15,1600,1099,1,30.0
6550,3179.0,RED TOADSTOOL LED NIGHT LIGHT,6,1026,14,1500,474,1,28.0
6551,3180.0,HOME BUILDING BLOCK WORD,10,1354,25,2600,1246,1,50.0
6552,3181.0,LOVE BUILDING BLOCK WORD,4,795,11,1200,405,1,22.0
6553,3182.0,DOORMAT FANCY FONT HOME SWEET HOME,9,352,23,2400,2048,1,46.0
6554,3183.0,HOME SMALL WOOD LETTERS,3,891,11,1200,309,1,22.0
6555,3184.0,GINGHAM HEART  DOORSTOP RED,7,169,1,200,31,1,2.0
6556,3185.0,FIVE HEART HANGING DECORATION,9,360,23,2400,2040,1,46.0
6557,3186.0,HANGING METAL HEART LANTERN,2,112,5,600,488,1,10.0
6558,3187.0,ASSORTED BOTTLE TOP  MAGNETS ,2,402,5,600,198,1,10.0
6559,3188.0,FRIDGE MAGNETS US DINER ASSORTED,1,481,5,600,119,1,10.0
6560,3189.0,HOMEMADE JAM SCENTED CANDLES,9,415,22,2300,1885,1,44.0
6561,3190.0,FRIDGE MAGNETS LES ENFANTS ASSORTED,9,959,10,1100,141,1,20.0
6562,3191.0,ROSE CARAVAN DOORSTOP,3,1450,18,1900,450,1,36.0
6563,3192.0,HEART OF WICKER SMALL,6,101,12,1300,1199,1,24.0
6564,3193.0,7 HOOK HANGER MAGIC TOADSTOOL,8,103,12,1300,1197,1,24.0
6565,3194.0,CHRISTMAS LIGHTS 10 REINDEER,7,1129,12,1300,171,1,24.0
6566,3195.0,VINTAGE UNION JACK CUSHION COVER,3,1732,23,2400,668,1,46.0
6567,3196.0,VINTAGE HEADS AND TAILS CARD GAME ,5,108,17,1800,1692,1,34.0
6568,3197.0,SET OF 3 COLOURED  FLYING DUCKS,3,325,10,1100,775,1,20.0
6569,3198.0,SET OF 3 GOLD FLYING DUCKS,4,1226,22,2300,1074,1,44.0
6570,3199.0,RED RETROSPOT UMBRELLA,10,346,4,500,154,1,8.0
6571,3200.0,BLACK/BLUE POLKADOT UMBRELLA,8,799,10,1100,301,1,20.0
6572,3201.0,RED DINER WALL CLOCK,6,1857,18,1900,43,1,36.0
6573,3202.0,ALARM CLOCK BAKELIKE GREEN,2,119,1,200,81,1,2.0
6574,3203.0,ALARM CLOCK BAKELIKE RED ,5,215,12,1300,1085,1,24.0
6575,3204.0,BLUE DINER WALL CLOCK,8,119,1,200,81,1,2.0
6576,3205.0,IVORY DINER WALL CLOCK,2,901,13,1400,499,1,26.0
6577,3206.0,LARGE HEART MEASURING SPOONS,4,150,12,1300,1150,1,24.0
6578,3207.0,SMALL HEART MEASURING SPOONS,8,214,8,900,686,1,16.0
6579,3208.0,CHRISTMAS LIGHTS 10 REINDEER,9,1077,18,1900,823,1,36.0
6580,3209.0,JAM MAKING SET WITH JARS,8,194,25,2600,2406,1,50.0
6581,3210.0,JAM MAKING SET PRINTED,7,901,23,2400,1499,1,46.0
6582,3211.0,JAM JAR WITH PINK LID,5,1213,17,1800,587,1,34.0
6583,3212.0,JAM JAR WITH GREEN LID,5,148,5,600,452,1,10.0
6584,3213.0,ROSE COTTAGE KEEPSAKE BOX ,8,1172,24,2500,1328,1,48.0
6585,3214.0,HANGING HEART ZINC T-LIGHT HOLDER,1,594,15,1600,1006,1,30.0
6586,3215.0,PAPER CHAIN KIT VINTAGE CHRISTMAS,8,1606,24,2500,894,1,48.0
6587,3216.0,DISCO BALL CHRISTMAS DECORATION,9,189,1,200,11,1,2.0
6588,3217.0,WHITE HANGING HEART T-LIGHT HOLDER,10,305,18,1900,1595,1,36.0
6589,3218.0,SMALL POPCORN HOLDER,10,800,8,900,100,1,16.0
6590,3219.0,LARGE POPCORN HOLDER ,1,424,15,1600,1176,1,30.0
6591,3220.0,RETROSPOT LARGE MILK JUG,1,866,8,900,34,1,16.0
6592,3221.0,SET/20 RED RETROSPOT PAPER NAPKINS ,10,986,22,2300,1314,1,44.0
6593,3222.0,SET/6 RED SPOTTY PAPER PLATES,2,1085,15,1600,515,1,30.0
6594,3223.0,SET/6 RED SPOTTY PAPER CUPS,9,1469,20,2100,631,1,40.0
6595,3224.0,POLKADOT RAIN HAT ,5,132,1,200,68,1,2.0
6596,3225.0,DELUXE SEWING KIT ,6,1235,13,1400,165,1,26.0
6597,3226.0,RETROSPOT HEART HOT WATER BOTTLE,7,1468,18,1900,432,1,36.0
6598,3227.0,KNITTED UNION FLAG HOT WATER BOTTLE,7,1284,12,1300,16,1,24.0
6599,3228.0,ENGLISH ROSE HOT WATER BOTTLE,5,728,16,1700,972,1,32.0
6600,3229.0,PHOTO CUBE,10,250,9,1000,750,1,18.0
6601,3230.0,HOMEMADE JAM SCENTED CANDLES,6,457,8,900,443,1,16.0
6602,3231.0,JUMBO BAG RED RETROSPOT,4,852,12,1300,448,1,24.0
6603,3232.0,PLASTERS IN TIN CIRCUS PARADE ,8,561,13,1400,839,1,26.0
6604,3233.0,PACK OF 12 PINK PAISLEY TISSUES ,2,449,11,1200,751,1,22.0
6605,3234.0,PACK OF 12 BLUE PAISLEY TISSUES ,2,1574,23,2400,826,1,46.0
6606,3235.0,PACK OF 12 RED RETROSPOT TISSUES ,6,397,19,2000,1603,1,38.0
6607,3236.0,CHICK GREY HOT WATER BOTTLE,2,989,11,1200,211,1,22.0
6608,3237.0,PLASTERS IN TIN VINTAGE PAISLEY ,4,566,10,1100,534,1,20.0
6609,3238.0,PLASTERS IN TIN SKULLS,10,248,11,1200,952,1,22.0
6610,3239.0,5 STRIPEY MICE FELTCRAFT,4,375,4,500,125,1,8.0
6611,3240.0,SET OF 6 SOLDIER SKITTLES,10,417,23,2400,1983,1,46.0
6612,3241.0,TRADITIONAL WOODEN SKIPPING ROPE,1,115,25,2600,2485,1,50.0
6613,3242.0,WOODEN BOX OF DOMINOES,8,612,25,2600,1988,1,50.0
6614,3243.0,RUSTIC  SEVENTEEN DRAWER SIDEBOARD,5,408,5,600,192,1,10.0
6615,3244.0,PARTY CONES CARNIVAL ASSORTED,4,188,6,700,512,1,12.0
6616,3245.0,PARTY CONES CANDY ASSORTED,1,1388,15,1600,212,1,30.0
6617,3246.0,PICNIC BASKET WICKER SMALL,10,784,19,2000,1216,1,38.0
6618,3247.0,ASSORTED COLOUR BIRD ORNAMENT,7,650,19,2000,1350,1,38.0
6619,3248.0,STAR DECORATION PAINTED ZINC ,9,574,6,700,126,1,12.0
6620,3249.0,RETROSPOT LAMP,7,188,12,1300,1112,1,24.0
6621,3250.0,"FANCY FONT BIRTHDAY CARD, ",3,364,6,700,336,1,12.0
6622,3251.0,HAND WARMER UNION JACK,7,1519,20,2100,581,1,40.0
6623,3252.0,HAND WARMER SCOTTY DOG DESIGN,8,1460,17,1800,340,1,34.0
6624,3253.0,HAND WARMER OWL DESIGN,4,114,7,800,686,1,14.0
6625,3254.0,HAND WARMER RED RETROSPOT,4,482,24,2500,2018,1,48.0
6626,3255.0,RETROSPOT HEART HOT WATER BOTTLE,8,580,14,1500,920,1,28.0
6627,3256.0,DOG BOWL CHASING BALL DESIGN,10,1313,17,1800,487,1,34.0
6628,3257.0,CLOTHES PEGS RETROSPOT PACK 26,10,1036,24,2500,1464,1,48.0
6629,3258.0,HAND OVER THE CHOCOLATE   SIGN ,8,567,25,2600,2033,1,50.0
6630,3259.0,WHITE HANGING HEART T-LIGHT HOLDER,6,161,14,1500,1339,1,28.0
6631,3260.0,TRAVEL SEWING KIT,5,100,0,100,0,1,0.0
6632,3261.0,BLACK HEART CARD HOLDER,9,246,3,400,154,1,6.0
6633,3262.0,ASSORTED COLOUR BIRD ORNAMENT,8,1063,11,1200,137,1,22.0
6634,3263.0,PACK OF 60 PINK PAISLEY CAKE CASES,5,158,5,600,442,1,10.0
6635,3264.0,62 TEATIME FAIRY CAKE CASES,5,1879,19,2000,121,1,38.0
6636,3265.0,PACK OF 72 RETROSPOT CAKE CASES,3,418,18,1900,1482,1,36.0
6637,3266.0,CHICK GREY HOT WATER BOTTLE,1,839,19,2000,1161,1,38.0
6638,3267.0,SMALL GLASS HEART TRINKET POT,3,379,8,900,521,1,16.0
6639,3268.0,ALARM CLOCK BAKELIKE IVORY,4,720,16,1700,980,1,32.0
6640,3269.0,ALARM CLOCK BAKELIKE RED ,6,1043,13,1400,357,1,26.0
6641,3270.0,ALARM CLOCK BAKELIKE ORANGE,5,769,13,1400,631,1,26.0
6642,3271.0,ALARM CLOCK BAKELIKE GREEN,10,572,16,1700,1128,1,32.0
6643,3272.0,HOT WATER BOTTLE TEA AND SYMPATHY,3,824,8,900,76,1,16.0
6644,3273.0,HAND WARMER BIRD DESIGN,2,149,1,200,51,1,2.0
6645,3274.0,HAND WARMER SCOTTY DOG DESIGN,8,188,1,200,12,1,2.0
6646,3275.0,WHITE HANGING HEART T-LIGHT HOLDER,9,1317,15,1600,283,1,30.0
6647,3276.0,WHITE METAL LANTERN,6,250,11,1200,950,1,22.0
6648,3277.0,CREAM CUPID HEARTS COAT HANGER,2,1941,20,2100,159,1,40.0
6649,3278.0,EDWARDIAN PARASOL BLACK,6,1791,20,2100,309,1,40.0
6650,3279.0,EDWARDIAN PARASOL RED,8,211,6,700,489,1,12.0
6651,3280.0,RETRO COFFEE MUGS ASSORTED,5,926,10,1100,174,1,20.0
6652,3281.0,SAVE THE PLANET MUG,3,130,3,400,270,1,6.0
6653,3282.0,VINTAGE BILLBOARD DRINK ME MUG,8,325,3,400,75,1,6.0
6654,3283.0,VINTAGE BILLBOARD LOVE/HATE MUG,10,1024,12,1300,276,1,24.0
6655,3284.0,WOOD 2 DRAWER CABINET WHITE FINISH,5,100,0,100,0,1,0.0
6656,3285.0,WOOD S/3 CABINET ANT WHITE FINISH,5,1284,21,2200,916,1,42.0
6657,3286.0,WOODEN PICTURE FRAME WHITE FINISH,9,719,11,1200,481,1,22.0
6658,3287.0,WOODEN FRAME ANTIQUE WHITE ,6,794,7,800,6,1,14.0
6659,3288.0,KNITTED UNION FLAG HOT WATER BOTTLE,5,123,14,1500,1377,1,28.0
6660,3289.0,RED WOOLLY HOTTIE WHITE HEART.,6,106,2,300,194,1,4.0
6661,3290.0,SET 7 BABUSHKA NESTING BOXES,6,363,6,700,337,1,12.0
6662,3291.0,IVORY EMBROIDERED QUILT ,8,1959,19,2000,41,1,38.0
6663,3292.0,GLASS STAR FROSTED T-LIGHT HOLDER,2,326,4,500,174,1,8.0
6664,3293.0,SET OF 3 BLACK FLYING DUCKS,2,164,5,600,436,1,10.0
6665,3294.0,SET OF 3 COLOURED  FLYING DUCKS,8,331,21,2200,1869,1,42.0
6666,3295.0,PACK OF 12 RED RETROSPOT TISSUES ,1,410,12,1300,890,1,24.0
6667,3296.0,RED RETROSPOT MUG,10,1365,20,2100,735,1,40.0
6668,3297.0,BABUSHKA LIGHTS STRING OF 12,6,171,1,200,29,1,2.0
6669,3298.0,PIGGY BANK RETROSPOT ,9,794,11,1200,406,1,22.0
6670,3299.0,SET 7 BABUSHKA NESTING BOXES,8,1750,17,1800,50,1,34.0
6671,3300.0,DOORMAT FAIRY CAKE,7,1127,25,2600,1473,1,50.0
6672,3301.0,HAND WARMER RED RETROSPOT,6,558,9,1000,442,1,18.0
6673,3302.0,HAND WARMER SCOTTY DOG DESIGN,5,708,21,2200,1492,1,42.0
6674,3303.0,HAND WARMER OWL DESIGN,7,1121,15,1600,479,1,30.0
6675,3304.0,STRAWBERRY CERAMIC TRINKET BOX,2,2170,21,2200,30,1,42.0
6676,3305.0,PINK DOUGHNUT TRINKET POT ,2,411,7,800,389,1,14.0
6677,3306.0,SILK PURSE BABUSHKA PINK,5,1239,25,2600,1361,1,50.0
6678,3307.0,HOT WATER BOTTLE TEA AND SYMPATHY,3,161,10,1100,939,1,20.0
6679,3308.0,HOT WATER BOTTLE I AM SO POORLY,10,1365,17,1800,435,1,34.0
6680,3309.0,CHOCOLATE HOT WATER BOTTLE,9,331,4,500,169,1,8.0
6681,3310.0,WHITE SKULL HOT WATER BOTTLE ,8,1493,14,1500,7,1,28.0
6682,3311.0,SCOTTIE DOG HOT WATER BOTTLE,5,124,2,300,176,1,4.0
6683,3312.0,HAND WARMER RED POLKA DOT,10,145,3,400,255,1,6.0
6684,3313.0,HAND WARMER UNION JACK,4,228,7,800,572,1,14.0
6685,3314.0,HOMEMADE JAM SCENTED CANDLES,4,976,9,1000,24,1,18.0
6686,3315.0,BIRD HOUSE HOT WATER BOTTLE,6,850,24,2500,1650,1,48.0
6687,3316.0,BOUDOIR SQUARE TISSUE BOX,3,229,3,400,171,1,6.0
6688,3317.0,SKULLS SQUARE TISSUE BOX,3,1171,14,1500,329,1,28.0
6689,3318.0,PHOTO FRAME CORNICE,2,288,17,1800,1512,1,34.0
6690,3319.0,SILK PURSE BABUSHKA RED,2,367,19,2000,1633,1,38.0
6691,3320.0,PICTURE DOMINOES,1,144,1,200,56,1,2.0
6692,3321.0,S/6 SEW ON CROCHET FLOWERS,9,240,2,300,60,1,4.0
6693,3322.0,SCANDINAVIAN REDS RIBBONS,5,555,16,1700,1145,1,32.0
6694,3323.0,BALLOONS  WRITING SET ,8,1255,24,2500,1245,1,48.0
6695,3324.0,JAM MAKING SET PRINTED,5,703,24,2500,1797,1,48.0
6696,3325.0,LAVENDER INCENSE IN TIN,6,1125,16,1700,575,1,32.0
6697,3326.0,TV DINNER TRAY VINTAGE PAISLEY,9,157,7,800,643,1,14.0
6698,3327.0,SET OF 4 ENGLISH ROSE PLACEMATS,6,320,15,1600,1280,1,30.0
6699,3328.0,SET OF 4 ENGLISH ROSE COASTERS,2,184,2,300,116,1,4.0
6700,3329.0,TRIPLE PHOTO FRAME CORNICE ,2,814,18,1900,1086,1,36.0
6701,3330.0,FAMILY PHOTO FRAME CORNICE,8,372,4,500,128,1,8.0
6702,3331.0,MIRRORED DISCO BALL ,1,261,6,700,439,1,12.0
6703,3332.0,DISCO BALL ROTATOR BATTERY OPERATED,8,376,18,1900,1524,1,36.0
6704,3333.0,SILVER LOOKING MIRROR,7,1169,20,2100,931,1,40.0
6705,3334.0,LADIES & GENTLEMEN METAL SIGN,2,930,17,1800,870,1,34.0
6706,3335.0,METAL SIGN HER DINNER IS SERVED ,3,1805,24,2500,695,1,48.0
6707,3336.0,YOU'RE CONFUSING ME METAL SIGN ,7,1076,19,2000,924,1,38.0
6708,3337.0,DOORMAT TOPIARY,1,1665,21,2200,535,1,42.0
6709,3338.0,BATHROOM METAL SIGN,7,1798,20,2100,302,1,40.0
6710,3339.0,KITCHEN METAL SIGN,1,171,4,500,329,1,8.0
6711,3340.0,TOILET METAL SIGN,6,195,8,900,705,1,16.0
6712,3341.0,METAL SIGN TAKE IT OR LEAVE IT ,8,261,2,300,39,1,4.0
6713,3342.0,I'M ON HOLIDAY METAL SIGN,5,921,12,1300,379,1,24.0
6714,3343.0,GROW YOUR OWN BASIL IN ENAMEL MUG,7,356,4,500,144,1,8.0
6715,3344.0,SET/10 PINK POLKADOT PARTY CANDLES,1,309,17,1800,1491,1,34.0
6716,3345.0,SET 20 NAPKINS FAIRY CAKES DESIGN ,4,430,12,1300,870,1,24.0
6717,3346.0,62 TEATIME FAIRY CAKE CASES,6,171,17,1800,1629,1,34.0
6718,3347.0,SET OF 6 T-LIGHTS SNOWMEN,3,1206,14,1500,294,1,28.0
6719,3348.0,SET OF 6 T-LIGHTS SANTA,2,177,8,900,723,1,16.0
6720,3349.0,SET OF 9 HEART SHAPED BALLOONS,4,498,21,2200,1702,1,42.0
6721,3350.0,SANDWICH BATH SPONGE,8,221,5,600,379,1,10.0
6722,3351.0,APPLE BATH SPONGE,3,1113,18,1900,787,1,36.0
6723,3352.0,STRAWBERRY BATH SPONGE ,3,553,11,1200,647,1,22.0
6724,3353.0,BLACK PIRATE TREASURE CHEST,6,1475,23,2400,925,1,46.0
6725,3354.0,STAR PORTABLE TABLE LIGHT ,1,554,5,600,46,1,10.0
6726,3355.0,SNOWFLAKE PORTABLE TABLE LIGHT ,8,881,13,1400,519,1,26.0
6727,3356.0,PINK OVAL JEWELLED MIRROR,1,393,6,700,307,1,12.0
6728,3357.0,RETROSPOT CIGAR BOX MATCHES ,3,896,14,1500,604,1,28.0
6729,3358.0,COSY HOUR GIANT TUBE MATCHES,9,159,11,1200,1041,1,22.0
6730,3359.0,JAZZ HEARTS PURSE NOTEBOOK,6,135,4,500,365,1,8.0
6731,3360.0,LUNCH BAG DOLLY GIRL DESIGN,8,837,23,2400,1563,1,46.0
6732,3361.0,WHITE HANGING HEART T-LIGHT HOLDER,1,2387,24,2500,113,1,48.0
6733,3362.0,CANDLEHOLDER PINK HANGING HEART,1,1839,24,2500,661,1,48.0
6734,3363.0,WOOD 2 DRAWER CABINET WHITE FINISH,10,223,10,1100,877,1,20.0
6735,3364.0,ASSORTED COLOUR MINI CASES,4,417,5,600,183,1,10.0
6736,3365.0,LUNCH BAG RED RETROSPOT,10,100,0,100,0,1,0.0
6737,3366.0,LUNCH BAG SPACEBOY DESIGN ,2,1273,13,1400,127,1,26.0
6738,3367.0,LUNCH BAG WOODLAND,5,269,3,400,131,1,6.0
6739,3368.0,LUNCH BAG PINK POLKADOT,4,329,19,2000,1671,1,38.0
6740,3369.0,GUMBALL COAT RACK,10,215,17,1800,1585,1,34.0
6741,3370.0,BLUE NEW BAROQUE CANDLESTICK CANDLE,2,346,4,500,154,1,8.0
6742,3371.0,PINK NEW BAROQUECANDLESTICK CANDLE,6,310,6,700,390,1,12.0
6743,3372.0,FAIRY CAKE FLANNEL ASSORTED COLOUR,6,2378,23,2400,22,1,46.0
6744,3373.0,BREAD BIN DINER STYLE PINK,2,323,15,1600,1277,1,30.0
6745,3374.0,JUMBO BAG CHARLIE AND LOLA TOYS,10,1731,18,1900,169,1,36.0
6746,3375.0,TEA TIME TABLE CLOTH,5,282,2,300,18,1,4.0
6747,3376.0,ENGLISH ROSE HOT WATER BOTTLE,8,169,3,400,231,1,6.0
6748,3377.0,ENAMEL FIRE BUCKET CREAM,1,1469,20,2100,631,1,40.0
6749,3378.0,PICNIC BASKET WICKER SMALL,8,353,9,1000,647,1,18.0
6750,3379.0,PAPER CHAIN KIT 50'S CHRISTMAS ,4,100,1,200,100,1,2.0
6751,3380.0,PAPER CHAIN KIT VINTAGE CHRISTMAS,5,1982,24,2500,518,1,48.0
6752,3381.0,HOT WATER BOTTLE BABUSHKA ,3,1114,21,2200,1086,1,42.0
6753,3382.0,HAND WARMER BIRD DESIGN,5,132,21,2200,2068,1,42.0
6754,3383.0,POSTAGE,6,506,13,1400,894,1,26.0
6755,3384.0,HEART IVORY TRELLIS SMALL,8,449,4,500,51,1,8.0
6756,3385.0,CLEAR DRAWER KNOB ACRYLIC EDWARDIAN,2,1270,12,1300,30,1,24.0
6757,3386.0,PINK DRAWER KNOB ACRYLIC EDWARDIAN,4,1590,24,2500,910,1,48.0
6758,3387.0,GREEN DRAWER KNOB ACRYLIC EDWARDIAN,3,924,18,1900,976,1,36.0
6759,3388.0,BLUE DRAWER KNOB ACRYLIC EDWARDIAN,6,175,5,600,425,1,10.0
6760,3389.0,HEART OF WICKER SMALL,4,401,5,600,199,1,10.0
6761,3390.0,SMALL POPCORN HOLDER,7,719,19,2000,1281,1,38.0
6762,3391.0,SET 6 FOOTBALL CELEBRATION CANDLES,7,138,12,1300,1162,1,24.0
6763,3392.0,SET OF 6 GIRLS CELEBRATION CANDLES,4,310,9,1000,690,1,18.0
6764,3393.0,ROMANTIC PINKS RIBBONS ,9,788,8,900,112,1,16.0
6765,3394.0,BRIGHT BLUES RIBBONS ,3,1374,15,1600,226,1,30.0
6766,3395.0,SCANDINAVIAN REDS RIBBONS,3,553,8,900,347,1,16.0
6767,3396.0,CHOCOLATE BOX RIBBONS ,4,133,21,2200,2067,1,42.0
6768,3397.0,PARTY INVITES FOOTBALL,2,681,9,1000,319,1,18.0
6769,3398.0,PARTY INVITES JAZZ HEARTS,1,642,21,2200,1558,1,42.0
6770,3399.0,PARTY INVITES SPACEMAN,3,100,0,100,0,1,0.0
6771,3400.0,SET OF 3 BUTTERFLY COOKIE CUTTERS,6,669,6,700,31,1,12.0
6772,3401.0,SET OF 3 HEART COOKIE CUTTERS,9,824,12,1300,476,1,24.0
6773,3402.0,5 PIECE SPACEBOY COOKIE CUTTER SET,3,1751,17,1800,49,1,34.0
6774,3403.0,PACK OF 72 SKULL CAKE CASES,9,100,0,100,0,1,0.0
6775,3404.0,PACK OF 60 SPACEBOY CAKE CASES,6,1374,17,1800,426,1,34.0
6776,3405.0,PACK OF 72 RETROSPOT CAKE CASES,9,2107,22,2300,193,1,44.0
6777,3406.0,74 SWEETHEART FAIRY CAKE CASES,3,133,6,700,567,1,12.0
6778,3407.0,PACK OF 60 DINOSAUR CAKE CASES,1,802,19,2000,1198,1,38.0
6779,3408.0,LUNCH BAG SUKI  DESIGN ,10,1656,17,1800,144,1,34.0
6780,3409.0,LUNCH BAG CARS BLUE,3,465,8,900,435,1,16.0
6781,3410.0,LUNCH BAG  BLACK SKULL.,9,126,2,300,174,1,4.0
6782,3411.0,HEART IVORY TRELLIS LARGE,1,923,13,1400,477,1,26.0
6783,3412.0,SET/5 RED RETROSPOT LID GLASS BOWLS,1,230,10,1100,870,1,20.0
6784,3413.0,WHITE HANGING HEART T-LIGHT HOLDER,3,636,24,2500,1864,1,48.0
6785,3414.0,WHITE METAL LANTERN,4,105,13,1400,1295,1,26.0
6786,3415.0,CREAM CUPID HEARTS COAT HANGER,6,1376,22,2300,924,1,44.0
6787,3416.0,EDWARDIAN PARASOL RED,2,609,6,700,91,1,12.0
6788,3417.0,RETRO COFFEE MUGS ASSORTED,3,302,4,500,198,1,8.0
6789,3418.0,SAVE THE PLANET MUG,4,262,2,300,38,1,4.0
6790,3419.0,VINTAGE BILLBOARD DRINK ME MUG,4,626,14,1500,874,1,28.0
6791,3420.0,VINTAGE BILLBOARD LOVE/HATE MUG,10,823,24,2500,1677,1,48.0
6792,3421.0,WOOD 2 DRAWER CABINET WHITE FINISH,3,712,23,2400,1688,1,46.0
6793,3422.0,WOOD S/3 CABINET ANT WHITE FINISH,2,170,6,700,530,1,12.0
6794,3423.0,WOODEN PICTURE FRAME WHITE FINISH,2,232,18,1900,1668,1,36.0
6795,3424.0,WOODEN FRAME ANTIQUE WHITE ,8,270,11,1200,930,1,22.0
6796,3425.0,KNITTED UNION FLAG HOT WATER BOTTLE,8,2259,22,2300,41,1,44.0
6797,3426.0,RED WOOLLY HOTTIE WHITE HEART.,4,949,12,1300,351,1,24.0
6798,3427.0,SET 7 BABUSHKA NESTING BOXES,2,1159,22,2300,1141,1,44.0
6799,3428.0,IVORY EMBROIDERED QUILT ,1,341,19,2000,1659,1,38.0
6800,3429.0,GLASS STAR FROSTED T-LIGHT HOLDER,3,223,15,1600,1377,1,30.0
6801,3430.0,HAND WARMER RED POLKA DOT,3,180,24,2500,2320,1,48.0
6802,3431.0,HAND WARMER UNION JACK,6,313,10,1100,787,1,20.0
6803,3432.0,MAGIC DRAWING SLATE DINOSAUR,4,1053,10,1100,47,1,20.0
6804,3433.0,MAGIC DRAWING SLATE BAKE A CAKE ,8,1193,24,2500,1307,1,48.0
6805,3434.0,14 PENCILS TALL TUBE SKULLS,7,283,5,600,317,1,10.0
6806,3435.0,CHOCOLATE CALCULATOR,3,236,3,400,164,1,6.0
6807,3436.0,RED  HARMONICA IN BOX ,7,793,17,1800,1007,1,34.0
6808,3437.0,BLUE HARMONICA IN BOX ,6,699,16,1700,1001,1,32.0
6809,3438.0,SKULLS  WATER TRANSFER TATTOOS ,6,432,5,600,168,1,10.0
6810,3439.0,PACK 3 BOXES BIRD PANNETONE ,7,1675,24,2500,825,1,48.0
6811,3440.0,HOT WATER BOTTLE TEA AND SYMPATHY,10,543,12,1300,757,1,24.0
6812,3441.0,RED WOOLLY HOTTIE WHITE HEART.,2,1050,16,1700,650,1,32.0
6813,3442.0,WHITE SKULL HOT WATER BOTTLE ,7,779,9,1000,221,1,18.0
6814,3443.0,5 PIECE SPACEBOY COOKIE CUTTER SET,8,100,0,100,0,1,0.0
6815,3444.0,SET OF 20 KIDS COOKIE CUTTERS,10,241,6,700,459,1,12.0
6816,3445.0,12 COLOUR SPACEBOY PEN,9,2267,23,2400,133,1,46.0
6817,3446.0,VICTORIAN GLASS HANGING T-LIGHT,5,1204,16,1700,496,1,32.0
6818,3447.0,SINGLE HEART ZINC T-LIGHT HOLDER,9,914,20,2100,1186,1,40.0
6819,3448.0,RED HANGING HEART T-LIGHT HOLDER,1,1446,17,1800,354,1,34.0
6820,3449.0,HANGING METAL STAR LANTERN,3,528,5,600,72,1,10.0
6821,3450.0,SILVER HANGING T-LIGHT HOLDER,4,100,0,100,0,1,0.0
6822,3451.0,DOORMAT RED RETROSPOT,1,275,10,1100,825,1,20.0
6823,3452.0,DOORMAT HEARTS,10,232,3,400,168,1,6.0
6824,3453.0,NATURAL SLATE RECTANGLE CHALKBOARD,2,375,5,600,225,1,10.0
6825,3454.0,LOVEBIRD HANGING DECORATION WHITE ,9,1117,19,2000,883,1,38.0
6826,3455.0,ASSORTED COLOUR BIRD ORNAMENT,6,216,4,500,284,1,8.0
6827,3456.0,HOME BUILDING BLOCK WORD,3,377,4,500,123,1,8.0
6828,3457.0,LOVE BUILDING BLOCK WORD,4,1230,15,1600,370,1,30.0
6829,3458.0,PHOTO FRAME CORNICE,2,910,12,1300,390,1,24.0
6830,3459.0,PENS ASSORTED FUNNY FACE,8,298,12,1300,1002,1,24.0
6831,3460.0,CARD CIRCUS PARADE,5,578,8,900,322,1,16.0
6832,3461.0,WRAP COWBOYS  ,8,122,1,200,78,1,2.0
6833,3462.0,AIRLINE BAG VINTAGE TOKYO 80,4,730,7,800,70,1,14.0
6834,3463.0,RED RETROSPOT UMBRELLA,8,106,17,1800,1694,1,34.0
6835,3464.0,BLACK/BLUE POLKADOT UMBRELLA,8,133,5,600,467,1,10.0
6836,3465.0,RED 3 PIECE RETROSPOT CUTLERY SET,3,490,13,1400,910,1,26.0
6837,3466.0,PACK OF 72 RETROSPOT CAKE CASES,2,446,9,1000,554,1,18.0
6838,3467.0,SET OF 72 RETROSPOT PAPER  DOILIES,8,1314,17,1800,486,1,34.0
6839,3468.0,BLUE COAT RACK PARIS FASHION,3,1568,16,1700,132,1,32.0
6840,3469.0,PLASTERS IN TIN SKULLS,10,637,7,800,163,1,14.0
6841,3470.0,SLEEPING CAT ERASERS,9,807,11,1200,393,1,22.0
6842,3471.0,CARD BIRTHDAY COWBOY,10,110,18,1900,1790,1,36.0
6843,3472.0,PACK 3 BOXES CHRISTMAS PANNETONE,3,296,3,400,104,1,6.0
6844,3473.0,ROTATING SILVER ANGELS T-LIGHT HLDR,1,939,12,1300,361,1,24.0
6845,3474.0,COSY HOUR GIANT TUBE MATCHES,2,762,18,1900,1138,1,36.0
6846,3475.0,RIBBON REEL MAKING SNOWMEN ,1,1354,24,2500,1146,1,48.0
6847,3476.0,MINI PAINT SET VINTAGE ,10,333,4,500,167,1,8.0
6848,3477.0,6 TRADITIONAL SPINNING TOPS,5,1105,18,1900,795,1,36.0
6849,3478.0,SET OF 6 SOLDIER SKITTLES,7,204,3,400,196,1,6.0
6850,3479.0,BAG 500g SWIRLY MARBLES,8,994,12,1300,306,1,24.0
6851,3480.0,7 STRAND GLASS NECKLACE CRYSTAL,2,376,17,1800,1424,1,34.0
6852,3481.0,WHITE SKULL HOT WATER BOTTLE ,6,319,3,400,81,1,6.0
6853,3482.0,SCOTTIE DOG HOT WATER BOTTLE,1,591,7,800,209,1,14.0
6854,3483.0,SQUARECUSHION COVER PINK UNION FLAG,10,100,0,100,0,1,0.0
6855,3484.0,SPACEBOY CHILDRENS EGG CUP,4,1308,23,2400,1092,1,46.0
6856,3485.0,CHILDREN'S SPACEBOY MUG,10,1384,22,2300,916,1,44.0
6857,3486.0,HAND WARMER SCOTTY DOG DESIGN,2,428,11,1200,772,1,22.0
6858,3487.0,FELTCRAFT CUSHION OWL,10,100,0,100,0,1,0.0
6859,3488.0,BLACK CANDELABRA T-LIGHT HOLDER,5,927,25,2600,1673,1,50.0
6860,3489.0,TOY TIDY DOLLY GIRL DESIGN,8,1158,11,1200,42,1,22.0
6861,3490.0,SET 12 LAVENDER  BOTANICAL T-LIGHTS,2,1256,23,2400,1144,1,46.0
6862,3491.0,UNION JACK FLAG LUGGAGE TAG,1,100,0,100,0,1,0.0
6863,3492.0,RED HEART LUGGAGE TAG,1,1427,14,1500,73,1,28.0
6864,3493.0,RED GLASS TASSLE BAG CHARM,2,675,11,1200,525,1,22.0
6865,3494.0,CLEAR ACRYLIC FACETED BANGLE,10,306,17,1800,1494,1,34.0
6866,3495.0,7 STRAND GLASS NECKLACE CRYSTAL,3,1283,25,2600,1317,1,50.0
6867,3496.0,DOORMAT UNION JACK GUNS AND ROSES,4,213,8,900,687,1,16.0
6868,3497.0,VANILLA SCENT CANDLE JEWELLED BOX,10,172,6,700,528,1,12.0
6869,3498.0,FULL ENGLISH BREAKFAST PLATE,5,570,16,1700,1130,1,32.0
6870,3499.0,BLACK CANDELABRA T-LIGHT HOLDER,7,696,21,2200,1504,1,42.0
6871,3500.0,MAGIC DRAWING SLATE CIRCUS PARADE  ,7,1610,18,1900,290,1,36.0
6872,3501.0,CHRISTMAS HANGING HEART WITH BELL,3,226,8,900,674,1,16.0
6873,3502.0,CAKE STAND VICTORIAN FILIGREE MED,10,334,6,700,366,1,12.0
6874,3503.0,PAISLEY PATTERN  STICKERS,4,902,18,1900,998,1,36.0
6875,3504.0,FLOWERS  STICKERS,3,318,11,1200,882,1,22.0
6876,3505.0,PINK NEW BAROQUECANDLESTICK CANDLE,5,874,21,2200,1326,1,42.0
6877,3506.0,BLUE NEW BAROQUE CANDLESTICK CANDLE,2,166,1,200,34,1,2.0
6878,3507.0,JUMBO STORAGE BAG SUKI,6,699,7,800,101,1,14.0
6879,3508.0,BLACK LOVE BIRD CANDLE,5,1256,13,1400,144,1,26.0
6880,3509.0,PARTY TIME PENCIL ERASERS,2,388,20,2100,1712,1,40.0
6881,3510.0,DISCO BALL CHRISTMAS DECORATION,2,238,3,400,162,1,6.0
6882,3511.0,PINK B'FLY C/COVER W BOBBLES,4,1456,20,2100,644,1,40.0
6883,3512.0,PINK UNION JACK  LUGGAGE TAG,4,220,11,1200,980,1,22.0
6884,3513.0,8 RIBBONS ELEGANT CHRISTMAS ,1,1021,21,2200,1179,1,42.0
6885,3514.0,UNION JACK FLAG LUGGAGE TAG,4,1671,20,2100,429,1,40.0
6886,3515.0,AGED GLASS SILVER T-LIGHT HOLDER,3,2415,24,2500,85,1,48.0
6887,3516.0,BOOM BOX SPEAKER GIRLS,1,186,11,1200,1014,1,22.0
6888,3517.0,8 RIBBONS SHIMMERING PINKS ,7,869,10,1100,231,1,20.0
6889,3518.0, SET 2 TEA TOWELS I LOVE LONDON ,9,919,12,1300,381,1,24.0
6890,3519.0,JUMBO BAG OWLS,6,100,0,100,0,1,0.0
6891,3520.0,SANDWICH BATH SPONGE,10,1347,14,1500,153,1,28.0
6892,3521.0,OWL DOORSTOP,7,131,1,200,69,1,2.0
6893,3522.0,7 STRAND GLASS NECKLACE CRYSTAL,5,285,15,1600,1315,1,30.0
6894,3523.0,HAND WARMER UNION JACK,9,1550,15,1600,50,1,30.0
6895,3524.0,HAND WARMER SCOTTY DOG DESIGN,10,529,9,1000,471,1,18.0
6896,3525.0,LARGE POPCORN HOLDER ,4,100,0,100,0,1,0.0
6897,3526.0,PAINTED METAL STAR WITH HOLLY BELLS,5,937,24,2500,1563,1,48.0
6898,3527.0,PAINTED METAL HEART WITH HOLLY BELL,8,1998,19,2000,2,1,38.0
6899,3528.0,ANGEL DECORATION STARS ON DRESS,3,989,12,1300,311,1,24.0
6900,3529.0,SMALL POPCORN HOLDER,9,928,11,1200,272,1,22.0
6901,3530.0,JUMBO BAG RED RETROSPOT,7,594,9,1000,406,1,18.0
6902,3531.0,JUMBO BAG STRAWBERRY,2,1260,17,1800,540,1,34.0
6903,3532.0,STRAWBERRY SHOPPER BAG,8,100,0,100,0,1,0.0
6904,3533.0,STRAWBERRY CHARLOTTE BAG,3,939,10,1100,161,1,20.0
6905,3534.0, SET 2 TEA TOWELS I LOVE LONDON ,9,844,10,1100,256,1,20.0
6906,3535.0,PACK OF 12 RED RETROSPOT TISSUES ,10,1140,11,1200,60,1,22.0
6907,3536.0,SCOTTIE DOG HOT WATER BOTTLE,8,231,3,400,169,1,6.0
6908,3537.0,CHOCOLATE HOT WATER BOTTLE,1,398,21,2200,1802,1,42.0
6909,3538.0,LUNCH BAG CARS BLUE,10,190,4,500,310,1,8.0
6910,3539.0,LUNCH BAG SPACEBOY DESIGN ,5,345,22,2300,1955,1,44.0
6911,3540.0,ROUND SNACK BOXES SET OF4 WOODLAND ,10,158,13,1400,1242,1,26.0
6912,3541.0,LUNCH BAG DOLLY GIRL DESIGN,9,572,20,2100,1528,1,40.0
6913,3542.0,LUNCH BAG SUKI  DESIGN ,6,536,13,1400,864,1,26.0
6914,3543.0,LUNCH BAG  BLACK SKULL.,9,1144,21,2200,1056,1,42.0
6915,3544.0,ROUND SNACK BOXES SET OF 4 FRUITS ,5,100,0,100,0,1,0.0
6916,3545.0,ROUND SNACK BOXES SET OF 4 SKULLS,6,706,10,1100,394,1,20.0
6917,3546.0,DOLLY GIRL LUNCH BOX,9,123,6,700,577,1,12.0
6918,3547.0,SPACEBOY LUNCH BOX ,4,281,5,600,319,1,10.0
6919,3548.0,GREEN POLKADOT PLATE ,8,362,6,700,338,1,12.0
6920,3549.0,BLUE POLKADOT PLATE ,8,2281,23,2400,119,1,46.0
6921,3550.0,RED RETROSPOT PLATE ,10,201,2,300,99,1,4.0
6922,3551.0,PINK  POLKADOT PLATE ,3,1636,19,2000,364,1,38.0
6923,3552.0,ROUND SNACK BOXES SET OF 4 SKULLS,5,635,10,1100,465,1,20.0
6924,3553.0,FELTCRAFT DOLL MOLLY,7,1527,15,1600,73,1,30.0
6925,3554.0,FELTCRAFT CHRISTMAS FAIRY,9,134,5,600,466,1,10.0
6926,3555.0,TRAVEL SEWING KIT,10,161,3,400,239,1,6.0
6927,3556.0,SET OF 3 NOTEBOOKS IN PARCEL,8,567,10,1100,533,1,20.0
6928,3557.0,RED RETROSPOT TAPE,10,1400,19,2000,600,1,38.0
6929,3558.0,COSY SLIPPER SHOES SMALL  RED ,5,242,13,1400,1158,1,26.0
6930,3559.0,8 RIBBONS RUSTIC CHARM,8,637,14,1500,863,1,28.0
6931,3560.0,SCANDINAVIAN REDS RIBBONS,2,1105,11,1200,95,1,22.0
6932,3561.0,JAM MAKING SET PRINTED,2,2340,25,2600,260,1,50.0
6933,3562.0,14 DAISY PEGS IN WOOD BOX,7,1301,20,2100,799,1,40.0
6934,3563.0,HOT WATER BOTTLE BABUSHKA ,7,1255,22,2300,1045,1,44.0
6935,3564.0,FELTCRAFT PRINCESS CHARLOTTE DOLL,3,627,13,1400,773,1,26.0
6936,3565.0,FELTCRAFT CHRISTMAS FAIRY,9,1040,15,1600,560,1,30.0
6937,3566.0,FELTCRAFT PRINCESS CHARLOTTE DOLL,10,1907,19,2000,93,1,38.0
6938,3567.0,8 RIBBONS RUSTIC CHARM,10,485,12,1300,815,1,24.0
6939,3568.0,COSY SLIPPER SHOES SMALL  RED ,9,477,4,500,23,1,8.0
6940,3569.0,SCANDINAVIAN REDS RIBBONS,5,609,20,2100,1491,1,40.0
6941,3570.0,7 HOOK HANGER RED MAGIC TOADSTOOL,4,355,12,1300,945,1,24.0
6942,3571.0,CHRISTMAS CRAFT TREE TOP ANGEL,6,429,7,800,371,1,14.0
6943,3572.0,CHRISTMAS CRAFT LITTLE FRIENDS,1,150,9,1000,850,1,18.0
6944,3573.0,7 HOOK HANGER RED MAGIC TOADSTOOL,6,358,8,900,542,1,16.0
6945,3574.0,8 RIBBONS RUSTIC CHARM,2,265,17,1800,1535,1,34.0
6946,3575.0,14 DAISY PEGS IN WOOD BOX,3,401,23,2400,1999,1,46.0
6947,3576.0,SET OF 3 NOTEBOOKS IN PARCEL,9,722,8,900,178,1,16.0
6948,3577.0,7 HOOK HANGER MAGIC TOADSTOOL,9,122,9,1000,878,1,18.0
6949,3578.0,SCANDINAVIAN REDS RIBBONS,1,149,12,1300,1151,1,24.0
6950,3579.0,RED TOADSTOOL LED NIGHT LIGHT,3,892,8,900,8,1,16.0
6951,3580.0,7 HOOK HANGER RED MAGIC TOADSTOOL,1,108,4,500,392,1,8.0
6952,3581.0,COSY SLIPPER SHOES SMALL GREEN,3,1298,18,1900,602,1,36.0
6953,3582.0,COSY SLIPPER SHOES SMALL  RED ,9,1184,17,1800,616,1,34.0
6954,3583.0,FELTCRAFT DOLL ROSIE,3,1266,14,1500,234,1,28.0
6955,3584.0,FELTCRAFT DOLL MOLLY,9,1600,17,1800,200,1,34.0
6956,3585.0,FELTCRAFT DOLL EMILY,10,136,1,200,64,1,2.0
6957,3586.0,FELTCRAFT PRINCESS CHARLOTTE DOLL,7,777,9,1000,223,1,18.0
6958,3587.0,FELTCRAFT PRINCESS OLIVIA DOLL,9,1572,19,2000,428,1,38.0
6959,3588.0,REX CASH+CARRY JUMBO SHOPPER,4,468,23,2400,1932,1,46.0
6960,3589.0,FELTCRAFT DOLL MOLLY,5,102,1,200,98,1,2.0
6961,3590.0,FELTCRAFT CUSHION OWL,8,276,20,2100,1824,1,40.0
6962,3591.0,CHRISTMAS CRAFT TREE TOP ANGEL,5,912,9,1000,88,1,18.0
6963,3592.0,CHRISTMAS CRAFT LITTLE FRIENDS,10,323,3,400,77,1,6.0
6964,3593.0,FELTCRAFT CUSHION RABBIT,9,188,2,300,112,1,4.0
6965,3594.0,FELTCRAFT CUSHION BUTTERFLY,4,177,2,300,123,1,4.0
6966,3595.0,14 DAISY PEGS IN WOOD BOX,1,983,22,2300,1317,1,44.0
6967,3596.0,PAPER CHAIN KIT 50'S CHRISTMAS ,2,1197,14,1500,303,1,28.0
6968,3597.0,FELTCRAFT CUSHION BUTTERFLY,8,2097,24,2500,403,1,48.0
6969,3598.0,14 DAISY PEGS IN WOOD BOX,5,128,20,2100,1972,1,40.0
6970,3599.0,ROSE COTTAGE KEEPSAKE BOX ,7,184,18,1900,1716,1,36.0
6971,3600.0,TOTE BAG I LOVE LONDON,6,1349,14,1500,151,1,28.0
6972,3601.0,14 DAISY PEGS IN WOOD BOX,2,1306,18,1900,594,1,36.0
6973,3602.0,TOTE BAG I LOVE LONDON,10,235,15,1600,1365,1,30.0
6974,3603.0,FOLDING UMBRELLA PINKWHITE POLKADOT,8,1429,18,1900,471,1,36.0
6975,3604.0,FOLDING UMBRELLA CREAM POLKADOT,3,123,2,300,177,1,4.0
6976,3605.0,FOLDING UMBRELLA WHITE/RED POLKADOT,2,314,3,400,86,1,6.0
6977,3606.0,SET 10 LIGHTS NIGHT OWL,3,153,10,1100,947,1,20.0
6978,3607.0,SMALL POPCORN HOLDER,2,2367,24,2500,133,1,48.0
6979,3608.0, SET 2 TEA TOWELS I LOVE LONDON ,9,588,6,700,112,1,12.0
6980,3609.0,FOLDING UMBRELLA RED/WHITE POLKADOT,5,1088,11,1200,112,1,22.0
6981,3610.0,BABUSHKA LIGHTS STRING OF 12,9,1565,25,2600,1035,1,50.0
6982,3611.0,LUNCH BAG RED RETROSPOT,7,755,25,2600,1845,1,50.0
6983,3612.0,S/4 VALENTINE DECOUPAGE HEART BOX,2,111,10,1100,989,1,20.0
6984,3613.0,FOLDING UMBRELLA CREAM POLKADOT,7,356,23,2400,2044,1,46.0
6985,3614.0, SET 2 TEA TOWELS I LOVE LONDON ,10,253,21,2200,1947,1,42.0
6986,3615.0,FOLDING UMBRELLA RED/WHITE POLKADOT,1,824,13,1400,576,1,26.0
6987,3616.0,SOLDIERS EGG CUP ,2,860,21,2200,1340,1,42.0
6988,3617.0,S/4 VALENTINE DECOUPAGE HEART BOX,3,916,25,2600,1684,1,50.0
6989,3618.0,RED RETROSPOT MINI CASES,3,807,9,1000,193,1,18.0
6990,3619.0,,9,1748,24,2500,752,1,48.0
6991,3620.0,62 CAKE CASES VINTAGE CHRISTMAS,7,103,8,900,797,1,16.0
6992,3621.0,PAPER CHAIN KIT VINTAGE CHRISTMAS,6,708,16,1700,992,1,32.0
6993,3622.0,RIBBON REEL CHRISTMAS SOCK BAUBLE,1,1446,22,2300,854,1,44.0
6994,3623.0,RIBBON REEL SNOWY VILLAGE,7,148,8,900,752,1,16.0
6995,3624.0,RIBBON REEL MAKING SNOWMEN ,6,1100,14,1500,400,1,28.0
6996,3625.0,SET OF 20 VINTAGE CHRISTMAS NAPKINS,3,267,9,1000,733,1,18.0
6997,3626.0,TURQUOISE CHRISTMAS TREE ,4,245,2,300,55,1,4.0
6998,3627.0,RED STAR CARD HOLDER,4,2273,24,2500,227,1,48.0
6999,3628.0,WICKER WREATH SMALL,4,1313,13,1400,87,1,26.0
7000,3629.0,HEART OF WICKER LARGE,7,508,13,1400,892,1,26.0
7001,3630.0,ADVENT CALENDAR GINGHAM SACK,1,1080,12,1300,220,1,24.0
7002,3631.0,HEART OF WICKER SMALL,4,310,17,1800,1490,1,34.0
7003,3632.0,FELTCRAFT BUTTERFLY HEARTS,5,407,10,1100,693,1,20.0
7004,3633.0,PARTY CONE CHRISTMAS DECORATION ,9,239,20,2100,1861,1,40.0
7005,3634.0,VINTAGE HEADS AND TAILS CARD GAME ,2,140,2,300,160,1,4.0
7006,3635.0,WICKER STAR ,4,226,2,300,74,1,4.0
7007,3636.0,VINTAGE SNAP CARDS,10,242,22,2300,2058,1,44.0
7008,3637.0,FELTCRAFT 6 FLOWER FRIENDS,5,493,21,2200,1707,1,42.0
7009,3638.0, SET 2 TEA TOWELS I LOVE LONDON ,6,545,5,600,55,1,10.0
7010,3639.0,JAM MAKING SET PRINTED,4,2473,24,2500,27,1,48.0
7011,3640.0,BIRD DECORATION RED RETROSPOT,3,164,4,500,336,1,8.0
7012,3641.0,CHRISTMAS GINGHAM TREE,6,1589,20,2100,511,1,40.0
7013,3642.0,CHRISTMAS GINGHAM STAR,2,386,16,1700,1314,1,32.0
7014,3643.0,CHRISTMAS GINGHAM HEART,9,197,21,2200,2003,1,42.0
7015,3644.0,PACK OF 12 PINK POLKADOT TISSUES,6,830,15,1600,770,1,30.0
7016,3645.0,FELTCRAFT PRINCESS LOLA DOLL,9,399,3,400,1,1,6.0
7017,3646.0,PACK OF 12 LONDON TISSUES ,7,451,19,2000,1549,1,38.0
7018,3647.0,PURPLE DRAWERKNOB ACRYLIC EDWARDIAN,2,782,9,1000,218,1,18.0
7019,3648.0,CHILDREN'S APRON DOLLY GIRL ,9,1209,20,2100,891,1,40.0
7020,3649.0,CHILDRENS APRON SPACEBOY DESIGN,10,100,0,100,0,1,0.0
7021,3650.0,CHRISTMAS LIGHTS 10 SANTAS ,7,100,0,100,0,1,0.0
7022,3651.0,CHRISTMAS LIGHTS 10 REINDEER,1,217,25,2600,2383,1,50.0
7023,3652.0,PAPER CHAIN KIT 50'S CHRISTMAS ,6,225,20,2100,1875,1,40.0
7024,3653.0,FELTCRAFT CHRISTMAS FAIRY,5,190,15,1600,1410,1,30.0
7025,3654.0,PACK OF 72 RETROSPOT CAKE CASES,8,1659,23,2400,741,1,46.0
7026,3655.0,PACK OF 60 MUSHROOM CAKE CASES,7,620,16,1700,1080,1,32.0
7027,3656.0,62 CAKE CASES DOLLY GIRL DESIGN,6,315,3,400,85,1,6.0
7028,3657.0,PACK OF 60 PINK PAISLEY CAKE CASES,8,351,11,1200,849,1,22.0
7029,3658.0,HAND WARMER BABUSHKA DESIGN,4,900,23,2400,1500,1,46.0
7030,3659.0,HAND WARMER BIRD DESIGN,4,1097,20,2100,1003,1,40.0
7031,3660.0,HAND WARMER OWL DESIGN,6,929,13,1400,471,1,26.0
7032,3661.0,HAND WARMER RED RETROSPOT,6,265,6,700,435,1,12.0
7033,3662.0,SET 12 RETRO WHITE CHALK STICKS,1,427,6,700,273,1,12.0
7034,3663.0,FELTCRAFT HAIRBAND RED AND BLUE,5,143,1,200,57,1,2.0
7035,3664.0,FELTCRAFT HAIRBAND PINK AND PURPLE,10,1200,15,1600,400,1,30.0
7036,3665.0,FELTCRAFT HAIRBANDS PINK AND WHITE ,3,334,12,1300,966,1,24.0
7037,3666.0,TV DINNER TRAY DOLLY GIRL,10,126,1,200,74,1,2.0
7038,3667.0,PLASTERS IN TIN VINTAGE PAISLEY ,1,1007,19,2000,993,1,38.0
7039,3668.0,PLASTERS IN TIN SPACEBOY,1,900,20,2100,1200,1,40.0
7040,3669.0,PLASTERS IN TIN WOODLAND ANIMALS,10,169,1,200,31,1,2.0
7041,3670.0,MAGIC DRAWING SLATE SPACEBOY ,5,651,8,900,249,1,16.0
7042,3671.0,MAGIC DRAWING SLATE CIRCUS PARADE  ,8,247,6,700,453,1,12.0
7043,3672.0,MAGIC DRAWING SLATE GO TO THE FAIR ,3,195,2,300,105,1,4.0
7044,3673.0,MAGIC DRAWING SLATE DOLLY GIRL ,3,1281,16,1700,419,1,32.0
7045,3674.0,CHARLIE + LOLA RED HOT WATER BOTTLE,6,323,8,900,577,1,16.0
7046,3675.0,HOT WATER BOTTLE BABUSHKA ,7,258,5,600,342,1,10.0
7047,3676.0,URBAN BLACK RIBBONS ,3,594,5,600,6,1,10.0
7048,3677.0,FELTCRAFT PRINCESS CHARLOTTE DOLL,10,455,13,1400,945,1,26.0
7049,3678.0,SET OF 6 T-LIGHTS TOADSTOOLS,1,1328,17,1800,472,1,34.0
7050,3679.0,ROTATING LEAVES T-LIGHT HOLDER,3,205,12,1300,1095,1,24.0
7051,3680.0,RED  HARMONICA IN BOX ,8,449,5,600,151,1,10.0
7052,3681.0,CUPCAKE LACE PAPER SET 8,3,1633,24,2500,867,1,48.0
7053,3682.0,FAMILY PHOTO FRAME CORNICE,6,404,4,500,96,1,8.0
7054,3683.0,TRIPLE PHOTO FRAME CORNICE ,1,158,4,500,342,1,8.0
7055,3684.0,WOODEN FRAME ANTIQUE WHITE ,1,1676,17,1800,124,1,34.0
7056,3685.0,WOODEN BOX OF DOMINOES,1,145,4,500,355,1,8.0
7057,3686.0,TRADITIONAL WOODEN CATCH CUP GAME ,4,1205,19,2000,795,1,38.0
7058,3687.0,TRADITIONAL WOODEN SKIPPING ROPE,10,208,20,2100,1892,1,40.0
7059,3688.0,S/6 WOODEN SKITTLES IN COTTON BAG,10,693,12,1300,607,1,24.0
7060,3689.0,RED METAL BEACH SPADE ,3,199,6,700,501,1,12.0
7061,3690.0,BOYS VINTAGE TIN SEASIDE BUCKET,6,599,25,2600,2001,1,50.0
7062,3691.0,GIRLS VINTAGE TIN SEASIDE BUCKET,1,831,18,1900,1069,1,36.0
7063,3692.0,GREY HEART HOT WATER BOTTLE,2,354,8,900,546,1,16.0
7064,3693.0,SCOTTIE DOG HOT WATER BOTTLE,7,1323,23,2400,1077,1,46.0
7065,3694.0,BIRD HOUSE HOT WATER BOTTLE,3,1962,21,2200,238,1,42.0
7066,3695.0,KINGS CHOICE TEA CADDY ,7,122,21,2200,2078,1,42.0
7067,3696.0,KINGS CHOICE BISCUIT TIN,2,589,7,800,211,1,14.0
7068,3697.0,METAL SIGN EMPIRE TEA,2,196,6,700,504,1,12.0
7069,3698.0,HOMEMADE JAM SCENTED CANDLES,1,1677,19,2000,323,1,38.0
7070,3699.0,SET OF 6 SOLDIER SKITTLES,9,195,3,400,205,1,6.0
7071,3700.0,FAWN BLUE HOT WATER BOTTLE,1,300,25,2600,2300,1,50.0
7072,3701.0,HAND WARMER RED RETROSPOT,1,597,6,700,103,1,12.0
7073,3702.0,HOT WATER BOTTLE BABUSHKA ,1,875,20,2100,1225,1,40.0
7074,3703.0,WHITE SKULL HOT WATER BOTTLE ,10,526,6,700,174,1,12.0
7075,3704.0,RETROSPOT HEART HOT WATER BOTTLE,9,389,13,1400,1011,1,26.0
7076,3705.0,RED WOOLLY HOTTIE WHITE HEART.,4,1763,24,2500,737,1,48.0
7077,3706.0,SCOTTIE DOG HOT WATER BOTTLE,7,333,9,1000,667,1,18.0
7078,3707.0,GREY HEART HOT WATER BOTTLE,2,395,12,1300,905,1,24.0
7079,3708.0,HOT WATER BOTTLE BABUSHKA ,3,238,4,500,262,1,8.0
7080,3709.0,PACK OF 6 BIRDY GIFT TAGS,8,1343,25,2600,1257,1,50.0
7081,3710.0,CHILLI LIGHTS,4,164,12,1300,1136,1,24.0
7082,3711.0,PIGGY BANK RETROSPOT ,5,954,15,1600,646,1,30.0
7083,3712.0,CERAMIC STRAWBERRY MONEY BOX,3,400,21,2200,1800,1,42.0
7084,3713.0,CERAMIC STRAWBERRY CAKE MONEY BANK,2,311,15,1600,1289,1,30.0
7085,3714.0,CERAMIC CHERRY CAKE MONEY BANK,3,366,24,2500,2134,1,48.0
7086,3715.0,CERAMIC HEART FAIRY CAKE MONEY BANK,8,1120,21,2200,1080,1,42.0
7087,3716.0,CERAMIC PIRATE CHEST MONEY BANK,6,1503,16,1700,197,1,32.0
7088,3717.0,DOORSTOP RETROSPOT HEART,8,1484,19,2000,516,1,38.0
7089,3718.0,GINGHAM HEART  DOORSTOP RED,6,782,8,900,118,1,16.0
7090,3719.0,RETROSPOT BABUSHKA DOORSTOP,4,246,2,300,54,1,4.0
7091,3720.0,SILK PURSE BABUSHKA RED,1,744,17,1800,1056,1,34.0
7092,3721.0,SILK PURSE BABUSHKA PINK,2,813,22,2300,1487,1,44.0
7093,3722.0,FAMILY PHOTO FRAME CORNICE,8,553,13,1400,847,1,26.0
7094,3723.0,SWEETHEART WIRE WALL TIDY,4,260,2,300,40,1,4.0
7095,3724.0,JAM MAKING SET PRINTED,2,2082,20,2100,18,1,40.0
7096,3725.0,RED RETROSPOT OVEN GLOVE ,2,989,12,1300,311,1,24.0
7097,3726.0,CREAM HEART CARD HOLDER,9,186,17,1800,1614,1,34.0
7098,3727.0,NAMASTE SWAGAT INCENSE,3,708,16,1700,992,1,32.0
7099,3728.0,CERAMIC STRAWBERRY DESIGN MUG,8,396,7,800,404,1,14.0
7100,3729.0,BLACK HEART CARD HOLDER,2,204,3,400,196,1,6.0
7101,3730.0,CLASSICAL ROSE SMALL VASE,1,584,9,1000,416,1,18.0
7102,3731.0,HYACINTH BULB T-LIGHT CANDLES,2,102,1,200,98,1,2.0
7103,3732.0,CHRISTMAS CRAFT WHITE FAIRY ,8,1295,15,1600,305,1,30.0
7104,3733.0,CHRISTMAS CRAFT LITTLE FRIENDS,6,696,6,700,4,1,12.0
7105,3734.0,COSY HOUR CIGAR BOX MATCHES ,3,112,1,200,88,1,2.0
7106,3735.0,RED TEA TOWEL CLASSIC DESIGN,10,464,12,1300,836,1,24.0
7107,3736.0,HEART FILIGREE DOVE  SMALL,7,709,12,1300,591,1,24.0
7108,3737.0,RETROSPOT CHILDRENS APRON,6,640,11,1200,560,1,22.0
7109,3738.0,COLOURING PENCILS BROWN TUBE,5,1042,10,1100,58,1,20.0
7110,3739.0,6 IVORY DINNER CANDLES SILVER FLOCK,4,293,8,900,607,1,16.0
7111,3740.0,HEART FILIGREE DOVE  SMALL,10,1986,24,2500,514,1,48.0
7112,3741.0,ZINC METAL HEART DECORATION,6,833,16,1700,867,1,32.0
7113,3742.0,GREEN FERN NOTEBOOK,7,258,12,1300,1042,1,24.0
7114,3743.0,BLUE PAISLEY NOTEBOOK,3,1974,23,2400,426,1,46.0
7115,3744.0,CHRYSANTHEMUM NOTEBOOK,9,1247,18,1900,653,1,36.0
7116,3745.0,LARGE CHINESE STYLE SCISSOR,3,637,6,700,63,1,12.0
7117,3746.0,SMALL CHINESE STYLE SCISSOR,5,331,5,600,269,1,10.0
7118,3747.0,S/6 WOODEN SKITTLES IN COTTON BAG,6,1466,18,1900,434,1,36.0
7119,3748.0,TRADITIONAL WOODEN SKIPPING ROPE,4,837,11,1200,363,1,22.0
7120,3749.0,SET OF 6 SOLDIER SKITTLES,9,2400,25,2600,200,1,50.0
7121,3750.0,6 TRADITIONAL SPINNING TOPS,9,1447,19,2000,553,1,38.0
7122,3751.0,ROTATING SILVER ANGELS T-LIGHT HLDR,10,813,12,1300,487,1,24.0
7123,3752.0,BLACK LOVE BIRD CANDLE,6,760,15,1600,840,1,30.0
7124,3753.0,RETROSPOT CHILDRENS APRON,10,258,8,900,642,1,16.0
7125,3754.0,HANGING GLASS ETCHED TEALIGHT,2,1648,16,1700,52,1,32.0
7126,3755.0,HANGING GLASS ETCHED TEALIGHT,9,303,18,1900,1597,1,36.0
7127,3756.0,BLUE NEW BAROQUE CANDLESTICK CANDLE,6,202,2,300,98,1,4.0
7128,3757.0,COOKING SET RETROSPOT,3,526,6,700,174,1,12.0
7129,3758.0,KINGS CHOICE GIANT TUBE MATCHES,9,440,8,900,460,1,16.0
7130,3759.0,COSY HOUR GIANT TUBE MATCHES,3,2187,24,2500,313,1,48.0
7131,3760.0,PLACE SETTING WHITE STAR,4,100,0,100,0,1,0.0
7132,3761.0,HYACINTH BULB T-LIGHT CANDLES,9,1169,22,2300,1131,1,44.0
7133,3762.0,S/15 SILVER GLASS BAUBLES IN BAG,1,759,17,1800,1041,1,34.0
7134,3763.0,FRENCH WC SIGN BLUE METAL,10,802,15,1600,798,1,30.0
7135,3764.0,KINGS CHOICE GIANT TUBE MATCHES,1,602,15,1600,998,1,30.0
7136,3765.0,74 SWEETHEART FAIRY CAKE CASES,1,143,13,1400,1257,1,26.0
7137,3766.0,ASSORTED COLOUR BIRD ORNAMENT,8,1430,23,2400,970,1,46.0
7138,3767.0,FAIRY SOAP SOAP HOLDER,8,1571,25,2600,1029,1,50.0
7139,3768.0,GREEN GIANT GARDEN THERMOMETER,1,1304,25,2600,1296,1,50.0
7140,3769.0,IVORY GIANT GARDEN THERMOMETER,7,1479,20,2100,621,1,40.0
7141,3770.0,BLUE GIANT GARDEN THERMOMETER,5,289,10,1100,811,1,20.0
7142,3771.0,PACK OF 60 PINK PAISLEY CAKE CASES,1,531,7,800,269,1,14.0
7143,3772.0,RETROSPOT HEART HOT WATER BOTTLE,10,1021,15,1600,579,1,30.0
7144,3773.0,CHICK GREY HOT WATER BOTTLE,1,336,20,2100,1764,1,40.0
7145,3774.0,VICTORIAN SEWING BOX SMALL ,9,180,1,200,20,1,2.0
7146,3775.0,VICTORIAN SEWING BOX MEDIUM,9,1471,16,1700,229,1,32.0
7147,3776.0,SET/10 RED POLKADOT PARTY CANDLES,1,831,15,1600,769,1,30.0
7148,3777.0,WASHROOM METAL SIGN,5,621,21,2200,1579,1,42.0
7149,3778.0,BLACK SWEETHEART BRACELET,8,177,10,1100,923,1,20.0
7150,3779.0,DIAMANTE HAIR GRIP PACK/2 BLACK DIA,10,1696,16,1700,4,1,32.0
7151,3780.0,BLACK DIAMANTE EXPANDABLE RING,6,588,14,1500,912,1,28.0
7152,3781.0,DIAMANTE HAIR GRIP PACK/2 RUBY,2,254,3,400,146,1,6.0
7153,3782.0,DIAMANTE HAIR GRIP PACK/2 MONTANA,8,628,14,1500,872,1,28.0
7154,3783.0,BLUE SWEETHEART BRACELET,7,682,6,700,18,1,12.0
7155,3784.0,PINK SWEETHEART BRACELET,1,628,8,900,272,1,16.0
7156,3785.0,PURPLE SWEETHEART BRACELET,2,590,14,1500,910,1,28.0
7157,3786.0,JUMBO BAG PINK POLKADOT,3,2419,24,2500,81,1,48.0
7158,3787.0,JUMBO BAG RED RETROSPOT,2,1123,17,1800,677,1,34.0
7159,3788.0,ASSORTED COLOUR BIRD ORNAMENT,6,1116,18,1900,784,1,36.0
7160,3789.0,PAPER CHAIN KIT 50'S CHRISTMAS ,4,925,15,1600,675,1,30.0
7161,3790.0,RIBBON REEL CHRISTMAS PRESENT ,1,228,15,1600,1372,1,30.0
7162,3791.0,FIRST AID TIN,2,551,20,2100,1549,1,40.0
7163,3792.0,MAKE YOUR OWN MONSOON CARD KIT,4,379,20,2100,1721,1,40.0
7164,3793.0,PACK OF 12 HEARTS DESIGN TISSUES ,7,451,6,700,249,1,12.0
7165,3794.0,PACK OF 12 RED RETROSPOT TISSUES ,5,773,9,1000,227,1,18.0
7166,3795.0,SOLDIERS EGG CUP ,8,100,0,100,0,1,0.0
7167,3796.0,HEART IVORY TRELLIS SMALL,4,119,4,500,381,1,8.0
7168,3797.0,HEART FILIGREE DOVE  SMALL,10,1264,17,1800,536,1,34.0
7169,3798.0,HEART FILIGREE DOVE LARGE,7,805,8,900,95,1,16.0
7170,3799.0,PACK 3 BOXES BIRD PANNETONE ,7,322,19,2000,1678,1,38.0
7171,3800.0,PACK 3 BOXES CHRISTMAS PANNETONE,4,123,10,1100,977,1,20.0
7172,3801.0,SMALL POPCORN HOLDER,9,885,11,1200,315,1,22.0
7173,3802.0,PACK OF 60 PINK PAISLEY CAKE CASES,7,1630,21,2200,570,1,42.0
7174,3803.0,SET OF 6 SOLDIER SKITTLES,2,1311,24,2500,1189,1,48.0
7175,3804.0,SWIRLY CIRCULAR RUBBERS IN BAG,6,465,18,1900,1435,1,36.0
7176,3805.0,VINTAGE PAISLEY STATIONERY SET,6,259,6,700,441,1,12.0
7177,3806.0,PAPER CHAIN KIT VINTAGE CHRISTMAS,8,165,1,200,35,1,2.0
7178,3807.0,SET/10 BLUE POLKADOT PARTY CANDLES,4,304,20,2100,1796,1,40.0
7179,3808.0,RIBBON REEL SOCKS AND MITTENS,2,662,25,2600,1938,1,50.0
7180,3809.0,62 CAKE CASES VINTAGE CHRISTMAS,3,101,2,300,199,1,4.0
7181,3810.0,CHRISTMAS METAL TAGS ASSORTED ,5,100,9,1000,900,1,18.0
7182,3811.0,CHRISTMAS TREE T-LIGHT HOLDER,9,1434,15,1600,166,1,30.0
7183,3812.0,STAR  T-LIGHT HOLDER ,3,260,14,1500,1240,1,28.0
7184,3813.0,HEART T-LIGHT HOLDER ,1,701,20,2100,1399,1,40.0
7185,3814.0,MINI FUNKY DESIGN TAPES,7,1332,16,1700,368,1,32.0
7186,3815.0,SET OF 6 T-LIGHTS SNOWMEN,10,376,11,1200,824,1,22.0
7187,3816.0,STAR WOODEN CHRISTMAS DECORATION,1,100,0,100,0,1,0.0
7188,3817.0,WOODEN HEART CHRISTMAS SCANDINAVIAN,1,866,9,1000,134,1,18.0
7189,3818.0,CHRISTMAS RETROSPOT TREE WOOD,9,281,11,1200,919,1,22.0
7190,3819.0,SET OF 6 T-LIGHTS SANTA,9,1573,17,1800,227,1,34.0
7191,3820.0,SET/9 CHRISTMAS T-LIGHTS SCENTED ,6,563,9,1000,437,1,18.0
7192,3821.0,BLUE ROSE FABRIC MIRROR,3,2179,21,2200,21,1,42.0
7193,3822.0,THREE CANVAS LUGGAGE TAGS,2,501,7,800,299,1,14.0
7194,3823.0,RETROSPOT PARTY BAG + STICKER SET,4,902,21,2200,1298,1,42.0
7195,3824.0,PLASTERS IN TIN VINTAGE PAISLEY ,8,215,7,800,585,1,14.0
7196,3825.0,RETROSPOT SMALL TUBE MATCHES,8,628,6,700,72,1,12.0
7197,3826.0,HAND WARMER SCOTTY DOG DESIGN,9,403,22,2300,1897,1,44.0
7198,3827.0,3D CHRISTMAS STAMPS STICKERS ,1,1966,22,2300,334,1,44.0
7199,3828.0,HAND WARMER SCOTTY DOG DESIGN,5,379,11,1200,821,1,22.0
7200,3829.0,HAND WARMER SCOTTY DOG DESIGN,3,243,12,1300,1057,1,24.0
7201,3830.0,CLOTHES PEGS RETROSPOT PACK 26,9,981,23,2400,1419,1,46.0
7202,3831.0,38 FOIL HEART CAKE CASES,1,688,8,900,212,1,16.0
7203,3832.0,CHRISTMAS METAL TAGS ASSORTED ,9,108,7,800,692,1,14.0
7204,3833.0,PACK OF 6 SWEETIE GIFT BOXES,4,507,11,1200,693,1,22.0
7205,3834.0,PACK OF 72 RETROSPOT CAKE CASES,2,458,7,800,342,1,14.0
7206,3835.0,PACK OF 72 RETROSPOT CAKE CASES,9,2283,23,2400,117,1,46.0
7207,3836.0,PACK OF 6 BIRDY GIFT TAGS,10,211,24,2500,2289,1,48.0
7208,3837.0,SET/10 RED POLKADOT PARTY CANDLES,8,496,12,1300,804,1,24.0
7209,3838.0,SET/10 PINK POLKADOT PARTY CANDLES,4,100,0,100,0,1,0.0
7210,3839.0,SET OF 3 NOTEBOOKS IN PARCEL,3,998,9,1000,2,1,18.0
7211,3840.0,STAR  T-LIGHT HOLDER ,6,1614,22,2300,686,1,44.0
7212,3841.0,CINAMMON SET OF 9 T-LIGHTS,9,1189,22,2300,1111,1,44.0
7213,3842.0,ORANGE SCENTED SET/9 T-LIGHTS,3,256,14,1500,1244,1,28.0
7214,3843.0,RIBBON REEL STRIPES DESIGN ,9,939,12,1300,361,1,24.0
7215,3844.0,SET OF 2 TINS JARDIN DE PROVENCE,6,154,10,1100,946,1,20.0
7216,3845.0,MAKE YOUR OWN PLAYTIME CARD KIT,4,1518,24,2500,982,1,48.0
7217,3846.0,DINOSAURS  WRITING SET ,4,864,18,1900,1036,1,36.0
7218,3847.0,BALLOONS  WRITING SET ,2,351,7,800,449,1,14.0
7219,3848.0,SKULLS WRITING SET ,1,104,8,900,796,1,16.0
7220,3849.0,VINTAGE PAISLEY STATIONERY SET,9,607,23,2400,1793,1,46.0
7221,3850.0,COSY SLIPPER SHOES SMALL  RED ,8,164,4,500,336,1,8.0
7222,3851.0,DOORMAT BLACK FLOCK ,4,1322,17,1800,478,1,34.0
7223,3852.0,JUMBO  BAG BAROQUE BLACK WHITE,6,489,6,700,211,1,12.0
7224,3853.0,JAM MAKING SET WITH JARS,2,209,2,300,91,1,4.0
7225,3854.0,ORANGE SCENTED SET/9 T-LIGHTS,7,1096,10,1100,4,1,20.0
7226,3855.0,CINAMMON SET OF 9 T-LIGHTS,7,189,1,200,11,1,2.0
7227,3856.0,HAND WARMER SCOTTY DOG DESIGN,9,767,13,1400,633,1,26.0
7228,3857.0,CHRISTMAS DECOUPAGE CANDLE,10,217,7,800,583,1,14.0
7229,3858.0,HEART T-LIGHT HOLDER ,2,1808,24,2500,692,1,48.0
7230,3859.0,GROW YOUR OWN BASIL IN ENAMEL MUG,9,180,12,1300,1120,1,24.0
7231,3860.0,OFFICE MUG WARMER POLKADOT,5,1017,12,1300,283,1,24.0
7232,3861.0,SMALL POPCORN HOLDER,9,100,0,100,0,1,0.0
7233,3862.0,JUMBO BAG DOLLY GIRL DESIGN,10,383,7,800,417,1,14.0
7234,3863.0,JAM MAKING SET WITH JARS,9,235,2,300,65,1,4.0
7235,3864.0,JAM MAKING SET PRINTED,1,1176,24,2500,1324,1,48.0
7236,3865.0,SMALL GLASS HEART TRINKET POT,9,787,14,1500,713,1,28.0
7237,3866.0,RED WOOLLY HOTTIE WHITE HEART.,5,2046,21,2200,154,1,42.0
7238,3867.0,BLACK RECORD COVER FRAME,8,772,10,1100,328,1,20.0
7239,3868.0,"RECORD FRAME 7"" SINGLE SIZE ",1,1331,18,1900,569,1,36.0
7240,3869.0,38 PENCILS TUBE RED RETROSPOT,5,344,5,600,256,1,10.0
7241,3870.0,38 PENCILS TUBE WOODLAND,7,1158,20,2100,942,1,40.0
7242,3871.0,SET OF 6 SOLDIER SKITTLES,6,1564,17,1800,236,1,34.0
7243,3872.0,ROCKING HORSE RED CHRISTMAS ,3,582,5,600,18,1,10.0
7244,3873.0,CHRISTMAS GINGHAM HEART,10,772,22,2300,1528,1,44.0
7245,3874.0,CHRISTMAS GINGHAM STAR,8,749,14,1500,751,1,28.0
7246,3875.0,HAND WARMER UNION JACK,7,1006,19,2000,994,1,38.0
7247,3876.0,HAND WARMER RED RETROSPOT,3,168,2,300,132,1,4.0
7248,3877.0,REGENCY CAKESTAND 3 TIER,4,564,17,1800,1236,1,34.0
7249,3878.0,JUMBO SHOPPER VINTAGE RED PAISLEY,10,1515,22,2300,785,1,44.0
7250,3879.0,RIBBON REEL SNOWY VILLAGE,4,1872,22,2300,428,1,44.0
7251,3880.0,VINTAGE UNION JACK BUNTING,3,661,20,2100,1439,1,40.0
7252,3881.0,JAM MAKING SET WITH JARS,3,206,21,2200,1994,1,42.0
7253,3882.0,RIBBON REEL STRIPES DESIGN ,8,682,19,2000,1318,1,38.0
7254,3883.0,RETRO LONGBOARD IRONING BOARD COVER,10,507,9,1000,493,1,18.0
7255,3884.0,3D DOG PICTURE PLAYING CARDS,1,738,10,1100,362,1,20.0
7256,3885.0,RETROSPOT CIGAR BOX MATCHES ,7,320,21,2200,1880,1,42.0
7257,3886.0,SET/9 CHRISTMAS T-LIGHTS SCENTED ,2,698,9,1000,302,1,18.0
7258,3887.0,ROTATING SILVER ANGELS T-LIGHT HLDR,9,392,8,900,508,1,16.0
7259,3888.0,ROTATING SILVER ANGELS T-LIGHT HLDR,9,529,10,1100,571,1,20.0
7260,3889.0,SAVE THE PLANET COTTON TOTE BAG,10,1866,20,2100,234,1,40.0
7261,3890.0,SET OF 20 VINTAGE CHRISTMAS NAPKINS,6,2055,21,2200,145,1,42.0
7262,3891.0,PAPER BUNTING WHITE LACE,6,1554,20,2100,546,1,40.0
7263,3892.0,GENTLEMAN SHIRT REPAIR KIT ,1,100,0,100,0,1,0.0
7264,3893.0,CARD I LOVE LONDON ,3,323,5,600,277,1,10.0
7265,3894.0,PAPER CHAIN KIT VINTAGE CHRISTMAS,2,420,17,1800,1380,1,34.0
7266,3895.0,MIRRORED WALL ART FOXY,3,960,23,2400,1440,1,46.0
7267,3896.0,MIRRORED WALL ART GENTS,10,2040,23,2400,360,1,46.0
7268,3897.0,AIRLINE BAG VINTAGE JET SET WHITE,3,461,17,1800,1339,1,34.0
7269,3898.0,JAM MAKING SET PRINTED,8,1094,20,2100,1006,1,40.0
7270,3899.0,POTTING SHED SOW 'N' GROW SET,4,253,2,300,47,1,4.0
7271,3900.0,BABUSHKA LIGHTS STRING OF 12,7,788,10,1100,312,1,20.0
7272,3901.0,REX CASH+CARRY JUMBO SHOPPER,4,780,17,1800,1020,1,34.0
7273,3902.0,AIRLINE BAG VINTAGE WORLD CHAMPION ,7,159,18,1900,1741,1,36.0
7274,3903.0,HAND WARMER BIRD DESIGN,4,309,4,500,191,1,8.0
7275,3904.0,CHRISTMAS CRAFT LITTLE FRIENDS,2,775,11,1200,425,1,22.0
7276,3905.0,PINK HEARTS PAPER GARLAND,6,755,15,1600,845,1,30.0
7277,3906.0,POTTING SHED SEED ENVELOPES,10,817,15,1600,783,1,30.0
7278,3907.0,HI TEC ALPINE HAND WARMER,3,305,12,1300,995,1,24.0
7279,3908.0,FELTCRAFT CHRISTMAS FAIRY,4,531,15,1600,1069,1,30.0
7280,3909.0,HI TEC ALPINE HAND WARMER,2,544,5,600,56,1,10.0
7281,3910.0,ROTATING SILVER ANGELS T-LIGHT HLDR,1,441,20,2100,1659,1,40.0
7282,3911.0,5 STRIPEY MICE FELTCRAFT,8,1372,14,1500,128,1,28.0
7283,3912.0,FELTCRAFT 6 FLOWER FRIENDS,10,139,5,600,461,1,10.0
7284,3913.0,CHRISTMAS CRAFT LITTLE FRIENDS,5,632,9,1000,368,1,18.0
7285,3914.0,VINTAGE UNION JACK CUSHION COVER,1,968,11,1200,232,1,22.0
7286,3915.0,POLYESTER FILLER PAD 45x45cm,2,269,21,2200,1931,1,42.0
7287,3916.0,DOLLY GIRL LUNCH BOX,6,589,20,2100,1511,1,40.0
7288,3917.0,PACK OF 12 LONDON TISSUES ,4,1277,15,1600,323,1,30.0
7289,3918.0,CARD DOLLY GIRL ,3,441,4,500,59,1,8.0
7290,3919.0,CARD BILLBOARD FONT,4,800,23,2400,1600,1,46.0
7291,3920.0,RAINY LADIES BIRTHDAY CARD,10,746,21,2200,1454,1,42.0
7292,3921.0,GREY HEART HOT WATER BOTTLE,9,148,7,800,652,1,14.0
7293,3922.0,RED WOOLLY HOTTIE WHITE HEART.,9,1099,21,2200,1101,1,42.0
7294,3923.0,RED WHITE SCARF  HOT WATER BOTTLE,4,1552,19,2000,448,1,38.0
7295,3924.0, SET 2 TEA TOWELS I LOVE LONDON ,4,395,19,2000,1605,1,38.0
7296,3925.0,SET OF 2 TEA TOWELS APPLE AND PEARS,8,1328,20,2100,772,1,40.0
7297,3926.0,SET/2 RED RETROSPOT TEA TOWELS ,9,787,7,800,13,1,14.0
7298,3927.0,LOVE BUILDING BLOCK WORD,5,761,7,800,39,1,14.0
7299,3928.0,HOME BUILDING BLOCK WORD,6,380,21,2200,1820,1,42.0
7300,3929.0,ASSORTED COLOUR BIRD ORNAMENT,3,222,4,500,278,1,8.0
7301,3930.0,LANTERN CREAM GAZEBO ,1,116,25,2600,2484,1,50.0
7302,3931.0,BLUE BIRDHOUSE DECORATION,5,1599,15,1600,1,1,30.0
7303,3932.0,WHITE HANGING HEART T-LIGHT HOLDER,8,115,8,900,785,1,16.0
7304,3933.0,REGENCY CAKESTAND 3 TIER,6,586,15,1600,1014,1,30.0
7305,3934.0,ANTIQUE SILVER TEA GLASS ENGRAVED,10,2013,22,2300,287,1,44.0
7306,3935.0,AGED GLASS SILVER T-LIGHT HOLDER,4,1217,25,2600,1383,1,50.0
7307,3936.0,JAM MAKING SET WITH JARS,5,1084,20,2100,1016,1,40.0
7308,3937.0,HAND WARMER OWL DESIGN,2,113,5,600,487,1,10.0
7309,3938.0,SET OF 2 WOODEN MARKET CRATES,4,1417,22,2300,883,1,44.0
7310,3939.0,SET OF 6 T-LIGHTS TOADSTOOLS,8,245,4,500,255,1,8.0
7311,3940.0,HAND WARMER UNION JACK,8,564,6,700,136,1,12.0
7312,3941.0,HAND WARMER SCOTTY DOG DESIGN,5,477,12,1300,823,1,24.0
7313,3942.0,CLASSIC FRENCH STYLE BASKET NATURAL,5,312,13,1400,1088,1,26.0
7314,3943.0,CRAZY DAISY HEART DECORATION,9,106,1,200,94,1,2.0
7315,3944.0,GIN + TONIC DIET METAL SIGN,1,331,5,600,269,1,10.0
7316,3945.0,IVORY GIANT GARDEN THERMOMETER,5,1342,16,1700,358,1,32.0
7317,3946.0,CARD HOLDER GINGHAM HEART,9,287,7,800,513,1,14.0
7318,3947.0,SMALL STRIPES CHOCOLATE GIFT BAG ,1,614,20,2100,1486,1,40.0
7319,3948.0,S/6 WOODEN SKITTLES IN COTTON BAG,5,362,21,2200,1838,1,42.0
7320,3949.0,HAND WARMER RED RETROSPOT,6,577,18,1900,1323,1,36.0
7321,3950.0,HAND WARMER UNION JACK,1,821,21,2200,1379,1,42.0
7322,3951.0,FRENCH WC SIGN BLUE METAL,6,210,9,1000,790,1,18.0
7323,3952.0,PINK UNION JACK  LUGGAGE TAG,4,1806,21,2200,394,1,42.0
7324,3953.0,"TRAY, BREAKFAST IN BED",1,113,3,400,287,1,6.0
7325,3954.0,PIZZA PLATE IN BOX,3,137,1,200,63,1,2.0
7326,3955.0,HEART OF WICKER LARGE,3,242,23,2400,2158,1,46.0
7327,3956.0,PINK HEART DOTS HOT WATER BOTTLE,3,806,20,2100,1294,1,40.0
7328,3957.0,PLACE SETTING WHITE HEART,5,148,6,700,552,1,12.0
7329,3958.0,SET OF 4 NAPKIN CHARMS LEAVES   ,4,457,8,900,443,1,16.0
7330,3959.0,SET OF 4 NAPKIN CHARMS STARS   ,9,359,14,1500,1141,1,28.0
7331,3960.0,SET OF 4 NAPKIN CHARMS CUTLERY,5,1027,25,2600,1573,1,50.0
7332,3961.0,CARAVAN SQUARE TISSUE BOX,10,818,17,1800,982,1,34.0
7333,3962.0,PLASTERS IN TIN SKULLS,10,1808,22,2300,492,1,44.0
7334,3963.0,PLASTERS IN TIN SPACEBOY,5,148,11,1200,1052,1,22.0
7335,3964.0,BUTTON BOX ,7,1003,15,1600,597,1,30.0
7336,3965.0,PLASTERS IN TIN VINTAGE PAISLEY ,3,696,8,900,204,1,16.0
7337,3966.0,14 MESSAGE CARDS WITH ENVELOPES,8,516,7,800,284,1,14.0
7338,3967.0,SMALL RED BABUSHKA NOTEBOOK ,3,1895,23,2400,505,1,46.0
7339,3968.0,CUPCAKE LACE PAPER SET 8,1,1988,19,2000,12,1,38.0
7340,3969.0,PACK 3 BOXES CHRISTMAS PANNETONE,4,340,10,1100,760,1,20.0
7341,3970.0,HERB MARKER MINT,10,600,7,800,200,1,14.0
7342,3971.0,HERB MARKER ROSEMARY,1,138,4,500,362,1,8.0
7343,3972.0,HERB MARKER BASIL,6,949,9,1000,51,1,18.0
7344,3973.0,HERB MARKER CHIVES ,2,2187,23,2400,213,1,46.0
7345,3974.0,HERB MARKER PARSLEY,2,189,5,600,411,1,10.0
7346,3975.0,HERB MARKER THYME,1,679,23,2400,1721,1,46.0
7347,3976.0,WHITE HANGING HEART T-LIGHT HOLDER,1,530,6,700,170,1,12.0
7348,3977.0,METAL MERRY CHRISTMAS WREATH,8,220,3,400,180,1,6.0
7349,3978.0,WHITE CHRISTMAS GARLAND STARS TREES,9,687,8,900,213,1,16.0
7350,3979.0,RETROSPOT SMALL TUBE MATCHES,4,974,20,2100,1126,1,40.0
7351,3980.0,RETROSPOT GIANT TUBE MATCHES,1,336,24,2500,2164,1,48.0
7352,3981.0,PLACE SETTING WHITE STAR,7,928,16,1700,772,1,32.0
7353,3982.0,GROW YOUR OWN BASIL IN ENAMEL MUG,2,410,20,2100,1690,1,40.0
7354,3983.0,38 FOIL STAR CAKE CASES ,1,230,3,400,170,1,6.0
7355,3984.0,38 FOIL HEART CAKE CASES,5,396,11,1200,804,1,22.0
7356,3985.0,PACK OF 6 SWEETIE GIFT BOXES,8,480,10,1100,620,1,20.0
7357,3986.0,PACK OF 6 HANDBAG GIFT BOXES,10,1350,19,2000,650,1,38.0
7358,3987.0,GARLAND WOODEN HAPPY EASTER,3,2538,25,2600,62,1,50.0
7359,3988.0,CALENDAR PAPER CUT DESIGN,4,212,14,1500,1288,1,28.0
7360,3989.0,CALENDAR IN SEASON DESIGN,9,523,18,1900,1377,1,36.0
7361,3990.0,SMALL POPCORN HOLDER,3,740,9,1000,260,1,18.0
7362,3991.0,BLUE PAISLEY TISSUE BOX,9,773,8,900,127,1,16.0
7363,3992.0,HEART OF WICKER SMALL,8,229,2,300,71,1,4.0
7364,3993.0,SKULLS SQUARE TISSUE BOX,4,734,8,900,166,1,16.0
7365,3994.0,SKULLS SQUARE TISSUE BOX,10,268,15,1600,1332,1,30.0
7366,3995.0,WHITE HANGING HEART T-LIGHT HOLDER,9,1344,19,2000,656,1,38.0
7367,3996.0,WHITE METAL LANTERN,1,472,23,2400,1928,1,46.0
7368,3997.0,CREAM CUPID HEARTS COAT HANGER,9,616,16,1700,1084,1,32.0
7369,3998.0,KNITTED UNION FLAG HOT WATER BOTTLE,4,474,16,1700,1226,1,32.0
7370,3999.0,RED WOOLLY HOTTIE WHITE HEART.,9,443,11,1200,757,1,22.0
7371,4000.0,SET 7 BABUSHKA NESTING BOXES,9,1184,22,2300,1116,1,44.0
7372,4001.0,GLASS STAR FROSTED T-LIGHT HOLDER,9,114,1,200,86,1,2.0
7373,4002.0,HAND WARMER UNION JACK,3,415,11,1200,785,1,22.0
7374,4003.0,HAND WARMER RED POLKA DOT,5,632,20,2100,1468,1,40.0
7375,4004.0,ASSORTED COLOUR BIRD ORNAMENT,6,1063,18,1900,837,1,36.0
7376,4005.0,POPPY'S PLAYHOUSE BEDROOM ,2,376,15,1600,1224,1,30.0
7377,4006.0,POPPY'S PLAYHOUSE KITCHEN,2,1199,12,1300,101,1,24.0
7378,4007.0,FELTCRAFT PRINCESS CHARLOTTE DOLL,7,1588,20,2100,512,1,40.0
7379,4008.0,IVORY KNITTED MUG COSY ,8,209,5,600,391,1,10.0
7380,4009.0,BOX OF 6 ASSORTED COLOUR TEASPOONS,2,1654,18,1900,246,1,36.0
7381,4010.0,BOX OF VINTAGE JIGSAW BLOCKS ,8,647,7,800,153,1,14.0
7382,4011.0,BOX OF VINTAGE ALPHABET BLOCKS,6,174,2,300,126,1,4.0
7383,4012.0,HOME BUILDING BLOCK WORD,3,720,13,1400,680,1,26.0
7384,4013.0,LOVE BUILDING BLOCK WORD,6,100,0,100,0,1,0.0
7385,4014.0,RECIPE BOX WITH METAL HEART,8,652,8,900,248,1,16.0
7386,4015.0,DOORMAT NEW ENGLAND,1,305,21,2200,1895,1,42.0
7387,4016.0,JAM MAKING SET WITH JARS,2,748,20,2100,1352,1,40.0
7388,4017.0,RED COAT RACK PARIS FASHION,8,1074,16,1700,626,1,32.0
7389,4018.0,YELLOW COAT RACK PARIS FASHION,9,190,4,500,310,1,8.0
7390,4019.0,BLUE COAT RACK PARIS FASHION,3,2236,23,2400,164,1,46.0
7391,4020.0,BATH BUILDING BLOCK WORD,9,1625,19,2000,375,1,38.0
7392,4021.0,ALARM CLOCK BAKELIKE PINK,3,456,5,600,144,1,10.0
7393,4022.0,ALARM CLOCK BAKELIKE RED ,3,782,15,1600,818,1,30.0
7394,4023.0,ALARM CLOCK BAKELIKE GREEN,1,234,2,300,66,1,4.0
7395,4024.0,PANDA AND BUNNIES STICKER SHEET,1,451,6,700,249,1,12.0
7396,4025.0,STARS GIFT TAPE ,1,1378,13,1400,22,1,26.0
7397,4026.0,INFLATABLE POLITICAL GLOBE ,8,995,25,2600,1605,1,50.0
7398,4027.0,VINTAGE HEADS AND TAILS CARD GAME ,1,1469,20,2100,631,1,40.0
7399,4028.0,SET/2 RED RETROSPOT TEA TOWELS ,4,211,6,700,489,1,12.0
7400,4029.0,ROUND SNACK BOXES SET OF4 WOODLAND ,6,498,6,700,202,1,12.0
7401,4030.0,SPACEBOY LUNCH BOX ,10,132,25,2600,2468,1,50.0
7402,4031.0,LUNCH BOX I LOVE LONDON,1,419,14,1500,1081,1,28.0
7403,4032.0,CIRCUS PARADE LUNCH BOX ,6,158,1,200,42,1,2.0
7404,4033.0,CHARLOTTE BAG DOLLY GIRL DESIGN,8,828,8,900,72,1,16.0
7405,4034.0,RED TOADSTOOL LED NIGHT LIGHT,7,197,2,300,103,1,4.0
7406,4035.0, SET 2 TEA TOWELS I LOVE LONDON ,6,1003,13,1400,397,1,26.0
7407,4036.0,VINTAGE SEASIDE JIGSAW PUZZLES,6,1108,19,2000,892,1,38.0
7408,4037.0,MINI JIGSAW CIRCUS PARADE ,7,606,9,1000,394,1,18.0
7409,4038.0,MINI JIGSAW SPACEBOY,6,924,11,1200,276,1,22.0
7410,4039.0,MINI PAINT SET VINTAGE ,1,1531,21,2200,669,1,42.0
7411,4040.0,POSTAGE,1,144,5,600,456,1,10.0
7412,4041.0,PAPER CHAIN KIT 50'S CHRISTMAS ,8,415,7,800,385,1,14.0
7413,4042.0,HAND WARMER RED POLKA DOT,8,666,11,1200,534,1,22.0
7414,4043.0,HAND WARMER UNION JACK,6,897,9,1000,103,1,18.0
7415,4044.0,WHITE HANGING HEART T-LIGHT HOLDER,6,1162,11,1200,38,1,22.0
7416,4045.0,WHITE METAL LANTERN,2,1603,25,2600,997,1,50.0
7417,4046.0,CREAM CUPID HEARTS COAT HANGER,1,310,6,700,390,1,12.0
7418,4047.0,EDWARDIAN PARASOL RED,10,1486,17,1800,314,1,34.0
7419,4048.0,RETRO COFFEE MUGS ASSORTED,4,100,0,100,0,1,0.0
7420,4049.0,SAVE THE PLANET MUG,9,257,2,300,43,1,4.0
7421,4050.0,VINTAGE BILLBOARD DRINK ME MUG,5,1820,20,2100,280,1,40.0
7422,4051.0,VINTAGE BILLBOARD LOVE/HATE MUG,5,823,15,1600,777,1,30.0
7423,4052.0,WOOD 2 DRAWER CABINET WHITE FINISH,6,1193,12,1300,107,1,24.0
7424,4053.0,WOOD S/3 CABINET ANT WHITE FINISH,7,1155,21,2200,1045,1,42.0
7425,4054.0,WOODEN PICTURE FRAME WHITE FINISH,1,189,10,1100,911,1,20.0
7426,4055.0,WOODEN FRAME ANTIQUE WHITE ,6,2006,24,2500,494,1,48.0
7427,4056.0,KNITTED UNION FLAG HOT WATER BOTTLE,9,738,14,1500,762,1,28.0
7428,4057.0,RED WOOLLY HOTTIE WHITE HEART.,4,265,20,2100,1835,1,40.0
7429,4058.0,SET 7 BABUSHKA NESTING BOXES,10,174,1,200,26,1,2.0
7430,4059.0,GLASS STAR FROSTED T-LIGHT HOLDER,1,687,11,1200,513,1,22.0
7431,4060.0,VICTORIAN SEWING BOX LARGE,2,276,4,500,224,1,8.0
7432,4061.0,WHITE HANGING HEART T-LIGHT HOLDER,4,783,18,1900,1117,1,36.0
7433,4062.0,WHITE METAL LANTERN,8,1399,25,2600,1201,1,50.0
7434,4063.0,CREAM CUPID HEARTS COAT HANGER,3,174,11,1200,1026,1,22.0
7435,4064.0,EDWARDIAN PARASOL RED,9,100,0,100,0,1,0.0
7436,4065.0,RETRO COFFEE MUGS ASSORTED,4,1766,17,1800,34,1,34.0
7437,4066.0,SAVE THE PLANET MUG,1,729,7,800,71,1,14.0
7438,4067.0,VINTAGE BILLBOARD DRINK ME MUG,7,301,13,1400,1099,1,26.0
7439,4068.0,VINTAGE BILLBOARD LOVE/HATE MUG,3,549,6,700,151,1,12.0
7440,4069.0,WOOD 2 DRAWER CABINET WHITE FINISH,2,453,19,2000,1547,1,38.0
7441,4070.0,WOOD S/3 CABINET ANT WHITE FINISH,10,698,17,1800,1102,1,34.0
7442,4071.0,WOODEN PICTURE FRAME WHITE FINISH,2,1203,14,1500,297,1,28.0
7443,4072.0,WOODEN FRAME ANTIQUE WHITE ,8,348,23,2400,2052,1,46.0
7444,4073.0,KNITTED UNION FLAG HOT WATER BOTTLE,7,1389,16,1700,311,1,32.0
7445,4074.0,RED WOOLLY HOTTIE WHITE HEART.,7,943,12,1300,357,1,24.0
7446,4075.0,SET 7 BABUSHKA NESTING BOXES,4,222,2,300,78,1,4.0
7447,4076.0,GLASS STAR FROSTED T-LIGHT HOLDER,4,1016,21,2200,1184,1,42.0
7448,4077.0,HOT WATER BOTTLE TEA AND SYMPATHY,8,209,10,1100,891,1,20.0
7449,4078.0,RED HANGING HEART T-LIGHT HOLDER,6,297,3,400,103,1,6.0
7450,4079.0,HAND WARMER RED POLKA DOT,5,110,1,200,90,1,2.0
7451,4080.0,HAND WARMER UNION JACK,9,1289,12,1300,11,1,24.0
7452,4081.0,JUMBO BAG PINK POLKADOT,3,886,14,1500,614,1,28.0
7453,4082.0,JUMBO  BAG BAROQUE BLACK WHITE,4,429,4,500,71,1,8.0
7454,4083.0,JUMBO BAG CHARLIE AND LOLA TOYS,1,1785,23,2400,615,1,46.0
7455,4084.0,STRAWBERRY CHARLOTTE BAG,2,136,4,500,364,1,8.0
7456,4085.0,RED 3 PIECE RETROSPOT CUTLERY SET,2,443,4,500,57,1,8.0
7457,4086.0,BLUE 3 PIECE POLKADOT CUTLERY SET,6,996,14,1500,504,1,28.0
7458,4087.0,SET/6 RED SPOTTY PAPER PLATES,2,904,10,1100,196,1,20.0
7459,4088.0,LUNCH BAG RED RETROSPOT,3,219,4,500,281,1,8.0
7460,4089.0,STRAWBERRY LUNCH BOX WITH CUTLERY,8,232,4,500,268,1,8.0
7461,4090.0,LUNCH BOX WITH CUTLERY RETROSPOT ,5,358,25,2600,2242,1,50.0
7462,4091.0,PACK OF 72 RETROSPOT CAKE CASES,4,225,4,500,275,1,8.0
7463,4092.0,PACK OF 60 DINOSAUR CAKE CASES,6,378,15,1600,1222,1,30.0
7464,4093.0,PACK OF 60 PINK PAISLEY CAKE CASES,7,1170,17,1800,630,1,34.0
7465,4094.0,63 TEATIME FAIRY CAKE CASES,6,694,9,1000,306,1,18.0
7466,4095.0,TOMATO CHARLIE+LOLA COASTER SET,3,690,10,1100,410,1,20.0
7467,4096.0,CHARLIE & LOLA WASTEPAPER BIN FLORA,6,530,18,1900,1370,1,36.0
7468,4097.0,RED CHARLIE+LOLA PERSONAL DOORSIGN,6,169,1,200,31,1,2.0
7469,4098.0,JUMBO STORAGE BAG SUKI,8,653,6,700,47,1,12.0
7470,4099.0,JUMBO BAG PINK VINTAGE PAISLEY,10,479,6,700,221,1,12.0
7471,4100.0,JAM MAKING SET PRINTED,2,1095,12,1300,205,1,24.0
7472,4101.0,RETROSPOT TEA SET CERAMIC 11 PC ,7,499,10,1100,601,1,20.0
7473,4102.0,GIRLY PINK TOOL SET,2,1568,24,2500,932,1,48.0
7474,4103.0,JUMBO SHOPPER VINTAGE RED PAISLEY,7,142,6,700,558,1,12.0
7475,4104.0,"AIRLINE LOUNGE,METAL SIGN",6,259,6,700,441,1,12.0
7476,4105.0,WHITE SPOT RED CERAMIC DRAWER KNOB,8,226,13,1400,1174,1,26.0
7477,4106.0,RED DRAWER KNOB ACRYLIC EDWARDIAN,9,1649,17,1800,151,1,34.0
7478,4107.0,CLEAR DRAWER KNOB ACRYLIC EDWARDIAN,7,914,12,1300,386,1,24.0
7479,4108.0,PHOTO CLIP LINE,10,1427,16,1700,273,1,32.0
7480,4109.0,FELT EGG COSY CHICKEN,4,2509,25,2600,91,1,50.0
7481,4110.0,PIGGY BANK RETROSPOT ,5,1348,25,2600,1252,1,50.0
7482,4111.0,SKULL SHOULDER BAG,2,747,11,1200,453,1,22.0
7483,4112.0,YOU'RE CONFUSING ME METAL SIGN ,6,396,3,400,4,1,6.0
7484,4113.0,COOK WITH WINE METAL SIGN ,10,561,13,1400,839,1,26.0
7485,4114.0,GIN + TONIC DIET METAL SIGN,10,217,4,500,283,1,8.0
7486,4115.0,YELLOW BREAKFAST CUP AND SAUCER,7,1076,14,1500,424,1,28.0
7487,4116.0,PINK BREAKFAST CUP AND SAUCER ,2,444,18,1900,1456,1,36.0
7488,4117.0,PAPER CHAIN KIT 50'S CHRISTMAS ,7,657,25,2600,1943,1,50.0
7489,4118.0,PAPER CHAIN KIT RETROSPOT,7,858,11,1200,342,1,22.0
7490,4119.0,SMALL HEART FLOWERS HOOK ,8,137,25,2600,2463,1,50.0
7491,4120.0,PHOTO CLIP LINE,1,111,2,300,189,1,4.0
7492,4121.0,TEA TIME DES TEA COSY,7,1042,19,2000,958,1,38.0
7493,4122.0,FELT EGG COSY WHITE RABBIT ,7,526,18,1900,1374,1,36.0
7494,4123.0,ZINC WILLIE WINKIE  CANDLE STICK,2,130,16,1700,1570,1,32.0
7495,4124.0,CERAMIC CHERRY CAKE MONEY BANK,10,199,1,200,1,1,2.0
7496,4125.0,RETROSPOT LARGE MILK JUG,3,1196,17,1800,604,1,34.0
7497,4126.0,SET OF 6 FUNKY BEAKERS,7,100,0,100,0,1,0.0
7498,4127.0,EDWARDIAN PARASOL BLACK,1,1035,13,1400,365,1,26.0
7499,4128.0,EDWARDIAN PARASOL NATURAL,9,364,4,500,136,1,8.0
7500,4129.0,CERAMIC STRAWBERRY CAKE MONEY BANK,3,782,13,1400,618,1,26.0
7501,4130.0,BLUE OWL SOFT TOY,9,150,2,300,150,1,4.0
7502,4131.0,BALLOON ART MAKE YOUR OWN FLOWERS,9,264,5,600,336,1,10.0
7503,4132.0,RED TOADSTOOL LED NIGHT LIGHT,2,313,5,600,287,1,10.0
7504,4133.0,GLASS CLOCHE SMALL,1,542,14,1500,958,1,28.0
7505,4134.0,GUMBALL MONOCHROME COAT RACK,6,1147,13,1400,253,1,26.0
7506,4135.0,DOORMAT FANCY FONT HOME SWEET HOME,1,136,10,1100,964,1,20.0
7507,4136.0,Discount,10,130,25,2600,2470,1,50.0
7508,4137.0,INFLATABLE POLITICAL GLOBE ,3,447,8,900,453,1,16.0
7509,4138.0,VINTAGE SNAKES & LADDERS,2,670,8,900,230,1,16.0
7510,4139.0,CHOCOLATE CALCULATOR,1,852,9,1000,148,1,18.0
7511,4140.0,JUMBO SHOPPER VINTAGE RED PAISLEY,5,660,17,1800,1140,1,34.0
7512,4141.0,RECYCLING BAG RETROSPOT ,6,257,3,400,143,1,6.0
7513,4142.0,TOY TIDY PINK POLKADOT,5,593,6,700,107,1,12.0
7514,4143.0,ANTIQUE GLASS DRESSING TABLE POT,8,100,0,100,0,1,0.0
7515,4144.0,ALARM CLOCK BAKELIKE GREEN,2,488,4,500,12,1,8.0
7516,4145.0,IVORY GIANT GARDEN THERMOMETER,10,530,6,700,170,1,12.0
7517,4146.0,6 TIER CAKE TIN GREEN AND CREAM,8,381,20,2100,1719,1,40.0
7518,4147.0,6 TIER CAKE TIN RED AND CREAM,3,749,19,2000,1251,1,38.0
7519,4148.0,SET 3 WICKER OVAL BASKETS W LIDS,1,138,2,300,162,1,4.0
7520,4149.0,SET OF 3 COLOURED  FLYING DUCKS,9,984,9,1000,16,1,18.0
7521,4150.0,WOOD BLACK BOARD ANT WHITE FINISH,5,470,5,600,130,1,10.0
7522,4151.0,COLOUR GLASS T-LIGHT HOLDER HANGING,3,1537,23,2400,863,1,46.0
7523,4152.0,HANGING METAL HEART LANTERN,7,241,2,300,59,1,4.0
7524,4153.0,HANGING MEDINA LANTERN SMALL,1,699,19,2000,1301,1,38.0
7525,4154.0,NATURAL SLATE HEART CHALKBOARD ,3,1758,22,2300,542,1,44.0
7526,4155.0,HEART OF WICKER SMALL,4,1016,14,1500,484,1,28.0
7527,4156.0,HEART OF WICKER LARGE,5,475,7,800,325,1,14.0
7528,4157.0,WHITE LOVEBIRD LANTERN,6,434,4,500,66,1,8.0
7529,4158.0,CLASSIC METAL BIRDCAGE PLANT HOLDER,2,411,4,500,89,1,8.0
7530,4159.0,CREAM HEART CARD HOLDER,2,878,13,1400,522,1,26.0
7531,4160.0,ENAMEL FLOWER JUG CREAM,9,283,6,700,417,1,12.0
7532,4161.0,ENAMEL FIRE BUCKET CREAM,4,505,12,1300,795,1,24.0
7533,4162.0,ENAMEL BREAD BIN CREAM,4,165,16,1700,1535,1,32.0
7534,4163.0,SET 3 WICKER OVAL BASKETS W LIDS,3,1871,21,2200,329,1,42.0
7535,4164.0,JAM MAKING SET PRINTED,6,165,24,2500,2335,1,48.0
7536,4165.0,JAM MAKING SET WITH JARS,7,109,2,300,191,1,4.0
7537,4166.0,JUMBO BAG DOLLY GIRL DESIGN,9,1005,18,1900,895,1,36.0
7538,4167.0,TRADITIONAL CHRISTMAS RIBBONS,6,216,3,400,184,1,6.0
7539,4168.0,ORGANISER WOOD ANTIQUE WHITE ,5,967,9,1000,33,1,18.0
7540,4169.0,LUNCH BAG DOLLY GIRL DESIGN,8,2289,24,2500,211,1,48.0
7541,4170.0,WHITE WIRE EGG HOLDER,4,408,19,2000,1592,1,38.0
7542,4171.0,JUMBO  BAG BAROQUE BLACK WHITE,1,1142,15,1600,458,1,30.0
7543,4172.0,JUMBO BAG RED RETROSPOT,10,2139,25,2600,461,1,50.0
7544,4173.0,CHILLI LIGHTS,8,189,1,200,11,1,2.0
7545,4174.0,LIGHT GARLAND BUTTERFILES PINK,4,1514,18,1900,386,1,36.0
7546,4175.0,WOODEN OWLS LIGHT GARLAND ,6,347,9,1000,653,1,18.0
7547,4176.0,FAIRY TALE COTTAGE NIGHTLIGHT,9,338,9,1000,662,1,18.0
7548,4177.0,RED TOADSTOOL LED NIGHT LIGHT,5,1010,11,1200,190,1,22.0
7549,4178.0,HOME BUILDING BLOCK WORD,8,120,1,200,80,1,2.0
7550,4179.0,LOVE BUILDING BLOCK WORD,2,266,3,400,134,1,6.0
7551,4180.0,DOORMAT FANCY FONT HOME SWEET HOME,8,140,2,300,160,1,4.0
7552,4181.0,HOME SMALL WOOD LETTERS,3,105,3,400,295,1,6.0
7553,4182.0,GINGHAM HEART  DOORSTOP RED,8,156,1,200,44,1,2.0
7554,4183.0,FIVE HEART HANGING DECORATION,4,143,12,1300,1157,1,24.0
7555,4184.0,HANGING METAL HEART LANTERN,5,516,19,2000,1484,1,38.0
7556,4185.0,ASSORTED BOTTLE TOP  MAGNETS ,3,1778,23,2400,622,1,46.0
7557,4186.0,FRIDGE MAGNETS US DINER ASSORTED,9,536,10,1100,564,1,20.0
7558,4187.0,HOMEMADE JAM SCENTED CANDLES,5,1220,22,2300,1080,1,44.0
7559,4188.0,FRIDGE MAGNETS LES ENFANTS ASSORTED,8,979,25,2600,1621,1,50.0
7560,4189.0,ROSE CARAVAN DOORSTOP,5,847,15,1600,753,1,30.0
7561,4190.0,HEART OF WICKER SMALL,9,512,5,600,88,1,10.0
7562,4191.0,8 HOOK HANGER MAGIC TOADSTOOL,3,1910,21,2200,290,1,42.0
7563,4192.0,CHRISTMAS LIGHTS 10 REINDEER,10,152,1,200,48,1,2.0
7564,4193.0,VINTAGE UNION JACK CUSHION COVER,10,228,3,400,172,1,6.0
7565,4194.0,VINTAGE HEADS AND TAILS CARD GAME ,5,157,4,500,343,1,8.0
7566,4195.0,SET OF 3 COLOURED  FLYING DUCKS,10,620,16,1700,1080,1,32.0
7567,4196.0,SET OF 3 GOLD FLYING DUCKS,3,565,16,1700,1135,1,32.0
7568,4197.0,RED RETROSPOT UMBRELLA,10,158,5,600,442,1,10.0
7569,4198.0,BLACK/BLUE POLKADOT UMBRELLA,1,100,0,100,0,1,0.0
7570,4199.0,RED DINER WALL CLOCK,7,134,1,200,66,1,2.0
7571,4200.0,ALARM CLOCK BAKELIKE GREEN,5,509,7,800,291,1,14.0
7572,4201.0,ALARM CLOCK BAKELIKE RED ,4,100,0,100,0,1,0.0
7573,4202.0,BLUE DINER WALL CLOCK,1,105,3,400,295,1,6.0
7574,4203.0,IVORY DINER WALL CLOCK,4,733,9,1000,267,1,18.0
7575,4204.0,LARGE HEART MEASURING SPOONS,1,657,8,900,243,1,16.0
7576,4205.0,SMALL HEART MEASURING SPOONS,9,2201,24,2500,299,1,48.0
7577,4206.0,CHRISTMAS LIGHTS 10 REINDEER,6,1099,10,1100,1,1,20.0
7578,4207.0,JAM MAKING SET WITH JARS,4,278,11,1200,922,1,22.0
7579,4208.0,JAM MAKING SET PRINTED,9,583,12,1300,717,1,24.0
7580,4209.0,JAM JAR WITH PINK LID,3,488,21,2200,1712,1,42.0
7581,4210.0,JAM JAR WITH GREEN LID,7,1171,15,1600,429,1,30.0
7582,4211.0,ROSE COTTAGE KEEPSAKE BOX ,3,169,9,1000,831,1,18.0
7583,4212.0,HANGING HEART ZINC T-LIGHT HOLDER,10,786,13,1400,614,1,26.0
7584,4213.0,PAPER CHAIN KIT VINTAGE CHRISTMAS,6,323,9,1000,677,1,18.0
7585,4214.0,DISCO BALL CHRISTMAS DECORATION,7,708,11,1200,492,1,22.0
7586,4215.0,WHITE HANGING HEART T-LIGHT HOLDER,3,900,16,1700,800,1,32.0
7587,4216.0,SMALL POPCORN HOLDER,7,911,15,1600,689,1,30.0
7588,4217.0,LARGE POPCORN HOLDER ,5,656,8,900,244,1,16.0
7589,4218.0,RETROSPOT LARGE MILK JUG,4,555,5,600,45,1,10.0
7590,4219.0,SET/20 RED RETROSPOT PAPER NAPKINS ,2,892,10,1100,208,1,20.0
7591,4220.0,SET/6 RED SPOTTY PAPER PLATES,5,468,7,800,332,1,14.0
7592,4221.0,SET/6 RED SPOTTY PAPER CUPS,9,1352,14,1500,148,1,28.0
7593,4222.0,POLKADOT RAIN HAT ,8,200,2,300,100,1,4.0
7594,4223.0,DELUXE SEWING KIT ,7,566,16,1700,1134,1,32.0
7595,4224.0,RETROSPOT HEART HOT WATER BOTTLE,9,1903,24,2500,597,1,48.0
7596,4225.0,KNITTED UNION FLAG HOT WATER BOTTLE,1,836,12,1300,464,1,24.0
7597,4226.0,ENGLISH ROSE HOT WATER BOTTLE,3,684,9,1000,316,1,18.0
7598,4227.0,PHOTO CUBE,9,2122,24,2500,378,1,48.0
7599,4228.0,HOMEMADE JAM SCENTED CANDLES,8,300,9,1000,700,1,18.0
7600,4229.0,JUMBO BAG RED RETROSPOT,4,595,16,1700,1105,1,32.0
7601,4230.0,PLASTERS IN TIN CIRCUS PARADE ,3,941,11,1200,259,1,22.0
7602,4231.0,PACK OF 12 PINK PAISLEY TISSUES ,5,100,0,100,0,1,0.0
7603,4232.0,PACK OF 12 BLUE PAISLEY TISSUES ,10,944,13,1400,456,1,26.0
7604,4233.0,PACK OF 12 RED RETROSPOT TISSUES ,8,826,17,1800,974,1,34.0
7605,4234.0,CHICK GREY HOT WATER BOTTLE,3,466,4,500,34,1,8.0
7606,4235.0,PLASTERS IN TIN VINTAGE PAISLEY ,10,197,3,400,203,1,6.0
7607,4236.0,PLASTERS IN TIN SKULLS,9,274,2,300,26,1,4.0
7608,4237.0,6 STRIPEY MICE FELTCRAFT,9,891,23,2400,1509,1,46.0
7609,4238.0,SET OF 6 SOLDIER SKITTLES,9,100,0,100,0,1,0.0
7610,4239.0,TRADITIONAL WOODEN SKIPPING ROPE,2,196,3,400,204,1,6.0
7611,4240.0,WOODEN BOX OF DOMINOES,7,100,0,100,0,1,0.0
7612,4241.0,RUSTIC  SEVENTEEN DRAWER SIDEBOARD,1,462,25,2600,2138,1,50.0
7613,4242.0,PARTY CONES CARNIVAL ASSORTED,1,772,8,900,128,1,16.0
7614,4243.0,PARTY CONES CANDY ASSORTED,5,126,3,400,274,1,6.0
7615,4244.0,PICNIC BASKET WICKER SMALL,9,477,14,1500,1023,1,28.0
7616,4245.0,ASSORTED COLOUR BIRD ORNAMENT,3,384,9,1000,616,1,18.0
7617,4246.0,STAR DECORATION PAINTED ZINC ,3,1763,19,2000,237,1,38.0
7618,4247.0,RETROSPOT LAMP,10,337,6,700,363,1,12.0
7619,4248.0,"FANCY FONT BIRTHDAY CARD, ",9,408,12,1300,892,1,24.0
7620,4249.0,HAND WARMER UNION JACK,10,270,12,1300,1030,1,24.0
7621,4250.0,HAND WARMER SCOTTY DOG DESIGN,5,354,14,1500,1146,1,28.0
7622,4251.0,HAND WARMER OWL DESIGN,10,661,11,1200,539,1,22.0
7623,4252.0,HAND WARMER RED RETROSPOT,9,100,0,100,0,1,0.0
7624,4253.0,RETROSPOT HEART HOT WATER BOTTLE,2,493,16,1700,1207,1,32.0
7625,4254.0,DOG BOWL CHASING BALL DESIGN,8,2454,24,2500,46,1,48.0
7626,4255.0,CLOTHES PEGS RETROSPOT PACK 27,2,1036,10,1100,64,1,20.0
7627,4256.0,HAND OVER THE CHOCOLATE   SIGN ,2,515,7,800,285,1,14.0
7628,4257.0,WHITE HANGING HEART T-LIGHT HOLDER,9,1690,21,2200,510,1,42.0
7629,4258.0,TRAVEL SEWING KIT,3,875,8,900,25,1,16.0
7630,4259.0,BLACK HEART CARD HOLDER,9,1228,13,1400,172,1,26.0
7631,4260.0,ASSORTED COLOUR BIRD ORNAMENT,9,522,11,1200,678,1,22.0
7632,4261.0,PACK OF 60 PINK PAISLEY CAKE CASES,6,133,6,700,567,1,12.0
7633,4262.0,63 TEATIME FAIRY CAKE CASES,6,1296,14,1500,204,1,28.0
7634,4263.0,PACK OF 72 RETROSPOT CAKE CASES,3,191,2,300,109,1,4.0
7635,4264.0,CHICK GREY HOT WATER BOTTLE,1,1333,13,1400,67,1,26.0
7636,4265.0,SMALL GLASS HEART TRINKET POT,3,100,0,100,0,1,0.0
7637,4266.0,ALARM CLOCK BAKELIKE IVORY,7,1255,20,2100,845,1,40.0
7638,4267.0,ALARM CLOCK BAKELIKE RED ,3,2260,25,2600,340,1,50.0
7639,4268.0,ALARM CLOCK BAKELIKE ORANGE,6,1136,11,1200,64,1,22.0
7640,4269.0,ALARM CLOCK BAKELIKE GREEN,3,1157,20,2100,943,1,40.0
7641,4270.0,HOT WATER BOTTLE TEA AND SYMPATHY,6,1118,16,1700,582,1,32.0
7642,4271.0,HAND WARMER BIRD DESIGN,8,189,20,2100,1911,1,40.0
7643,4272.0,HAND WARMER SCOTTY DOG DESIGN,8,1513,18,1900,387,1,36.0
7644,4273.0,WHITE HANGING HEART T-LIGHT HOLDER,1,117,2,300,183,1,4.0
7645,4274.0,WHITE METAL LANTERN,10,116,2,300,184,1,4.0
7646,4275.0,CREAM CUPID HEARTS COAT HANGER,8,2347,24,2500,153,1,48.0
7647,4276.0,EDWARDIAN PARASOL BLACK,1,319,10,1100,781,1,20.0
7648,4277.0,EDWARDIAN PARASOL RED,6,271,2,300,29,1,4.0
7649,4278.0,RETRO COFFEE MUGS ASSORTED,4,265,2,300,35,1,4.0
7650,4279.0,SAVE THE PLANET MUG,7,748,7,800,52,1,14.0
7651,4280.0,VINTAGE BILLBOARD DRINK ME MUG,3,230,10,1100,870,1,20.0
7652,4281.0,VINTAGE BILLBOARD LOVE/HATE MUG,8,1209,14,1500,291,1,28.0
7653,4282.0,WOOD 2 DRAWER CABINET WHITE FINISH,5,1112,13,1400,288,1,26.0
7654,4283.0,WOOD S/3 CABINET ANT WHITE FINISH,3,462,6,700,238,1,12.0
7655,4284.0,WOODEN PICTURE FRAME WHITE FINISH,9,264,3,400,136,1,6.0
7656,4285.0,WOODEN FRAME ANTIQUE WHITE ,10,503,8,900,397,1,16.0
7657,4286.0,KNITTED UNION FLAG HOT WATER BOTTLE,4,1652,18,1900,248,1,36.0
7658,4287.0,RED WOOLLY HOTTIE WHITE HEART.,9,1367,15,1600,233,1,30.0
7659,4288.0,SET 7 BABUSHKA NESTING BOXES,6,1024,11,1200,176,1,22.0
7660,4289.0,IVORY EMBROIDERED QUILT ,2,1372,21,2200,828,1,42.0
7661,4290.0,GLASS STAR FROSTED T-LIGHT HOLDER,1,1667,18,1900,233,1,36.0
7662,4291.0,SET OF 3 BLACK FLYING DUCKS,8,718,14,1500,782,1,28.0
7663,4292.0,SET OF 3 COLOURED  FLYING DUCKS,6,461,18,1900,1439,1,36.0
7664,4293.0,PACK OF 12 RED RETROSPOT TISSUES ,6,290,17,1800,1510,1,34.0
7665,4294.0,RED RETROSPOT MUG,8,1465,14,1500,35,1,28.0
7666,4295.0,BABUSHKA LIGHTS STRING OF 13,4,2209,23,2400,191,1,46.0
7667,4296.0,PIGGY BANK RETROSPOT ,9,278,18,1900,1622,1,36.0
7668,4297.0,SET 7 BABUSHKA NESTING BOXES,3,571,5,600,29,1,10.0
7669,4298.0,DOORMAT FAIRY CAKE,6,147,4,500,353,1,8.0
7670,4299.0,HAND WARMER RED RETROSPOT,7,676,8,900,224,1,16.0
7671,4300.0,HAND WARMER SCOTTY DOG DESIGN,8,1781,19,2000,219,1,38.0
7672,4301.0,HAND WARMER OWL DESIGN,6,489,13,1400,911,1,26.0
7673,4302.0,STRAWBERRY CERAMIC TRINKET BOX,9,1032,24,2500,1468,1,48.0
7674,4303.0,PINK DOUGHNUT TRINKET POT ,4,241,4,500,259,1,8.0
7675,4304.0,SILK PURSE BABUSHKA PINK,9,104,5,600,496,1,10.0
7676,4305.0,HOT WATER BOTTLE TEA AND SYMPATHY,6,1038,18,1900,862,1,36.0
7677,4306.0,HOT WATER BOTTLE I AM SO POORLY,4,1017,21,2200,1183,1,42.0
7678,4307.0,CHOCOLATE HOT WATER BOTTLE,6,1088,10,1100,12,1,20.0
7679,4308.0,WHITE SKULL HOT WATER BOTTLE ,7,742,11,1200,458,1,22.0
7680,4309.0,SCOTTIE DOG HOT WATER BOTTLE,7,400,8,900,500,1,16.0
7681,4310.0,HAND WARMER RED POLKA DOT,7,120,14,1500,1380,1,28.0
7682,4311.0,HAND WARMER UNION JACK,9,564,18,1900,1336,1,36.0
7683,4312.0,HOMEMADE JAM SCENTED CANDLES,4,1762,20,2100,338,1,40.0
7684,4313.0,BIRD HOUSE HOT WATER BOTTLE,7,1466,24,2500,1034,1,48.0
7685,4314.0,BOUDOIR SQUARE TISSUE BOX,2,994,9,1000,6,1,18.0
7686,4315.0,SKULLS SQUARE TISSUE BOX,9,1304,18,1900,596,1,36.0
7687,4316.0,PHOTO FRAME CORNICE,8,485,9,1000,515,1,18.0
7688,4317.0,SILK PURSE BABUSHKA RED,7,1248,16,1700,452,1,32.0
7689,4318.0,PICTURE DOMINOES,6,399,3,400,1,1,6.0
7690,4319.0,S/6 SEW ON CROCHET FLOWERS,4,100,0,100,0,1,0.0
7691,4320.0,SCANDINAVIAN REDS RIBBONS,2,867,14,1500,633,1,28.0
7692,4321.0,BALLOONS  WRITING SET ,4,1805,21,2200,395,1,42.0
7693,4322.0,JAM MAKING SET PRINTED,9,836,17,1800,964,1,34.0
7694,4323.0,LAVENDER INCENSE IN TIN,9,196,3,400,204,1,6.0
7695,4324.0,TV DINNER TRAY VINTAGE PAISLEY,9,162,14,1500,1338,1,28.0
7696,4325.0,SET OF 4 ENGLISH ROSE PLACEMATS,1,675,14,1500,825,1,28.0
7697,4326.0,SET OF 4 ENGLISH ROSE COASTERS,5,492,12,1300,808,1,24.0
7698,4327.0,TRIPLE PHOTO FRAME CORNICE ,7,572,11,1200,628,1,22.0
7699,4328.0,FAMILY PHOTO FRAME CORNICE,9,107,3,400,293,1,6.0
7700,4329.0,MIRRORED DISCO BALL ,9,568,8,900,332,1,16.0
7701,4330.0,DISCO BALL ROTATOR BATTERY OPERATED,10,1819,18,1900,81,1,36.0
7702,4331.0,SILVER LOOKING MIRROR,4,1001,19,2000,999,1,38.0
7703,4332.0,LADIES & GENTLEMEN METAL SIGN,10,474,5,600,126,1,10.0
7704,4333.0,METAL SIGN HER DINNER IS SERVED ,10,1434,25,2600,1166,1,50.0
7705,4334.0,YOU'RE CONFUSING ME METAL SIGN ,10,1014,22,2300,1286,1,44.0
7706,4335.0,DOORMAT TOPIARY,3,818,9,1000,182,1,18.0
7707,4336.0,BATHROOM METAL SIGN,6,167,9,1000,833,1,18.0
7708,4337.0,KITCHEN METAL SIGN,1,631,8,900,269,1,16.0
7709,4338.0,TOILET METAL SIGN,8,1474,19,2000,526,1,38.0
7710,4339.0,METAL SIGN TAKE IT OR LEAVE IT ,1,563,23,2400,1837,1,46.0
7711,4340.0,I'M ON HOLIDAY METAL SIGN,9,572,15,1600,1028,1,30.0
7712,4341.0,GROW YOUR OWN BASIL IN ENAMEL MUG,4,813,12,1300,487,1,24.0
7713,4342.0,SET/10 PINK POLKADOT PARTY CANDLES,5,428,14,1500,1072,1,28.0
7714,4343.0,SET 20 NAPKINS FAIRY CAKES DESIGN ,7,432,6,700,268,1,12.0
7715,4344.0,63 TEATIME FAIRY CAKE CASES,2,357,24,2500,2143,1,48.0
7716,4345.0,SET OF 6 T-LIGHTS SNOWMEN,7,613,9,1000,387,1,18.0
7717,4346.0,SET OF 6 T-LIGHTS SANTA,2,935,12,1300,365,1,24.0
7718,4347.0,SET OF 9 HEART SHAPED BALLOONS,9,509,10,1100,591,1,20.0
7719,4348.0,SANDWICH BATH SPONGE,8,246,12,1300,1054,1,24.0
7720,4349.0,APPLE BATH SPONGE,6,466,13,1400,934,1,26.0
7721,4350.0,STRAWBERRY BATH SPONGE ,3,109,1,200,91,1,2.0
7722,4351.0,BLACK PIRATE TREASURE CHEST,8,432,14,1500,1068,1,28.0
7723,4352.0,STAR PORTABLE TABLE LIGHT ,2,1003,12,1300,297,1,24.0
7724,4353.0,SNOWFLAKE PORTABLE TABLE LIGHT ,8,2110,23,2400,290,1,46.0
7725,4354.0,PINK OVAL JEWELLED MIRROR,2,406,7,800,394,1,14.0
7726,4355.0,RETROSPOT CIGAR BOX MATCHES ,4,100,0,100,0,1,0.0
7727,4356.0,COSY HOUR GIANT TUBE MATCHES,3,277,15,1600,1323,1,30.0
7728,4357.0,JAZZ HEARTS PURSE NOTEBOOK,2,262,5,600,338,1,10.0
7729,4358.0,LUNCH BAG DOLLY GIRL DESIGN,4,660,18,1900,1240,1,36.0
7730,4359.0,WHITE HANGING HEART T-LIGHT HOLDER,7,202,18,1900,1698,1,36.0
7731,4360.0,CANDLEHOLDER PINK HANGING HEART,8,880,9,1000,120,1,18.0
7732,4361.0,WOOD 2 DRAWER CABINET WHITE FINISH,5,102,2,300,198,1,4.0
7733,4362.0,ASSORTED COLOUR MINI CASES,10,280,8,900,620,1,16.0
7734,4363.0,LUNCH BAG RED RETROSPOT,9,195,9,1000,805,1,18.0
7735,4364.0,LUNCH BAG SPACEBOY DESIGN ,8,840,9,1000,160,1,18.0
7736,4365.0,LUNCH BAG WOODLAND,7,623,11,1200,577,1,22.0
7737,4366.0,LUNCH BAG PINK POLKADOT,5,1396,21,2200,804,1,42.0
7738,4367.0,GUMBALL COAT RACK,8,209,2,300,91,1,4.0
7739,4368.0,BLUE NEW BAROQUE CANDLESTICK CANDLE,1,200,1,200,0,1,2.0
7740,4369.0,PINK NEW BAROQUECANDLESTICK CANDLE,4,307,4,500,193,1,8.0
7741,4370.0,FAIRY CAKE FLANNEL ASSORTED COLOUR,5,470,13,1400,930,1,26.0
7742,4371.0,BREAD BIN DINER STYLE PINK,4,1521,16,1700,179,1,32.0
7743,4372.0,JUMBO BAG CHARLIE AND LOLA TOYS,8,280,8,900,620,1,16.0
7744,4373.0,TEA TIME TABLE CLOTH,9,125,9,1000,875,1,18.0
7745,4374.0,ENGLISH ROSE HOT WATER BOTTLE,9,477,14,1500,1023,1,28.0
7746,4375.0,ENAMEL FIRE BUCKET CREAM,10,571,24,2500,1929,1,48.0
7747,4376.0,PICNIC BASKET WICKER SMALL,1,1883,18,1900,17,1,36.0
7748,4377.0,PAPER CHAIN KIT 50'S CHRISTMAS ,5,1834,22,2300,466,1,44.0
7749,4378.0,PAPER CHAIN KIT VINTAGE CHRISTMAS,6,2227,25,2600,373,1,50.0
7750,4379.0,HOT WATER BOTTLE BABUSHKA ,5,2180,22,2300,120,1,44.0
7751,4380.0,HAND WARMER BIRD DESIGN,1,768,19,2000,1232,1,38.0
7752,4381.0,POSTAGE,2,1887,20,2100,213,1,40.0
7753,4382.0,HEART IVORY TRELLIS SMALL,7,1900,21,2200,300,1,42.0
7754,4383.0,CLEAR DRAWER KNOB ACRYLIC EDWARDIAN,9,128,1,200,72,1,2.0
7755,4384.0,PINK DRAWER KNOB ACRYLIC EDWARDIAN,10,276,2,300,24,1,4.0
7756,4385.0,GREEN DRAWER KNOB ACRYLIC EDWARDIAN,4,265,8,900,635,1,16.0
7757,4386.0,BLUE DRAWER KNOB ACRYLIC EDWARDIAN,1,153,19,2000,1847,1,38.0
7758,4387.0,HEART OF WICKER SMALL,10,435,9,1000,565,1,18.0
7759,4388.0,SMALL POPCORN HOLDER,1,1767,17,1800,33,1,34.0
7760,4389.0,SET 6 FOOTBALL CELEBRATION CANDLES,1,666,9,1000,334,1,18.0
7761,4390.0,SET OF 6 GIRLS CELEBRATION CANDLES,6,2138,25,2600,462,1,50.0
7762,4391.0,ROMANTIC PINKS RIBBONS ,2,1186,12,1300,114,1,24.0
7763,4392.0,BRIGHT BLUES RIBBONS ,4,518,6,700,182,1,12.0
7764,4393.0,SCANDINAVIAN REDS RIBBONS,10,355,15,1600,1245,1,30.0
7765,4394.0,CHOCOLATE BOX RIBBONS ,4,2063,24,2500,437,1,48.0
7766,4395.0,PARTY INVITES FOOTBALL,2,461,12,1300,839,1,24.0
7767,4396.0,PARTY INVITES JAZZ HEARTS,8,780,14,1500,720,1,28.0
7768,4397.0,PARTY INVITES SPACEMAN,10,879,13,1400,521,1,26.0
7769,4398.0,SET OF 3 BUTTERFLY COOKIE CUTTERS,5,1744,20,2100,356,1,40.0
7770,4399.0,SET OF 3 HEART COOKIE CUTTERS,9,278,8,900,622,1,16.0
7771,4400.0,6 PIECE SPACEBOY COOKIE CUTTER SET,9,649,14,1500,851,1,28.0
7772,4401.0,PACK OF 72 SKULL CAKE CASES,10,476,24,2500,2024,1,48.0
7773,4402.0,PACK OF 60 SPACEBOY CAKE CASES,6,1202,17,1800,598,1,34.0
7774,4403.0,PACK OF 72 RETROSPOT CAKE CASES,2,100,0,100,0,1,0.0
7775,4404.0,75 SWEETHEART FAIRY CAKE CASES,8,100,0,100,0,1,0.0
7776,4405.0,PACK OF 60 DINOSAUR CAKE CASES,1,1457,19,2000,543,1,38.0
7777,4406.0,LUNCH BAG SUKI  DESIGN ,10,262,11,1200,938,1,22.0
7778,4407.0,LUNCH BAG CARS BLUE,9,132,20,2100,1968,1,40.0
7779,4408.0,LUNCH BAG  BLACK SKULL.,1,100,22,2300,2200,1,44.0
7780,4409.0,HEART IVORY TRELLIS LARGE,6,578,7,800,222,1,14.0
7781,4410.0,SET/5 RED RETROSPOT LID GLASS BOWLS,9,568,23,2400,1832,1,46.0
7782,4411.0,WHITE HANGING HEART T-LIGHT HOLDER,3,551,14,1500,949,1,28.0
7783,4412.0,WHITE METAL LANTERN,5,1109,14,1500,391,1,28.0
7784,4413.0,CREAM CUPID HEARTS COAT HANGER,6,459,22,2300,1841,1,44.0
7785,4414.0,EDWARDIAN PARASOL RED,2,1026,18,1900,874,1,36.0
7786,4415.0,RETRO COFFEE MUGS ASSORTED,7,129,13,1400,1271,1,26.0
7787,4416.0,SAVE THE PLANET MUG,9,353,14,1500,1147,1,28.0
7788,4417.0,VINTAGE BILLBOARD DRINK ME MUG,6,1128,11,1200,72,1,22.0
7789,4418.0,VINTAGE BILLBOARD LOVE/HATE MUG,2,218,5,600,382,1,10.0
7790,4419.0,WOOD 2 DRAWER CABINET WHITE FINISH,7,100,0,100,0,1,0.0
7791,4420.0,WOOD S/3 CABINET ANT WHITE FINISH,5,967,14,1500,533,1,28.0
7792,4421.0,WOODEN PICTURE FRAME WHITE FINISH,5,241,12,1300,1059,1,24.0
7793,4422.0,WOODEN FRAME ANTIQUE WHITE ,2,177,3,400,223,1,6.0
7794,4423.0,KNITTED UNION FLAG HOT WATER BOTTLE,3,129,2,300,171,1,4.0
7795,4424.0,RED WOOLLY HOTTIE WHITE HEART.,10,526,12,1300,774,1,24.0
7796,4425.0,SET 7 BABUSHKA NESTING BOXES,7,582,5,600,18,1,10.0
7797,4426.0,IVORY EMBROIDERED QUILT ,7,210,7,800,590,1,14.0
7798,4427.0,GLASS STAR FROSTED T-LIGHT HOLDER,8,2572,25,2600,28,1,50.0
7799,4428.0,HAND WARMER RED POLKA DOT,10,152,10,1100,948,1,20.0
7800,4429.0,HAND WARMER UNION JACK,4,256,11,1200,944,1,22.0
7801,4430.0,MAGIC DRAWING SLATE DINOSAUR,1,100,0,100,0,1,0.0
7802,4431.0,MAGIC DRAWING SLATE BAKE A CAKE ,6,829,13,1400,571,1,26.0
7803,4432.0,15 PENCILS TALL TUBE SKULLS,3,1697,25,2600,903,1,50.0
7804,4433.0,CHOCOLATE CALCULATOR,6,538,10,1100,562,1,20.0
7805,4434.0,RED  HARMONICA IN BOX ,8,1412,16,1700,288,1,32.0
7806,4435.0,BLUE HARMONICA IN BOX ,9,140,1,200,60,1,2.0
7807,4436.0,SKULLS  WATER TRANSFER TATTOOS ,1,1310,21,2200,890,1,42.0
7808,4437.0,PACK 3 BOXES BIRD PANNETONE ,2,493,18,1900,1407,1,36.0
7809,4438.0,HOT WATER BOTTLE TEA AND SYMPATHY,8,2009,21,2200,191,1,42.0
7810,4439.0,RED WOOLLY HOTTIE WHITE HEART.,5,280,2,300,20,1,4.0
7811,4440.0,WHITE SKULL HOT WATER BOTTLE ,7,1712,23,2400,688,1,46.0
7812,4441.0,6 PIECE SPACEBOY COOKIE CUTTER SET,6,391,19,2000,1609,1,38.0
7813,4442.0,SET OF 20 KIDS COOKIE CUTTERS,5,714,25,2600,1886,1,50.0
7814,4443.0,13 COLOUR SPACEBOY PEN,2,821,22,2300,1479,1,44.0
7815,4444.0,VICTORIAN GLASS HANGING T-LIGHT,2,100,0,100,0,1,0.0
7816,4445.0,SINGLE HEART ZINC T-LIGHT HOLDER,6,142,7,800,658,1,14.0
7817,4446.0,RED HANGING HEART T-LIGHT HOLDER,9,144,2,300,156,1,4.0
7818,4447.0,HANGING METAL STAR LANTERN,4,100,0,100,0,1,0.0
7819,4448.0,SILVER HANGING T-LIGHT HOLDER,5,898,10,1100,202,1,20.0
7820,4449.0,DOORMAT RED RETROSPOT,4,196,1,200,4,1,2.0
7821,4450.0,DOORMAT HEARTS,6,257,5,600,343,1,10.0
7822,4451.0,NATURAL SLATE RECTANGLE CHALKBOARD,7,596,12,1300,704,1,24.0
7823,4452.0,LOVEBIRD HANGING DECORATION WHITE ,6,1126,23,2400,1274,1,46.0
7824,4453.0,ASSORTED COLOUR BIRD ORNAMENT,7,337,3,400,63,1,6.0
7825,4454.0,HOME BUILDING BLOCK WORD,4,1036,15,1600,564,1,30.0
7826,4455.0,LOVE BUILDING BLOCK WORD,2,855,17,1800,945,1,34.0
7827,4456.0,PHOTO FRAME CORNICE,8,2456,24,2500,44,1,48.0
7828,4457.0,PENS ASSORTED FUNNY FACE,8,2006,24,2500,494,1,48.0
7829,4458.0,CARD CIRCUS PARADE,10,326,4,500,174,1,8.0
7830,4459.0,WRAP COWBOYS  ,10,1788,17,1800,12,1,34.0
7831,4460.0,AIRLINE BAG VINTAGE TOKYO 81,2,373,3,400,27,1,6.0
7832,4461.0,RED RETROSPOT UMBRELLA,2,1258,21,2200,942,1,42.0
7833,4462.0,BLACK/BLUE POLKADOT UMBRELLA,1,1097,12,1300,203,1,24.0
7834,4463.0,RED 3 PIECE RETROSPOT CUTLERY SET,5,775,25,2600,1825,1,50.0
7835,4464.0,PACK OF 72 RETROSPOT CAKE CASES,7,392,8,900,508,1,16.0
7836,4465.0,SET OF 72 RETROSPOT PAPER  DOILIES,10,399,4,500,101,1,8.0
7837,4466.0,BLUE COAT RACK PARIS FASHION,6,683,9,1000,317,1,18.0
7838,4467.0,PLASTERS IN TIN SKULLS,10,2248,23,2400,152,1,46.0
7839,4468.0,SLEEPING CAT ERASERS,1,591,10,1100,509,1,20.0
7840,4469.0,CARD BIRTHDAY COWBOY,5,1301,20,2100,799,1,40.0
7841,4470.0,PACK 3 BOXES CHRISTMAS PANNETONE,10,1140,25,2600,1460,1,50.0
7842,4471.0,ROTATING SILVER ANGELS T-LIGHT HLDR,5,855,8,900,45,1,16.0
7843,4472.0,COSY HOUR GIANT TUBE MATCHES,1,165,4,500,335,1,8.0
7844,4473.0,RIBBON REEL MAKING SNOWMEN ,5,1400,21,2200,800,1,42.0
7845,4474.0,MINI PAINT SET VINTAGE ,5,1637,17,1800,163,1,34.0
7846,4475.0,7 TRADITIONAL SPINNING TOPS,9,311,5,600,289,1,10.0
7847,4476.0,SET OF 6 SOLDIER SKITTLES,6,261,15,1600,1339,1,30.0
7848,4477.0,BAG 500g SWIRLY MARBLES,5,2300,23,2400,100,1,46.0
7849,4478.0,8 STRAND GLASS NECKLACE CRYSTAL,5,1095,22,2300,1205,1,44.0
7850,4479.0,WHITE SKULL HOT WATER BOTTLE ,6,646,8,900,254,1,16.0
7851,4480.0,SCOTTIE DOG HOT WATER BOTTLE,2,218,14,1500,1282,1,28.0
7852,4481.0,SQUARECUSHION COVER PINK UNION FLAG,10,105,9,1000,895,1,18.0
7853,4482.0,SPACEBOY CHILDRENS EGG CUP,8,1157,12,1300,143,1,24.0
7854,4483.0,CHILDREN'S SPACEBOY MUG,5,548,15,1600,1052,1,30.0
7855,4484.0,HAND WARMER SCOTTY DOG DESIGN,4,411,8,900,489,1,16.0
7856,4485.0,FELTCRAFT CUSHION OWL,5,1031,13,1400,369,1,26.0
7857,4486.0,BLACK CANDELABRA T-LIGHT HOLDER,6,1677,20,2100,423,1,40.0
7858,4487.0,TOY TIDY DOLLY GIRL DESIGN,2,208,14,1500,1292,1,28.0
7859,4488.0,SET 12 LAVENDER  BOTANICAL T-LIGHTS,6,2086,21,2200,114,1,42.0
7860,4489.0,UNION JACK FLAG LUGGAGE TAG,4,750,11,1200,450,1,22.0
7861,4490.0,RED HEART LUGGAGE TAG,9,100,0,100,0,1,0.0
7862,4491.0,RED GLASS TASSLE BAG CHARM,5,368,16,1700,1332,1,32.0
7863,4492.0,CLEAR ACRYLIC FACETED BANGLE,9,913,10,1100,187,1,20.0
7864,4493.0,8 STRAND GLASS NECKLACE CRYSTAL,1,791,18,1900,1109,1,36.0
7865,4494.0,DOORMAT UNION JACK GUNS AND ROSES,8,495,8,900,405,1,16.0
7866,4495.0,VANILLA SCENT CANDLE JEWELLED BOX,7,894,8,900,6,1,16.0
7867,4496.0,FULL ENGLISH BREAKFAST PLATE,9,1113,17,1800,687,1,34.0
7868,4497.0,BLACK CANDELABRA T-LIGHT HOLDER,9,171,9,1000,829,1,18.0
7869,4498.0,MAGIC DRAWING SLATE CIRCUS PARADE  ,10,127,23,2400,2273,1,46.0
7870,4499.0,CHRISTMAS HANGING HEART WITH BELL,10,100,0,100,0,1,0.0
7871,4500.0,CAKE STAND VICTORIAN FILIGREE MED,8,213,24,2500,2287,1,48.0
7872,4501.0,PAISLEY PATTERN  STICKERS,7,100,0,100,0,1,0.0
7873,4502.0,FLOWERS  STICKERS,7,1859,19,2000,141,1,38.0
7874,4503.0,PINK NEW BAROQUECANDLESTICK CANDLE,2,1189,19,2000,811,1,38.0
7875,4504.0,BLUE NEW BAROQUE CANDLESTICK CANDLE,1,579,25,2600,2021,1,50.0
7876,4505.0,JUMBO STORAGE BAG SUKI,8,1581,19,2000,419,1,38.0
7877,4506.0,BLACK LOVE BIRD CANDLE,5,1541,17,1800,259,1,34.0
7878,4507.0,PARTY TIME PENCIL ERASERS,4,1043,10,1100,57,1,20.0
7879,4508.0,DISCO BALL CHRISTMAS DECORATION,8,119,2,300,181,1,4.0
7880,4509.0,PINK B'FLY C/COVER W BOBBLES,8,944,12,1300,356,1,24.0
7881,4510.0,PINK UNION JACK  LUGGAGE TAG,10,134,2,300,166,1,4.0
7882,4511.0,9 RIBBONS ELEGANT CHRISTMAS ,7,565,7,800,235,1,14.0
7883,4512.0,UNION JACK FLAG LUGGAGE TAG,5,653,9,1000,347,1,18.0
7884,4513.0,AGED GLASS SILVER T-LIGHT HOLDER,5,158,21,2200,2042,1,42.0
7885,4514.0,BOOM BOX SPEAKER GIRLS,3,164,6,700,536,1,12.0
7886,4515.0,9 RIBBONS SHIMMERING PINKS ,2,237,2,300,63,1,4.0
7887,4516.0, SET 2 TEA TOWELS I LOVE LONDON ,7,227,4,500,273,1,8.0
7888,4517.0,JUMBO BAG OWLS,7,223,8,900,677,1,16.0
7889,4518.0,SANDWICH BATH SPONGE,10,673,12,1300,627,1,24.0
7890,4519.0,OWL DOORSTOP,2,1659,25,2600,941,1,50.0
7891,4520.0,8 STRAND GLASS NECKLACE CRYSTAL,9,122,7,800,678,1,14.0
7892,4521.0,HAND WARMER UNION JACK,10,207,10,1100,893,1,20.0
7893,4522.0,HAND WARMER SCOTTY DOG DESIGN,2,289,2,300,11,1,4.0
7894,4523.0,LARGE POPCORN HOLDER ,3,444,6,700,256,1,12.0
7895,4524.0,PAINTED METAL STAR WITH HOLLY BELLS,9,1377,17,1800,423,1,34.0
7896,4525.0,PAINTED METAL HEART WITH HOLLY BELL,3,283,22,2300,2017,1,44.0
7897,4526.0,ANGEL DECORATION STARS ON DRESS,4,677,11,1200,523,1,22.0
7898,4527.0,SMALL POPCORN HOLDER,10,496,4,500,4,1,8.0
7899,4528.0,JUMBO BAG RED RETROSPOT,8,107,12,1300,1193,1,24.0
7900,4529.0,JUMBO BAG STRAWBERRY,5,289,10,1100,811,1,20.0
7901,4530.0,STRAWBERRY SHOPPER BAG,5,235,3,400,165,1,6.0
7902,4531.0,STRAWBERRY CHARLOTTE BAG,1,531,8,900,369,1,16.0
7903,4532.0, SET 2 TEA TOWELS I LOVE LONDON ,3,153,2,300,147,1,4.0
7904,4533.0,PACK OF 12 RED RETROSPOT TISSUES ,2,440,22,2300,1860,1,44.0
7905,4534.0,SCOTTIE DOG HOT WATER BOTTLE,5,376,5,600,224,1,10.0
7906,4535.0,CHOCOLATE HOT WATER BOTTLE,8,378,5,600,222,1,10.0
7907,4536.0,LUNCH BAG CARS BLUE,5,1546,25,2600,1054,1,50.0
7908,4537.0,LUNCH BAG SPACEBOY DESIGN ,8,2068,23,2400,332,1,46.0
7909,4538.0,ROUND SNACK BOXES SET OF4 WOODLAND ,3,1476,15,1600,124,1,30.0
7910,4539.0,LUNCH BAG DOLLY GIRL DESIGN,2,114,3,400,286,1,6.0
7911,4540.0,LUNCH BAG SUKI  DESIGN ,9,764,9,1000,236,1,18.0
7912,4541.0,LUNCH BAG  BLACK SKULL.,3,1911,20,2100,189,1,40.0
7913,4542.0,ROUND SNACK BOXES SET OF 4 FRUITS ,10,599,22,2300,1701,1,44.0
7914,4543.0,ROUND SNACK BOXES SET OF 4 SKULLS,3,126,4,500,374,1,8.0
7915,4544.0,DOLLY GIRL LUNCH BOX,8,1953,20,2100,147,1,40.0
7916,4545.0,SPACEBOY LUNCH BOX ,6,363,10,1100,737,1,20.0
7917,4546.0,GREEN POLKADOT PLATE ,9,323,7,800,477,1,14.0
7918,4547.0,BLUE POLKADOT PLATE ,3,662,22,2300,1638,1,44.0
7919,4548.0,RED RETROSPOT PLATE ,4,477,6,700,223,1,12.0
7920,4549.0,PINK  POLKADOT PLATE ,9,127,1,200,73,1,2.0
7921,4550.0,ROUND SNACK BOXES SET OF 4 SKULLS,1,847,21,2200,1353,1,42.0
7922,4551.0,FELTCRAFT DOLL MOLLY,9,442,20,2100,1658,1,40.0
7923,4552.0,FELTCRAFT CHRISTMAS FAIRY,10,119,2,300,181,1,4.0
7924,4553.0,TRAVEL SEWING KIT,1,2437,25,2600,163,1,50.0
7925,4554.0,SET OF 3 NOTEBOOKS IN PARCEL,8,607,13,1400,793,1,26.0
7926,4555.0,RED RETROSPOT TAPE,1,256,7,800,544,1,14.0
7927,4556.0,COSY SLIPPER SHOES SMALL  RED ,2,426,6,700,274,1,12.0
7928,4557.0,9 RIBBONS RUSTIC CHARM,6,478,8,900,422,1,16.0
7929,4558.0,SCANDINAVIAN REDS RIBBONS,4,100,0,100,0,1,0.0
7930,4559.0,JAM MAKING SET PRINTED,6,414,6,700,286,1,12.0
7931,4560.0,15 DAISY PEGS IN WOOD BOX,7,489,15,1600,1111,1,30.0
7932,4561.0,HOT WATER BOTTLE BABUSHKA ,3,925,12,1300,375,1,24.0
7933,4562.0,FELTCRAFT PRINCESS CHARLOTTE DOLL,8,446,17,1800,1354,1,34.0
7934,4563.0,FELTCRAFT CHRISTMAS FAIRY,6,630,7,800,170,1,14.0
7935,4564.0,FELTCRAFT PRINCESS CHARLOTTE DOLL,10,185,1,200,15,1,2.0
7936,4565.0,9 RIBBONS RUSTIC CHARM,7,296,5,600,304,1,10.0
7937,4566.0,COSY SLIPPER SHOES SMALL  RED ,4,209,10,1100,891,1,20.0
7938,4567.0,SCANDINAVIAN REDS RIBBONS,6,733,19,2000,1267,1,38.0
7939,4568.0,8 HOOK HANGER RED MAGIC TOADSTOOL,6,288,2,300,12,1,4.0
7940,4569.0,CHRISTMAS CRAFT TREE TOP ANGEL,9,100,0,100,0,1,0.0
7941,4570.0,CHRISTMAS CRAFT LITTLE FRIENDS,8,1688,24,2500,812,1,48.0
7942,4571.0,8 HOOK HANGER RED MAGIC TOADSTOOL,4,498,15,1600,1102,1,30.0
7943,4572.0,9 RIBBONS RUSTIC CHARM,7,668,11,1200,532,1,22.0
7944,4573.0,15 DAISY PEGS IN WOOD BOX,7,1503,17,1800,297,1,34.0
7945,4574.0,SET OF 3 NOTEBOOKS IN PARCEL,4,1547,19,2000,453,1,38.0
7946,4575.0,8 HOOK HANGER MAGIC TOADSTOOL,8,430,8,900,470,1,16.0
7947,4576.0,SCANDINAVIAN REDS RIBBONS,6,782,14,1500,718,1,28.0
7948,4577.0,RED TOADSTOOL LED NIGHT LIGHT,1,1328,18,1900,572,1,36.0
7949,4578.0,8 HOOK HANGER RED MAGIC TOADSTOOL,7,382,18,1900,1518,1,36.0
7950,4579.0,COSY SLIPPER SHOES SMALL GREEN,6,367,14,1500,1133,1,28.0
7951,4580.0,COSY SLIPPER SHOES SMALL  RED ,3,684,25,2600,1916,1,50.0
7952,4581.0,FELTCRAFT DOLL ROSIE,8,1472,14,1500,28,1,28.0
7953,4582.0,FELTCRAFT DOLL MOLLY,10,225,24,2500,2275,1,48.0
7954,4583.0,FELTCRAFT DOLL EMILY,7,365,6,700,335,1,12.0
7955,4584.0,FELTCRAFT PRINCESS CHARLOTTE DOLL,7,238,19,2000,1762,1,38.0
7956,4585.0,FELTCRAFT PRINCESS OLIVIA DOLL,7,205,5,600,395,1,10.0
7957,4586.0,REX CASH+CARRY JUMBO SHOPPER,5,1232,24,2500,1268,1,48.0
7958,4587.0,FELTCRAFT DOLL MOLLY,10,514,18,1900,1386,1,36.0
7959,4588.0,FELTCRAFT CUSHION OWL,5,517,12,1300,783,1,24.0
7960,4589.0,CHRISTMAS CRAFT TREE TOP ANGEL,9,199,1,200,1,1,2.0
7961,4590.0,CHRISTMAS CRAFT LITTLE FRIENDS,6,858,8,900,42,1,16.0
7962,4591.0,FELTCRAFT CUSHION RABBIT,6,115,8,900,785,1,16.0
7963,4592.0,FELTCRAFT CUSHION BUTTERFLY,8,1100,21,2200,1100,1,42.0
7964,4593.0,15 DAISY PEGS IN WOOD BOX,3,570,6,700,130,1,12.0
7965,4594.0,PAPER CHAIN KIT 50'S CHRISTMAS ,2,287,4,500,213,1,8.0
7966,4595.0,FELTCRAFT CUSHION BUTTERFLY,7,378,23,2400,2022,1,46.0
7967,4596.0,15 DAISY PEGS IN WOOD BOX,6,768,11,1200,432,1,22.0
7968,4597.0,ROSE COTTAGE KEEPSAKE BOX ,5,1122,15,1600,478,1,30.0
7969,4598.0,TOTE BAG I LOVE LONDON,1,297,9,1000,703,1,18.0
7970,4599.0,15 DAISY PEGS IN WOOD BOX,4,1182,21,2200,1018,1,42.0
7971,4600.0,TOTE BAG I LOVE LONDON,10,349,20,2100,1751,1,40.0
7972,4601.0,FOLDING UMBRELLA PINKWHITE POLKADOT,1,145,3,400,255,1,6.0
7973,4602.0,FOLDING UMBRELLA CREAM POLKADOT,5,578,7,800,222,1,14.0
7974,4603.0,FOLDING UMBRELLA WHITE/RED POLKADOT,3,1007,13,1400,393,1,26.0
7975,4604.0,SET 10 LIGHTS NIGHT OWL,6,813,22,2300,1487,1,44.0
7976,4605.0,SMALL POPCORN HOLDER,7,203,7,800,597,1,14.0
7977,4606.0, SET 2 TEA TOWELS I LOVE LONDON ,7,201,6,700,499,1,12.0
7978,4607.0,FOLDING UMBRELLA RED/WHITE POLKADOT,5,231,4,500,269,1,8.0
7979,4608.0,BABUSHKA LIGHTS STRING OF 13,7,1373,15,1600,227,1,30.0
7980,4609.0,LUNCH BAG RED RETROSPOT,1,835,8,900,65,1,16.0
7981,4610.0,S/4 VALENTINE DECOUPAGE HEART BOX,5,589,22,2300,1711,1,44.0
7982,4611.0,FOLDING UMBRELLA CREAM POLKADOT,9,286,6,700,414,1,12.0
7983,4612.0, SET 2 TEA TOWELS I LOVE LONDON ,4,1113,19,2000,887,1,38.0
7984,4613.0,FOLDING UMBRELLA RED/WHITE POLKADOT,3,1274,21,2200,926,1,42.0
7985,4614.0,SOLDIERS EGG CUP ,4,235,9,1000,765,1,18.0
7986,4615.0,S/4 VALENTINE DECOUPAGE HEART BOX,7,115,1,200,85,1,2.0
7987,4616.0,RED RETROSPOT MINI CASES,5,1945,19,2000,55,1,38.0
7988,4617.0,,5,969,9,1000,31,1,18.0
7989,4618.0,63 CAKE CASES VINTAGE CHRISTMAS,1,1454,17,1800,346,1,34.0
7990,4619.0,PAPER CHAIN KIT VINTAGE CHRISTMAS,6,652,8,900,248,1,16.0
7991,4620.0,RIBBON REEL CHRISTMAS SOCK BAUBLE,5,100,0,100,0,1,0.0
7992,4621.0,RIBBON REEL SNOWY VILLAGE,1,248,3,400,152,1,6.0
7993,4622.0,RIBBON REEL MAKING SNOWMEN ,4,585,7,800,215,1,14.0
7994,4623.0,SET OF 20 VINTAGE CHRISTMAS NAPKINS,4,440,11,1200,760,1,22.0
7995,4624.0,TURQUOISE CHRISTMAS TREE ,4,503,10,1100,597,1,20.0
7996,4625.0,RED STAR CARD HOLDER,4,1118,14,1500,382,1,28.0
7997,4626.0,WICKER WREATH SMALL,2,1027,25,2600,1573,1,50.0
7998,4627.0,HEART OF WICKER LARGE,6,2116,23,2400,284,1,46.0
7999,4628.0,ADVENT CALENDAR GINGHAM SACK,4,579,12,1300,721,1,24.0
8000,4629.0,HEART OF WICKER SMALL,7,486,5,600,114,1,10.0
8001,4630.0,FELTCRAFT BUTTERFLY HEARTS,7,172,6,700,528,1,12.0
8002,4631.0,PARTY CONE CHRISTMAS DECORATION ,8,389,24,2500,2111,1,48.0
8003,4632.0,VINTAGE HEADS AND TAILS CARD GAME ,7,262,2,300,38,1,4.0
8004,4633.0,WICKER STAR ,1,625,13,1400,775,1,26.0
8005,4634.0,VINTAGE SNAP CARDS,10,717,7,800,83,1,14.0
8006,4635.0,FELTCRAFT 6 FLOWER FRIENDS,1,2045,20,2100,55,1,40.0
8007,4636.0, SET 2 TEA TOWELS I LOVE LONDON ,3,304,14,1500,1196,1,28.0
8008,4637.0,JAM MAKING SET PRINTED,10,1794,25,2600,806,1,50.0
8009,4638.0,BIRD DECORATION RED RETROSPOT,7,419,25,2600,2181,1,50.0
8010,4639.0,CHRISTMAS GINGHAM TREE,4,1063,10,1100,37,1,20.0
8011,4640.0,CHRISTMAS GINGHAM STAR,6,839,18,1900,1061,1,36.0
8012,4641.0,CHRISTMAS GINGHAM HEART,1,1481,17,1800,319,1,34.0
8013,4642.0,PACK OF 12 PINK POLKADOT TISSUES,1,691,11,1200,509,1,22.0
8014,4643.0,FELTCRAFT PRINCESS LOLA DOLL,4,653,13,1400,747,1,26.0
8015,4644.0,PACK OF 12 LONDON TISSUES ,2,1399,25,2600,1201,1,50.0
8016,4645.0,PURPLE DRAWERKNOB ACRYLIC EDWARDIAN,4,1160,15,1600,440,1,30.0
8017,4646.0,CHILDREN'S APRON DOLLY GIRL ,2,931,21,2200,1269,1,42.0
8018,4647.0,CHILDRENS APRON SPACEBOY DESIGN,10,869,21,2200,1331,1,42.0
8019,4648.0,CHRISTMAS LIGHTS 10 SANTAS ,3,372,3,400,28,1,6.0
8020,4649.0,CHRISTMAS LIGHTS 10 REINDEER,5,960,22,2300,1340,1,44.0
8021,4650.0,PAPER CHAIN KIT 50'S CHRISTMAS ,10,214,7,800,586,1,14.0
8022,4651.0,FELTCRAFT CHRISTMAS FAIRY,3,158,1,200,42,1,2.0
8023,4652.0,PACK OF 72 RETROSPOT CAKE CASES,2,550,12,1300,750,1,24.0
8024,4653.0,PACK OF 60 MUSHROOM CAKE CASES,4,487,17,1800,1313,1,34.0
8025,4654.0,63 CAKE CASES DOLLY GIRL DESIGN,10,1583,20,2100,517,1,40.0
8026,4655.0,PACK OF 60 PINK PAISLEY CAKE CASES,10,1747,19,2000,253,1,38.0
8027,4656.0,HAND WARMER BABUSHKA DESIGN,5,1045,17,1800,755,1,34.0
8028,4657.0,HAND WARMER BIRD DESIGN,3,594,11,1200,606,1,22.0
8029,4658.0,HAND WARMER OWL DESIGN,5,376,25,2600,2224,1,50.0
8030,4659.0,HAND WARMER RED RETROSPOT,7,1002,18,1900,898,1,36.0
8031,4660.0,SET 12 RETRO WHITE CHALK STICKS,3,146,1,200,54,1,2.0
8032,4661.0,FELTCRAFT HAIRBAND RED AND BLUE,2,124,1,200,76,1,2.0
8033,4662.0,FELTCRAFT HAIRBAND PINK AND PURPLE,5,322,7,800,478,1,14.0
8034,4663.0,FELTCRAFT HAIRBANDS PINK AND WHITE ,4,939,15,1600,661,1,30.0
8035,4664.0,TV DINNER TRAY DOLLY GIRL,3,833,9,1000,167,1,18.0
8036,4665.0,PLASTERS IN TIN VINTAGE PAISLEY ,3,187,25,2600,2413,1,50.0
8037,4666.0,PLASTERS IN TIN SPACEBOY,9,265,24,2500,2235,1,48.0
8038,4667.0,PLASTERS IN TIN WOODLAND ANIMALS,4,595,19,2000,1405,1,38.0
8039,4668.0,MAGIC DRAWING SLATE SPACEBOY ,10,825,25,2600,1775,1,50.0
8040,4669.0,MAGIC DRAWING SLATE CIRCUS PARADE  ,6,363,19,2000,1637,1,38.0
8041,4670.0,MAGIC DRAWING SLATE GO TO THE FAIR ,2,101,1,200,99,1,2.0
8042,4671.0,MAGIC DRAWING SLATE DOLLY GIRL ,3,1212,22,2300,1088,1,44.0
8043,4672.0,CHARLIE + LOLA RED HOT WATER BOTTLE,2,1405,15,1600,195,1,30.0
8044,4673.0,HOT WATER BOTTLE BABUSHKA ,8,433,9,1000,567,1,18.0
8045,4674.0,URBAN BLACK RIBBONS ,1,184,24,2500,2316,1,48.0
8046,4675.0,FELTCRAFT PRINCESS CHARLOTTE DOLL,4,414,18,1900,1486,1,36.0
8047,4676.0,SET OF 6 T-LIGHTS TOADSTOOLS,6,1053,12,1300,247,1,24.0
8048,4677.0,ROTATING LEAVES T-LIGHT HOLDER,4,1129,12,1300,171,1,24.0
8049,4678.0,RED  HARMONICA IN BOX ,5,1336,25,2600,1264,1,50.0
8050,4679.0,CUPCAKE LACE PAPER SET 9,9,986,11,1200,214,1,22.0
8051,4680.0,FAMILY PHOTO FRAME CORNICE,7,827,10,1100,273,1,20.0
8052,4681.0,TRIPLE PHOTO FRAME CORNICE ,6,417,7,800,383,1,14.0
8053,4682.0,WOODEN FRAME ANTIQUE WHITE ,6,575,11,1200,625,1,22.0
8054,4683.0,WOODEN BOX OF DOMINOES,5,680,20,2100,1420,1,40.0
8055,4684.0,TRADITIONAL WOODEN CATCH CUP GAME ,2,550,9,1000,450,1,18.0
8056,4685.0,TRADITIONAL WOODEN SKIPPING ROPE,3,878,12,1300,422,1,24.0
8057,4686.0,S/6 WOODEN SKITTLES IN COTTON BAG,5,172,2,300,128,1,4.0
8058,4687.0,RED METAL BEACH SPADE ,6,1241,17,1800,559,1,34.0
8059,4688.0,BOYS VINTAGE TIN SEASIDE BUCKET,7,792,19,2000,1208,1,38.0
8060,4689.0,GIRLS VINTAGE TIN SEASIDE BUCKET,9,706,8,900,194,1,16.0
8061,4690.0,GREY HEART HOT WATER BOTTLE,10,580,13,1400,820,1,26.0
8062,4691.0,SCOTTIE DOG HOT WATER BOTTLE,10,156,1,200,44,1,2.0
8063,4692.0,BIRD HOUSE HOT WATER BOTTLE,8,1544,23,2400,856,1,46.0
8064,4693.0,KINGS CHOICE TEA CADDY ,1,609,13,1400,791,1,26.0
8065,4694.0,KINGS CHOICE BISCUIT TIN,2,968,13,1400,432,1,26.0
8066,4695.0,METAL SIGN EMPIRE TEA,5,963,15,1600,637,1,30.0
8067,4696.0,HOMEMADE JAM SCENTED CANDLES,2,1072,17,1800,728,1,34.0
8068,4697.0,SET OF 6 SOLDIER SKITTLES,2,770,7,800,30,1,14.0
8069,4698.0,FAWN BLUE HOT WATER BOTTLE,3,649,11,1200,551,1,22.0
8070,4699.0,HAND WARMER RED RETROSPOT,7,2249,23,2400,151,1,46.0
8071,4700.0,HOT WATER BOTTLE BABUSHKA ,6,917,17,1800,883,1,34.0
8072,4701.0,WHITE SKULL HOT WATER BOTTLE ,6,1833,25,2600,767,1,50.0
8073,4702.0,RETROSPOT HEART HOT WATER BOTTLE,10,782,23,2400,1618,1,46.0
8074,4703.0,RED WOOLLY HOTTIE WHITE HEART.,5,601,10,1100,499,1,20.0
8075,4704.0,SCOTTIE DOG HOT WATER BOTTLE,6,109,3,400,291,1,6.0
8076,4705.0,GREY HEART HOT WATER BOTTLE,5,1570,19,2000,430,1,38.0
8077,4706.0,HOT WATER BOTTLE BABUSHKA ,10,800,13,1400,600,1,26.0
8078,4707.0,PACK OF 6 BIRDY GIFT TAGS,1,607,7,800,193,1,14.0
8079,4708.0,CHILLI LIGHTS,9,254,3,400,146,1,6.0
8080,4709.0,PIGGY BANK RETROSPOT ,8,486,21,2200,1714,1,42.0
8081,4710.0,CERAMIC STRAWBERRY MONEY BOX,8,245,3,400,155,1,6.0
8082,4711.0,CERAMIC STRAWBERRY CAKE MONEY BANK,1,1002,22,2300,1298,1,44.0
8083,4712.0,CERAMIC CHERRY CAKE MONEY BANK,2,1255,12,1300,45,1,24.0
8084,4713.0,CERAMIC HEART FAIRY CAKE MONEY BANK,8,2102,24,2500,398,1,48.0
8085,4714.0,CERAMIC PIRATE CHEST MONEY BANK,10,680,16,1700,1020,1,32.0
8086,4715.0,DOORSTOP RETROSPOT HEART,7,1386,17,1800,414,1,34.0
8087,4716.0,GINGHAM HEART  DOORSTOP RED,9,649,8,900,251,1,16.0
8088,4717.0,RETROSPOT BABUSHKA DOORSTOP,6,304,8,900,596,1,16.0
8089,4718.0,SILK PURSE BABUSHKA RED,5,552,6,700,148,1,12.0
8090,4719.0,SILK PURSE BABUSHKA PINK,5,988,13,1400,412,1,26.0
8091,4720.0,FAMILY PHOTO FRAME CORNICE,9,398,6,700,302,1,12.0
8092,4721.0,SWEETHEART WIRE WALL TIDY,10,1727,24,2500,773,1,48.0
8093,4722.0,JAM MAKING SET PRINTED,7,933,11,1200,267,1,22.0
8094,4723.0,RED RETROSPOT OVEN GLOVE ,7,826,12,1300,474,1,24.0
8095,4724.0,CREAM HEART CARD HOLDER,4,417,11,1200,783,1,22.0
8096,4725.0,NAMASTE SWAGAT INCENSE,7,836,16,1700,864,1,32.0
8097,4726.0,CERAMIC STRAWBERRY DESIGN MUG,9,536,24,2500,1964,1,48.0
8098,4727.0,BLACK HEART CARD HOLDER,9,157,2,300,143,1,4.0
8099,4728.0,CLASSICAL ROSE SMALL VASE,7,807,10,1100,293,1,20.0
8100,4729.0,HYACINTH BULB T-LIGHT CANDLES,3,853,23,2400,1547,1,46.0
8101,4730.0,CHRISTMAS CRAFT WHITE FAIRY ,2,2108,23,2400,292,1,46.0
8102,4731.0,CHRISTMAS CRAFT LITTLE FRIENDS,9,791,14,1500,709,1,28.0
8103,4732.0,COSY HOUR CIGAR BOX MATCHES ,4,151,6,700,549,1,12.0
8104,4733.0,RED TEA TOWEL CLASSIC DESIGN,1,668,22,2300,1632,1,44.0
8105,4734.0,HEART FILIGREE DOVE  SMALL,7,632,8,900,268,1,16.0
8106,4735.0,RETROSPOT CHILDRENS APRON,6,306,10,1100,794,1,20.0
8107,4736.0,COLOURING PENCILS BROWN TUBE,8,930,11,1200,270,1,22.0
8108,4737.0,7 IVORY DINNER CANDLES SILVER FLOCK,8,525,12,1300,775,1,24.0
8109,4738.0,HEART FILIGREE DOVE  SMALL,2,106,7,800,694,1,14.0
8110,4739.0,ZINC METAL HEART DECORATION,10,396,3,400,4,1,6.0
8111,4740.0,GREEN FERN NOTEBOOK,2,400,7,800,400,1,14.0
8112,4741.0,BLUE PAISLEY NOTEBOOK,10,365,25,2600,2235,1,50.0
8113,4742.0,CHRYSANTHEMUM NOTEBOOK,4,541,11,1200,659,1,22.0
8114,4743.0,LARGE CHINESE STYLE SCISSOR,5,1179,18,1900,721,1,36.0
8115,4744.0,SMALL CHINESE STYLE SCISSOR,4,874,17,1800,926,1,34.0
8116,4745.0,S/6 WOODEN SKITTLES IN COTTON BAG,1,958,9,1000,42,1,18.0
8117,4746.0,TRADITIONAL WOODEN SKIPPING ROPE,3,449,8,900,451,1,16.0
8118,4747.0,SET OF 6 SOLDIER SKITTLES,8,947,13,1400,453,1,26.0
8119,4748.0,7 TRADITIONAL SPINNING TOPS,10,634,17,1800,1166,1,34.0
8120,4749.0,ROTATING SILVER ANGELS T-LIGHT HLDR,6,292,14,1500,1208,1,28.0
8121,4750.0,BLACK LOVE BIRD CANDLE,3,1465,14,1500,35,1,28.0
8122,4751.0,RETROSPOT CHILDRENS APRON,8,517,13,1400,883,1,26.0
8123,4752.0,HANGING GLASS ETCHED TEALIGHT,10,357,7,800,443,1,14.0
8124,4753.0,HANGING GLASS ETCHED TEALIGHT,4,1180,16,1700,520,1,32.0
8125,4754.0,BLUE NEW BAROQUE CANDLESTICK CANDLE,8,189,4,500,311,1,8.0
8126,4755.0,COOKING SET RETROSPOT,1,943,13,1400,457,1,26.0
8127,4756.0,KINGS CHOICE GIANT TUBE MATCHES,6,815,8,900,85,1,16.0
8128,4757.0,COSY HOUR GIANT TUBE MATCHES,7,1598,19,2000,402,1,38.0
8129,4758.0,PLACE SETTING WHITE STAR,2,1134,24,2500,1366,1,48.0
8130,4759.0,HYACINTH BULB T-LIGHT CANDLES,3,113,18,1900,1787,1,36.0
8131,4760.0,S/15 SILVER GLASS BAUBLES IN BAG,2,769,8,900,131,1,16.0
8132,4761.0,FRENCH WC SIGN BLUE METAL,6,1566,22,2300,734,1,44.0
8133,4762.0,KINGS CHOICE GIANT TUBE MATCHES,1,100,0,100,0,1,0.0
8134,4763.0,75 SWEETHEART FAIRY CAKE CASES,10,950,17,1800,850,1,34.0
8135,4764.0,ASSORTED COLOUR BIRD ORNAMENT,9,1432,15,1600,168,1,30.0
8136,4765.0,FAIRY SOAP SOAP HOLDER,3,318,12,1300,982,1,24.0
8137,4766.0,GREEN GIANT GARDEN THERMOMETER,6,321,22,2300,1979,1,44.0
8138,4767.0,IVORY GIANT GARDEN THERMOMETER,2,317,12,1300,983,1,24.0
8139,4768.0,BLUE GIANT GARDEN THERMOMETER,8,248,8,900,652,1,16.0
8140,4769.0,PACK OF 60 PINK PAISLEY CAKE CASES,5,285,5,600,315,1,10.0
8141,4770.0,RETROSPOT HEART HOT WATER BOTTLE,3,256,9,1000,744,1,18.0
8142,4771.0,CHICK GREY HOT WATER BOTTLE,8,1632,24,2500,868,1,48.0
8143,4772.0,VICTORIAN SEWING BOX SMALL ,4,579,11,1200,621,1,22.0
8144,4773.0,VICTORIAN SEWING BOX MEDIUM,4,763,13,1400,637,1,26.0
8145,4774.0,SET/10 RED POLKADOT PARTY CANDLES,1,460,25,2600,2140,1,50.0
8146,4775.0,WASHROOM METAL SIGN,3,583,13,1400,817,1,26.0
8147,4776.0,BLACK SWEETHEART BRACELET,8,201,8,900,699,1,16.0
8148,4777.0,DIAMANTE HAIR GRIP PACK/2 BLACK DIA,8,318,3,400,82,1,6.0
8149,4778.0,BLACK DIAMANTE EXPANDABLE RING,8,1785,21,2200,415,1,42.0
8150,4779.0,DIAMANTE HAIR GRIP PACK/2 RUBY,6,412,18,1900,1488,1,36.0
8151,4780.0,DIAMANTE HAIR GRIP PACK/2 MONTANA,2,594,17,1800,1206,1,34.0
8152,4781.0,BLUE SWEETHEART BRACELET,5,554,10,1100,546,1,20.0
8153,4782.0,PINK SWEETHEART BRACELET,7,860,22,2300,1440,1,44.0
8154,4783.0,PURPLE SWEETHEART BRACELET,4,528,6,700,172,1,12.0
8155,4784.0,JUMBO BAG PINK POLKADOT,2,656,22,2300,1644,1,44.0
8156,4785.0,JUMBO BAG RED RETROSPOT,6,180,3,400,220,1,6.0
8157,4786.0,ASSORTED COLOUR BIRD ORNAMENT,10,1778,23,2400,622,1,46.0
8158,4787.0,PAPER CHAIN KIT 50'S CHRISTMAS ,3,175,17,1800,1625,1,34.0
8159,4788.0,RIBBON REEL CHRISTMAS PRESENT ,7,295,10,1100,805,1,20.0
8160,4789.0,FIRST AID TIN,9,1071,22,2300,1229,1,44.0
8161,4790.0,MAKE YOUR OWN MONSOON CARD KIT,7,350,21,2200,1850,1,42.0
8162,4791.0,PACK OF 12 HEARTS DESIGN TISSUES ,10,1580,19,2000,420,1,38.0
8163,4792.0,PACK OF 12 RED RETROSPOT TISSUES ,4,365,9,1000,635,1,18.0
8164,4793.0,SOLDIERS EGG CUP ,8,100,0,100,0,1,0.0
8165,4794.0,HEART IVORY TRELLIS SMALL,2,389,23,2400,2011,1,46.0
8166,4795.0,HEART FILIGREE DOVE  SMALL,6,865,19,2000,1135,1,38.0
8167,4796.0,HEART FILIGREE DOVE LARGE,9,2197,24,2500,303,1,48.0
8168,4797.0,PACK 3 BOXES BIRD PANNETONE ,4,1375,16,1700,325,1,32.0
8169,4798.0,PACK 3 BOXES CHRISTMAS PANNETONE,4,100,0,100,0,1,0.0
8170,4799.0,SMALL POPCORN HOLDER,4,2157,21,2200,43,1,42.0
8171,4800.0,PACK OF 60 PINK PAISLEY CAKE CASES,3,545,5,600,55,1,10.0
8172,4801.0,SET OF 6 SOLDIER SKITTLES,7,1462,20,2100,638,1,40.0
8173,4802.0,SWIRLY CIRCULAR RUBBERS IN BAG,6,648,7,800,152,1,14.0
8174,4803.0,VINTAGE PAISLEY STATIONERY SET,4,573,5,600,27,1,10.0
8175,4804.0,PAPER CHAIN KIT VINTAGE CHRISTMAS,10,872,11,1200,328,1,22.0
8176,4805.0,SET/10 BLUE POLKADOT PARTY CANDLES,9,1618,19,2000,382,1,38.0
8177,4806.0,RIBBON REEL SOCKS AND MITTENS,8,948,25,2600,1652,1,50.0
8178,4807.0,63 CAKE CASES VINTAGE CHRISTMAS,7,1239,22,2300,1061,1,44.0
8179,4808.0,CHRISTMAS METAL TAGS ASSORTED ,4,301,4,500,199,1,8.0
8180,4809.0,CHRISTMAS TREE T-LIGHT HOLDER,6,278,2,300,22,1,4.0
8181,4810.0,STAR  T-LIGHT HOLDER ,9,1565,21,2200,635,1,42.0
8182,4811.0,HEART T-LIGHT HOLDER ,3,153,24,2500,2347,1,48.0
8183,4812.0,MINI FUNKY DESIGN TAPES,8,1583,18,1900,317,1,36.0
8184,4813.0,SET OF 6 T-LIGHTS SNOWMEN,7,1367,18,1900,533,1,36.0
8185,4814.0,STAR WOODEN CHRISTMAS DECORATION,7,453,19,2000,1547,1,38.0
8186,4815.0,WOODEN HEART CHRISTMAS SCANDINAVIAN,5,1313,25,2600,1287,1,50.0
8187,4816.0,CHRISTMAS RETROSPOT TREE WOOD,7,181,15,1600,1419,1,30.0
8188,4817.0,SET OF 6 T-LIGHTS SANTA,8,363,8,900,537,1,16.0
8189,4818.0,SET/9 CHRISTMAS T-LIGHTS SCENTED ,6,2397,23,2400,3,1,46.0
8190,4819.0,BLUE ROSE FABRIC MIRROR,7,133,6,700,567,1,12.0
8191,4820.0,THREE CANVAS LUGGAGE TAGS,2,282,3,400,118,1,6.0
8192,4821.0,RETROSPOT PARTY BAG + STICKER SET,6,1385,20,2100,715,1,40.0
8193,4822.0,PLASTERS IN TIN VINTAGE PAISLEY ,5,1320,15,1600,280,1,30.0
8194,4823.0,RETROSPOT SMALL TUBE MATCHES,1,1199,22,2300,1101,1,44.0
8195,4824.0,HAND WARMER SCOTTY DOG DESIGN,10,175,23,2400,2225,1,46.0
8196,4825.0,3D CHRISTMAS STAMPS STICKERS ,7,2274,24,2500,226,1,48.0
8197,4826.0,HAND WARMER SCOTTY DOG DESIGN,6,953,21,2200,1247,1,42.0
8198,4827.0,HAND WARMER SCOTTY DOG DESIGN,4,135,16,1700,1565,1,32.0
8199,4828.0,CLOTHES PEGS RETROSPOT PACK 27,2,292,4,500,208,1,8.0
8200,4829.0,39 FOIL HEART CAKE CASES,10,740,8,900,160,1,16.0
8201,4830.0,CHRISTMAS METAL TAGS ASSORTED ,8,1319,19,2000,681,1,38.0
8202,4831.0,PACK OF 6 SWEETIE GIFT BOXES,1,887,12,1300,413,1,24.0
8203,4832.0,PACK OF 72 RETROSPOT CAKE CASES,4,477,24,2500,2023,1,48.0
8204,4833.0,PACK OF 72 RETROSPOT CAKE CASES,4,161,16,1700,1539,1,32.0
8205,4834.0,PACK OF 6 BIRDY GIFT TAGS,9,721,12,1300,579,1,24.0
8206,4835.0,SET/10 RED POLKADOT PARTY CANDLES,10,1488,16,1700,212,1,32.0
8207,4836.0,SET/10 PINK POLKADOT PARTY CANDLES,2,515,18,1900,1385,1,36.0
8208,4837.0,SET OF 3 NOTEBOOKS IN PARCEL,6,194,2,300,106,1,4.0
8209,4838.0,STAR  T-LIGHT HOLDER ,4,151,1,200,49,1,2.0
8210,4839.0,CINAMMON SET OF 9 T-LIGHTS,9,1555,21,2200,645,1,42.0
8211,4840.0,ORANGE SCENTED SET/9 T-LIGHTS,2,348,13,1400,1052,1,26.0
8212,4841.0,RIBBON REEL STRIPES DESIGN ,2,639,21,2200,1561,1,42.0
8213,4842.0,SET OF 2 TINS JARDIN DE PROVENCE,6,138,1,200,62,1,2.0
8214,4843.0,MAKE YOUR OWN PLAYTIME CARD KIT,3,571,16,1700,1129,1,32.0
8215,4844.0,DINOSAURS  WRITING SET ,6,892,8,900,8,1,16.0
8216,4845.0,BALLOONS  WRITING SET ,3,2295,23,2400,105,1,46.0
8217,4846.0,SKULLS WRITING SET ,2,2364,24,2500,136,1,48.0
8218,4847.0,VINTAGE PAISLEY STATIONERY SET,2,250,9,1000,750,1,18.0
8219,4848.0,COSY SLIPPER SHOES SMALL  RED ,8,383,4,500,117,1,8.0
8220,4849.0,DOORMAT BLACK FLOCK ,10,139,3,400,261,1,6.0
8221,4850.0,JUMBO  BAG BAROQUE BLACK WHITE,1,1061,10,1100,39,1,20.0
8222,4851.0,JAM MAKING SET WITH JARS,10,1787,21,2200,413,1,42.0
8223,4852.0,ORANGE SCENTED SET/9 T-LIGHTS,10,1870,19,2000,130,1,38.0
8224,4853.0,CINAMMON SET OF 9 T-LIGHTS,1,1719,20,2100,381,1,40.0
8225,4854.0,HAND WARMER SCOTTY DOG DESIGN,8,495,5,600,105,1,10.0
8226,4855.0,CHRISTMAS DECOUPAGE CANDLE,9,829,13,1400,571,1,26.0
8227,4856.0,HEART T-LIGHT HOLDER ,7,580,9,1000,420,1,18.0
8228,4857.0,GROW YOUR OWN BASIL IN ENAMEL MUG,9,225,6,700,475,1,12.0
8229,4858.0,OFFICE MUG WARMER POLKADOT,3,103,1,200,97,1,2.0
8230,4859.0,SMALL POPCORN HOLDER,4,268,12,1300,1032,1,24.0
8231,4860.0,JUMBO BAG DOLLY GIRL DESIGN,5,236,4,500,264,1,8.0
8232,4861.0,JAM MAKING SET WITH JARS,4,1366,14,1500,134,1,28.0
8233,4862.0,JAM MAKING SET PRINTED,5,483,11,1200,717,1,22.0
8234,4863.0,SMALL GLASS HEART TRINKET POT,4,646,6,700,54,1,12.0
8235,4864.0,RED WOOLLY HOTTIE WHITE HEART.,1,1020,10,1100,80,1,20.0
8236,4865.0,BLACK RECORD COVER FRAME,9,1328,16,1700,372,1,32.0
8237,4866.0,"RECORD FRAME 7"" SINGLE SIZE ",4,262,9,1000,738,1,18.0
8238,4867.0,39 PENCILS TUBE RED RETROSPOT,5,244,12,1300,1056,1,24.0
8239,4868.0,39 PENCILS TUBE WOODLAND,2,287,3,400,113,1,6.0
8240,4869.0,SET OF 6 SOLDIER SKITTLES,3,100,0,100,0,1,0.0
8241,4870.0,ROCKING HORSE RED CHRISTMAS ,6,413,18,1900,1487,1,36.0
8242,4871.0,CHRISTMAS GINGHAM HEART,7,100,0,100,0,1,0.0
8243,4872.0,CHRISTMAS GINGHAM STAR,5,270,7,800,530,1,14.0
8244,4873.0,HAND WARMER UNION JACK,8,414,17,1800,1386,1,34.0
8245,4874.0,HAND WARMER RED RETROSPOT,5,551,8,900,349,1,16.0
8246,4875.0,REGENCY CAKESTAND 3 TIER,7,801,19,2000,1199,1,38.0
8247,4876.0,JUMBO SHOPPER VINTAGE RED PAISLEY,5,808,16,1700,892,1,32.0
8248,4877.0,RIBBON REEL SNOWY VILLAGE,8,265,6,700,435,1,12.0
8249,4878.0,VINTAGE UNION JACK BUNTING,3,1788,21,2200,412,1,42.0
8250,4879.0,JAM MAKING SET WITH JARS,4,1323,24,2500,1177,1,48.0
8251,4880.0,RIBBON REEL STRIPES DESIGN ,9,2422,25,2600,178,1,50.0
8252,4881.0,RETRO LONGBOARD IRONING BOARD COVER,3,100,0,100,0,1,0.0
8253,4882.0,3D DOG PICTURE PLAYING CARDS,8,1661,19,2000,339,1,38.0
8254,4883.0,RETROSPOT CIGAR BOX MATCHES ,10,912,16,1700,788,1,32.0
8255,4884.0,SET/9 CHRISTMAS T-LIGHTS SCENTED ,3,234,2,300,66,1,4.0
8256,4885.0,ROTATING SILVER ANGELS T-LIGHT HLDR,5,654,11,1200,546,1,22.0
8257,4886.0,ROTATING SILVER ANGELS T-LIGHT HLDR,1,155,2,300,145,1,4.0
8258,4887.0,SAVE THE PLANET COTTON TOTE BAG,8,1016,13,1400,384,1,26.0
8259,4888.0,SET OF 20 VINTAGE CHRISTMAS NAPKINS,1,131,22,2300,2169,1,44.0
8260,4889.0,PAPER BUNTING WHITE LACE,7,896,11,1200,304,1,22.0
8261,4890.0,GENTLEMAN SHIRT REPAIR KIT ,5,494,8,900,406,1,16.0
8262,4891.0,CARD I LOVE LONDON ,8,687,17,1800,1113,1,34.0
8263,4892.0,PAPER CHAIN KIT VINTAGE CHRISTMAS,6,740,13,1400,660,1,26.0
8264,4893.0,MIRRORED WALL ART FOXY,5,195,1,200,5,1,2.0
8265,4894.0,MIRRORED WALL ART GENTS,7,994,17,1800,806,1,34.0
8266,4895.0,AIRLINE BAG VINTAGE JET SET WHITE,1,471,4,500,29,1,8.0
8267,4896.0,JAM MAKING SET PRINTED,4,603,10,1100,497,1,20.0
8268,4897.0,POTTING SHED SOW 'N' GROW SET,10,261,8,900,639,1,16.0
8269,4898.0,BABUSHKA LIGHTS STRING OF 13,2,976,19,2000,1024,1,38.0
8270,4899.0,REX CASH+CARRY JUMBO SHOPPER,1,145,11,1200,1055,1,22.0
8271,4900.0,AIRLINE BAG VINTAGE WORLD CHAMPION ,10,1284,23,2400,1116,1,46.0
8272,4901.0,HAND WARMER BIRD DESIGN,10,124,4,500,376,1,8.0
8273,4902.0,CHRISTMAS CRAFT LITTLE FRIENDS,9,255,12,1300,1045,1,24.0
8274,4903.0,PINK HEARTS PAPER GARLAND,7,100,0,100,0,1,0.0
8275,4904.0,POTTING SHED SEED ENVELOPES,2,1560,22,2300,740,1,44.0
8276,4905.0,HI TEC ALPINE HAND WARMER,3,387,14,1500,1113,1,28.0
8277,4906.0,FELTCRAFT CHRISTMAS FAIRY,10,492,4,500,8,1,8.0
8278,4907.0,HI TEC ALPINE HAND WARMER,5,236,6,700,464,1,12.0
8279,4908.0,ROTATING SILVER ANGELS T-LIGHT HLDR,1,487,9,1000,513,1,18.0
8280,4909.0,6 STRIPEY MICE FELTCRAFT,8,536,14,1500,964,1,28.0
8281,4910.0,FELTCRAFT 6 FLOWER FRIENDS,5,550,23,2400,1850,1,46.0
8282,4911.0,CHRISTMAS CRAFT LITTLE FRIENDS,6,625,14,1500,875,1,28.0
8283,4912.0,VINTAGE UNION JACK CUSHION COVER,7,661,17,1800,1139,1,34.0
8284,4913.0,POLYESTER FILLER PAD 45x45cm,6,1360,18,1900,540,1,36.0
8285,4914.0,DOLLY GIRL LUNCH BOX,6,112,12,1300,1188,1,24.0
8286,4915.0,PACK OF 12 LONDON TISSUES ,3,348,8,900,552,1,16.0
8287,4916.0,CARD DOLLY GIRL ,1,114,2,300,186,1,4.0
8288,4917.0,CARD BILLBOARD FONT,2,618,6,700,82,1,12.0
8289,4918.0,RAINY LADIES BIRTHDAY CARD,8,605,16,1700,1095,1,32.0
8290,4919.0,GREY HEART HOT WATER BOTTLE,6,793,20,2100,1307,1,40.0
8291,4920.0,RED WOOLLY HOTTIE WHITE HEART.,7,262,20,2100,1838,1,40.0
8292,4921.0,RED WHITE SCARF  HOT WATER BOTTLE,8,369,4,500,131,1,8.0
8293,4922.0, SET 2 TEA TOWELS I LOVE LONDON ,3,1774,18,1900,126,1,36.0
8294,4923.0,SET OF 2 TEA TOWELS APPLE AND PEARS,7,1402,17,1800,398,1,34.0
8295,4924.0,SET/2 RED RETROSPOT TEA TOWELS ,7,100,0,100,0,1,0.0
8296,4925.0,LOVE BUILDING BLOCK WORD,5,493,19,2000,1507,1,38.0
8297,4926.0,HOME BUILDING BLOCK WORD,10,539,5,600,61,1,10.0
8298,4927.0,ASSORTED COLOUR BIRD ORNAMENT,3,118,1,200,82,1,2.0
8299,4928.0,LANTERN CREAM GAZEBO ,1,2423,25,2600,177,1,50.0
8300,4929.0,BLUE BIRDHOUSE DECORATION,8,137,10,1100,963,1,20.0
8301,4930.0,WHITE HANGING HEART T-LIGHT HOLDER,6,103,1,200,97,1,2.0
8302,4931.0,REGENCY CAKESTAND 3 TIER,9,698,8,900,202,1,16.0
8303,4932.0,ANTIQUE SILVER TEA GLASS ENGRAVED,10,1950,21,2200,250,1,42.0
8304,4933.0,AGED GLASS SILVER T-LIGHT HOLDER,2,375,7,800,425,1,14.0
8305,4934.0,JAM MAKING SET WITH JARS,1,1886,25,2600,714,1,50.0
8306,4935.0,HAND WARMER OWL DESIGN,8,1301,14,1500,199,1,28.0
8307,4936.0,SET OF 2 WOODEN MARKET CRATES,5,185,1,200,15,1,2.0
8308,4937.0,SET OF 6 T-LIGHTS TOADSTOOLS,8,481,14,1500,1019,1,28.0
8309,4938.0,HAND WARMER UNION JACK,9,120,1,200,80,1,2.0
8310,4939.0,HAND WARMER SCOTTY DOG DESIGN,10,1341,20,2100,759,1,40.0
8311,4940.0,CLASSIC FRENCH STYLE BASKET NATURAL,4,982,19,2000,1018,1,38.0
8312,4941.0,CRAZY DAISY HEART DECORATION,4,291,5,600,309,1,10.0
8313,4942.0,GIN + TONIC DIET METAL SIGN,7,1617,23,2400,783,1,46.0
8314,4943.0,IVORY GIANT GARDEN THERMOMETER,10,621,13,1400,779,1,26.0
8315,4944.0,CARD HOLDER GINGHAM HEART,4,884,16,1700,816,1,32.0
8316,4945.0,SMALL STRIPES CHOCOLATE GIFT BAG ,2,252,4,500,248,1,8.0
8317,4946.0,S/6 WOODEN SKITTLES IN COTTON BAG,2,503,25,2600,2097,1,50.0
8318,4947.0,HAND WARMER RED RETROSPOT,6,194,1,200,6,1,2.0
8319,4948.0,HAND WARMER UNION JACK,8,644,24,2500,1856,1,48.0
8320,4949.0,FRENCH WC SIGN BLUE METAL,10,111,17,1800,1689,1,34.0
8321,4950.0,PINK UNION JACK  LUGGAGE TAG,5,772,8,900,128,1,16.0
8322,4951.0,"TRAY, BREAKFAST IN BED",4,216,17,1800,1584,1,34.0
8323,4952.0,PIZZA PLATE IN BOX,7,1395,22,2300,905,1,44.0
8324,4953.0,HEART OF WICKER LARGE,7,197,10,1100,903,1,20.0
8325,4954.0,PINK HEART DOTS HOT WATER BOTTLE,2,870,25,2600,1730,1,50.0
8326,4955.0,PLACE SETTING WHITE HEART,2,328,18,1900,1572,1,36.0
8327,4956.0,SET OF 4 NAPKIN CHARMS LEAVES   ,5,100,0,100,0,1,0.0
8328,4957.0,SET OF 4 NAPKIN CHARMS STARS   ,8,272,12,1300,1028,1,24.0
8329,4958.0,SET OF 4 NAPKIN CHARMS CUTLERY,5,539,7,800,261,1,14.0
8330,4959.0,CARAVAN SQUARE TISSUE BOX,9,283,24,2500,2217,1,48.0
8331,4960.0,PLASTERS IN TIN SKULLS,8,411,8,900,489,1,16.0
8332,4961.0,PLASTERS IN TIN SPACEBOY,7,691,8,900,209,1,16.0
8333,4962.0,BUTTON BOX ,9,1316,15,1600,284,1,30.0
8334,4963.0,PLASTERS IN TIN VINTAGE PAISLEY ,7,143,5,600,457,1,10.0
8335,4964.0,15 MESSAGE CARDS WITH ENVELOPES,2,2186,24,2500,314,1,48.0
8336,4965.0,SMALL RED BABUSHKA NOTEBOOK ,4,192,2,300,108,1,4.0
8337,4966.0,CUPCAKE LACE PAPER SET 9,1,1270,14,1500,230,1,28.0
8338,4967.0,PACK 3 BOXES CHRISTMAS PANNETONE,5,309,3,400,91,1,6.0
8339,4968.0,HERB MARKER MINT,10,1422,22,2300,878,1,44.0
8340,4969.0,HERB MARKER ROSEMARY,5,330,24,2500,2170,1,48.0
8341,4970.0,HERB MARKER BASIL,4,830,19,2000,1170,1,38.0
8342,4971.0,HERB MARKER CHIVES ,8,400,7,800,400,1,14.0
8343,4972.0,HERB MARKER PARSLEY,6,1877,18,1900,23,1,36.0
8344,4973.0,HERB MARKER THYME,8,279,11,1200,921,1,22.0
8345,4974.0,WHITE HANGING HEART T-LIGHT HOLDER,7,566,6,700,134,1,12.0
8346,4975.0,METAL MERRY CHRISTMAS WREATH,4,490,11,1200,710,1,22.0
8347,4976.0,WHITE CHRISTMAS GARLAND STARS TREES,9,407,22,2300,1893,1,44.0
8348,4977.0,RETROSPOT SMALL TUBE MATCHES,9,100,0,100,0,1,0.0
8349,4978.0,RETROSPOT GIANT TUBE MATCHES,3,1288,17,1800,512,1,34.0
8350,4979.0,PLACE SETTING WHITE STAR,4,746,10,1100,354,1,20.0
8351,4980.0,GROW YOUR OWN BASIL IN ENAMEL MUG,2,567,10,1100,533,1,20.0
8352,4981.0,39 FOIL STAR CAKE CASES ,1,345,17,1800,1455,1,34.0
8353,4982.0,39 FOIL HEART CAKE CASES,4,1890,18,1900,10,1,36.0
8354,4983.0,PACK OF 6 SWEETIE GIFT BOXES,8,334,23,2400,2066,1,46.0
8355,4984.0,PACK OF 6 HANDBAG GIFT BOXES,4,808,10,1100,292,1,20.0
8356,4985.0,GARLAND WOODEN HAPPY EASTER,7,215,3,400,185,1,6.0
8357,4986.0,CALENDAR PAPER CUT DESIGN,6,237,10,1100,863,1,20.0
8358,4987.0,CALENDAR IN SEASON DESIGN,1,1080,10,1100,20,1,20.0
8359,4988.0,SMALL POPCORN HOLDER,5,302,5,600,298,1,10.0
8360,4989.0,BLUE PAISLEY TISSUE BOX,5,277,25,2600,2323,1,50.0
8361,4990.0,HEART OF WICKER SMALL,7,114,8,900,786,1,16.0
8362,4991.0,SKULLS SQUARE TISSUE BOX,3,1573,20,2100,527,1,40.0
8363,4992.0,SKULLS SQUARE TISSUE BOX,4,242,2,300,58,1,4.0
8364,4993.0,WHITE HANGING HEART T-LIGHT HOLDER,6,551,5,600,49,1,10.0
8365,4994.0,WHITE METAL LANTERN,9,192,5,600,408,1,10.0
8366,4995.0,CREAM CUPID HEARTS COAT HANGER,1,154,13,1400,1246,1,26.0
8367,4996.0,KNITTED UNION FLAG HOT WATER BOTTLE,1,338,22,2300,1962,1,44.0
8368,4997.0,RED WOOLLY HOTTIE WHITE HEART.,1,145,19,2000,1855,1,38.0
8369,4998.0,SET 7 BABUSHKA NESTING BOXES,5,763,7,800,37,1,14.0
8370,4999.0,GLASS STAR FROSTED T-LIGHT HOLDER,7,1666,25,2600,934,1,50.0
8371,5000.0,HAND WARMER UNION JACK,4,120,21,2200,2080,1,42.0
8372,5001.0,HAND WARMER RED POLKA DOT,9,706,10,1100,394,1,20.0
8373,5002.0,ASSORTED COLOUR BIRD ORNAMENT,5,1043,24,2500,1457,1,48.0
8374,5003.0,POPPY'S PLAYHOUSE BEDROOM ,6,448,8,900,452,1,16.0
8375,5004.0,POPPY'S PLAYHOUSE KITCHEN,8,434,13,1400,966,1,26.0
8376,5005.0,FELTCRAFT PRINCESS CHARLOTTE DOLL,10,737,14,1500,763,1,28.0
8377,5006.0,IVORY KNITTED MUG COSY ,6,504,7,800,296,1,14.0
8378,5007.0,BOX OF 6 ASSORTED COLOUR TEASPOONS,7,1063,14,1500,437,1,28.0
8379,5008.0,BOX OF VINTAGE JIGSAW BLOCKS ,2,1064,12,1300,236,1,24.0
8380,5009.0,BOX OF VINTAGE ALPHABET BLOCKS,7,195,14,1500,1305,1,28.0
8381,5010.0,HOME BUILDING BLOCK WORD,6,467,8,900,433,1,16.0
8382,5011.0,LOVE BUILDING BLOCK WORD,7,796,17,1800,1004,1,34.0
8383,5012.0,RECIPE BOX WITH METAL HEART,10,612,24,2500,1888,1,48.0
8384,5013.0,DOORMAT NEW ENGLAND,2,1458,18,1900,442,1,36.0
8385,5014.0,JAM MAKING SET WITH JARS,9,155,2,300,145,1,4.0
8386,5015.0,RED COAT RACK PARIS FASHION,9,1184,21,2200,1016,1,42.0
8387,5016.0,YELLOW COAT RACK PARIS FASHION,5,646,6,700,54,1,12.0
8388,5017.0,BLUE COAT RACK PARIS FASHION,10,670,13,1400,730,1,26.0
8389,5018.0,BATH BUILDING BLOCK WORD,6,529,18,1900,1371,1,36.0
8390,5019.0,ALARM CLOCK BAKELIKE PINK,10,433,9,1000,567,1,18.0
8391,5020.0,ALARM CLOCK BAKELIKE RED ,10,1054,11,1200,146,1,22.0
8392,5021.0,ALARM CLOCK BAKELIKE GREEN,1,1619,24,2500,881,1,48.0
8393,5022.0,PANDA AND BUNNIES STICKER SHEET,2,466,14,1500,1034,1,28.0
8394,5023.0,STARS GIFT TAPE ,9,347,16,1700,1353,1,32.0
8395,5024.0,INFLATABLE POLITICAL GLOBE ,3,1716,22,2300,584,1,44.0
8396,5025.0,VINTAGE HEADS AND TAILS CARD GAME ,10,721,8,900,179,1,16.0
8397,5026.0,SET/2 RED RETROSPOT TEA TOWELS ,1,399,8,900,501,1,16.0
8398,5027.0,ROUND SNACK BOXES SET OF4 WOODLAND ,5,456,22,2300,1844,1,44.0
8399,5028.0,SPACEBOY LUNCH BOX ,1,194,7,800,606,1,14.0
8400,5029.0,LUNCH BOX I LOVE LONDON,1,572,14,1500,928,1,28.0
8401,5030.0,CIRCUS PARADE LUNCH BOX ,5,297,10,1100,803,1,20.0
8402,5031.0,CHARLOTTE BAG DOLLY GIRL DESIGN,10,100,0,100,0,1,0.0
8403,5032.0,RED TOADSTOOL LED NIGHT LIGHT,4,384,5,600,216,1,10.0
8404,5033.0, SET 2 TEA TOWELS I LOVE LONDON ,10,100,0,100,0,1,0.0
8405,5034.0,VINTAGE SEASIDE JIGSAW PUZZLES,2,138,2,300,162,1,4.0
8406,5035.0,MINI JIGSAW CIRCUS PARADE ,5,1441,20,2100,659,1,40.0
8407,5036.0,MINI JIGSAW SPACEBOY,6,149,1,200,51,1,2.0
8408,5037.0,MINI PAINT SET VINTAGE ,10,296,2,300,4,1,4.0
8409,5038.0,POSTAGE,6,215,12,1300,1085,1,24.0
8410,5039.0,PAPER CHAIN KIT 50'S CHRISTMAS ,4,815,8,900,85,1,16.0
8411,5040.0,HAND WARMER RED POLKA DOT,5,667,12,1300,633,1,24.0
8412,5041.0,HAND WARMER UNION JACK,4,100,0,100,0,1,0.0
8413,5042.0,WHITE HANGING HEART T-LIGHT HOLDER,10,1527,16,1700,173,1,32.0
8414,5043.0,WHITE METAL LANTERN,5,436,21,2200,1764,1,42.0
8415,5044.0,CREAM CUPID HEARTS COAT HANGER,7,2113,24,2500,387,1,48.0
8416,5045.0,EDWARDIAN PARASOL RED,2,1214,22,2300,1086,1,44.0
8417,5046.0,RETRO COFFEE MUGS ASSORTED,8,227,19,2000,1773,1,38.0
8418,5047.0,SAVE THE PLANET MUG,1,337,5,600,263,1,10.0
8419,5048.0,VINTAGE BILLBOARD DRINK ME MUG,6,1498,24,2500,1002,1,48.0
8420,5049.0,VINTAGE BILLBOARD LOVE/HATE MUG,2,615,6,700,85,1,12.0
8421,5050.0,WOOD 2 DRAWER CABINET WHITE FINISH,6,1273,19,2000,727,1,38.0
8422,5051.0,WOOD S/3 CABINET ANT WHITE FINISH,6,1172,24,2500,1328,1,48.0
8423,5052.0,WOODEN PICTURE FRAME WHITE FINISH,6,545,14,1500,955,1,28.0
8424,5053.0,WOODEN FRAME ANTIQUE WHITE ,5,296,15,1600,1304,1,30.0
8425,5054.0,KNITTED UNION FLAG HOT WATER BOTTLE,1,1136,16,1700,564,1,32.0
8426,5055.0,RED WOOLLY HOTTIE WHITE HEART.,7,1144,20,2100,956,1,40.0
8427,5056.0,SET 7 BABUSHKA NESTING BOXES,1,113,5,600,487,1,10.0
8428,5057.0,GLASS STAR FROSTED T-LIGHT HOLDER,6,901,9,1000,99,1,18.0
8429,5058.0,VICTORIAN SEWING BOX LARGE,2,129,3,400,271,1,6.0
8430,5059.0,WHITE HANGING HEART T-LIGHT HOLDER,8,1087,23,2400,1313,1,46.0
8431,5060.0,WHITE METAL LANTERN,10,184,5,600,416,1,10.0
8432,5061.0,CREAM CUPID HEARTS COAT HANGER,3,991,17,1800,809,1,34.0
8433,5062.0,EDWARDIAN PARASOL RED,10,730,7,800,70,1,14.0
8434,5063.0,RETRO COFFEE MUGS ASSORTED,7,130,10,1100,970,1,20.0
8435,5064.0,SAVE THE PLANET MUG,6,946,9,1000,54,1,18.0
8436,5065.0,VINTAGE BILLBOARD DRINK ME MUG,2,466,12,1300,834,1,24.0
8437,5066.0,VINTAGE BILLBOARD LOVE/HATE MUG,4,865,23,2400,1535,1,46.0
8438,5067.0,WOOD 2 DRAWER CABINET WHITE FINISH,7,1241,21,2200,959,1,42.0
8439,5068.0,WOOD S/3 CABINET ANT WHITE FINISH,1,480,15,1600,1120,1,30.0
8440,5069.0,WOODEN PICTURE FRAME WHITE FINISH,6,290,8,900,610,1,16.0
8441,5070.0,WOODEN FRAME ANTIQUE WHITE ,6,359,4,500,141,1,8.0
8442,5071.0,KNITTED UNION FLAG HOT WATER BOTTLE,4,910,16,1700,790,1,32.0
8443,5072.0,RED WOOLLY HOTTIE WHITE HEART.,2,131,16,1700,1569,1,32.0
8444,5073.0,SET 7 BABUSHKA NESTING BOXES,7,951,11,1200,249,1,22.0
8445,5074.0,GLASS STAR FROSTED T-LIGHT HOLDER,2,248,4,500,252,1,8.0
8446,5075.0,HOT WATER BOTTLE TEA AND SYMPATHY,6,1186,11,1200,14,1,22.0
8447,5076.0,RED HANGING HEART T-LIGHT HOLDER,5,1552,21,2200,648,1,42.0
8448,5077.0,HAND WARMER RED POLKA DOT,5,703,21,2200,1497,1,42.0
8449,5078.0,HAND WARMER UNION JACK,9,207,13,1400,1193,1,26.0
8450,5079.0,JUMBO BAG PINK POLKADOT,3,283,15,1600,1317,1,30.0
8451,5080.0,JUMBO  BAG BAROQUE BLACK WHITE,1,238,2,300,62,1,4.0
8452,5081.0,JUMBO BAG CHARLIE AND LOLA TOYS,10,844,21,2200,1356,1,42.0
8453,5082.0,STRAWBERRY CHARLOTTE BAG,1,1675,25,2600,925,1,50.0
8454,5083.0,RED 3 PIECE RETROSPOT CUTLERY SET,5,198,8,900,702,1,16.0
8455,5084.0,BLUE 3 PIECE POLKADOT CUTLERY SET,1,360,19,2000,1640,1,38.0
8456,5085.0,SET/6 RED SPOTTY PAPER PLATES,6,337,10,1100,763,1,20.0
8457,5086.0,LUNCH BAG RED RETROSPOT,5,500,20,2100,1600,1,40.0
8458,5087.0,STRAWBERRY LUNCH BOX WITH CUTLERY,2,934,22,2300,1366,1,44.0
8459,5088.0,LUNCH BOX WITH CUTLERY RETROSPOT ,1,103,1,200,97,1,2.0
8460,5089.0,PACK OF 72 RETROSPOT CAKE CASES,4,1636,23,2400,764,1,46.0
8461,5090.0,PACK OF 60 DINOSAUR CAKE CASES,6,199,9,1000,801,1,18.0
8462,5091.0,PACK OF 60 PINK PAISLEY CAKE CASES,10,586,6,700,114,1,12.0
8463,5092.0,64 TEATIME FAIRY CAKE CASES,1,100,0,100,0,1,0.0
8464,5093.0,TOMATO CHARLIE+LOLA COASTER SET,9,1649,21,2200,551,1,42.0
8465,5094.0,CHARLIE & LOLA WASTEPAPER BIN FLORA,6,145,1,200,55,1,2.0
8466,5095.0,RED CHARLIE+LOLA PERSONAL DOORSIGN,2,167,2,300,133,1,4.0
8467,5096.0,JUMBO STORAGE BAG SUKI,9,870,9,1000,130,1,18.0
8468,5097.0,JUMBO BAG PINK VINTAGE PAISLEY,8,156,1,200,44,1,2.0
8469,5098.0,JAM MAKING SET PRINTED,6,619,6,700,81,1,12.0
8470,5099.0,RETROSPOT TEA SET CERAMIC 11 PC ,8,243,2,300,57,1,4.0
8471,5100.0,GIRLY PINK TOOL SET,6,764,8,900,136,1,16.0
8472,5101.0,JUMBO SHOPPER VINTAGE RED PAISLEY,9,629,22,2300,1671,1,44.0
8473,5102.0,"AIRLINE LOUNGE,METAL SIGN",3,309,8,900,591,1,16.0
8474,5103.0,WHITE SPOT RED CERAMIC DRAWER KNOB,1,1474,23,2400,926,1,46.0
8475,5104.0,RED DRAWER KNOB ACRYLIC EDWARDIAN,10,505,5,600,95,1,10.0
8476,5105.0,CLEAR DRAWER KNOB ACRYLIC EDWARDIAN,1,169,1,200,31,1,2.0
8477,5106.0,PHOTO CLIP LINE,8,1033,16,1700,667,1,32.0
8478,5107.0,FELT EGG COSY CHICKEN,2,387,18,1900,1513,1,36.0
8479,5108.0,PIGGY BANK RETROSPOT ,4,272,2,300,28,1,4.0
8480,5109.0,SKULL SHOULDER BAG,5,503,7,800,297,1,14.0
8481,5110.0,YOU'RE CONFUSING ME METAL SIGN ,3,499,10,1100,601,1,20.0
8482,5111.0,COOK WITH WINE METAL SIGN ,2,199,6,700,501,1,12.0
8483,5112.0,GIN + TONIC DIET METAL SIGN,9,918,16,1700,782,1,32.0
8484,5113.0,YELLOW BREAKFAST CUP AND SAUCER,2,761,13,1400,639,1,26.0
8485,5114.0,PINK BREAKFAST CUP AND SAUCER ,5,1355,16,1700,345,1,32.0
8486,5115.0,PAPER CHAIN KIT 50'S CHRISTMAS ,7,883,25,2600,1717,1,50.0
8487,5116.0,PAPER CHAIN KIT RETROSPOT,4,555,10,1100,545,1,20.0
8488,5117.0,SMALL HEART FLOWERS HOOK ,2,722,12,1300,578,1,24.0
8489,5118.0,PHOTO CLIP LINE,6,318,4,500,182,1,8.0
8490,5119.0,TEA TIME DES TEA COSY,4,100,0,100,0,1,0.0
8491,5120.0,FELT EGG COSY WHITE RABBIT ,9,1033,19,2000,967,1,38.0
8492,5121.0,ZINC WILLIE WINKIE  CANDLE STICK,8,767,18,1900,1133,1,36.0
8493,5122.0,CERAMIC CHERRY CAKE MONEY BANK,10,1308,23,2400,1092,1,46.0
8494,5123.0,RETROSPOT LARGE MILK JUG,2,275,2,300,25,1,4.0
8495,5124.0,SET OF 6 FUNKY BEAKERS,8,802,16,1700,898,1,32.0
8496,5125.0,EDWARDIAN PARASOL BLACK,3,342,25,2600,2258,1,50.0
8497,5126.0,EDWARDIAN PARASOL NATURAL,5,483,10,1100,617,1,20.0
8498,5127.0,CERAMIC STRAWBERRY CAKE MONEY BANK,3,1991,19,2000,9,1,38.0
8499,5128.0,BLUE OWL SOFT TOY,8,545,6,700,155,1,12.0
8500,5129.0,BALLOON ART MAKE YOUR OWN FLOWERS,8,103,1,200,97,1,2.0
8501,5130.0,RED TOADSTOOL LED NIGHT LIGHT,9,414,17,1800,1386,1,34.0
8502,5131.0,GLASS CLOCHE SMALL,10,225,4,500,275,1,8.0
8503,5132.0,GUMBALL MONOCHROME COAT RACK,7,1129,16,1700,571,1,32.0
8504,5133.0,DOORMAT FANCY FONT HOME SWEET HOME,6,464,14,1500,1036,1,28.0
8505,5134.0,Discount,9,1083,14,1500,417,1,28.0
8506,5135.0,INFLATABLE POLITICAL GLOBE ,8,1522,20,2100,578,1,40.0
8507,5136.0,VINTAGE SNAKES & LADDERS,8,632,7,800,168,1,14.0
8508,5137.0,CHOCOLATE CALCULATOR,10,1209,12,1300,91,1,24.0
8509,5138.0,JUMBO SHOPPER VINTAGE RED PAISLEY,2,1629,23,2400,771,1,46.0
8510,5139.0,RECYCLING BAG RETROSPOT ,4,648,21,2200,1552,1,42.0
8511,5140.0,TOY TIDY PINK POLKADOT,10,317,17,1800,1483,1,34.0
8512,5141.0,ANTIQUE GLASS DRESSING TABLE POT,7,491,6,700,209,1,12.0
8513,5142.0,ALARM CLOCK BAKELIKE GREEN,3,109,8,900,791,1,16.0
8514,5143.0,IVORY GIANT GARDEN THERMOMETER,6,739,7,800,61,1,14.0
8515,5144.0,7 TIER CAKE TIN GREEN AND CREAM,7,100,0,100,0,1,0.0
8516,5145.0,7 TIER CAKE TIN RED AND CREAM,5,329,5,600,271,1,10.0
8517,5146.0,SET 3 WICKER OVAL BASKETS W LIDS,1,1291,14,1500,209,1,28.0
8518,5147.0,SET OF 3 COLOURED  FLYING DUCKS,9,671,21,2200,1529,1,42.0
8519,5148.0,WOOD BLACK BOARD ANT WHITE FINISH,3,456,12,1300,844,1,24.0
8520,5149.0,COLOUR GLASS T-LIGHT HOLDER HANGING,2,784,9,1000,216,1,18.0
8521,5150.0,HANGING METAL HEART LANTERN,6,1648,25,2600,952,1,50.0
8522,5151.0,HANGING MEDINA LANTERN SMALL,2,239,2,300,61,1,4.0
8523,5152.0,NATURAL SLATE HEART CHALKBOARD ,6,193,6,700,507,1,12.0
8524,5153.0,HEART OF WICKER SMALL,5,135,2,300,165,1,4.0
8525,5154.0,HEART OF WICKER LARGE,2,608,20,2100,1492,1,40.0
8526,5155.0,WHITE LOVEBIRD LANTERN,10,1054,19,2000,946,1,38.0
8527,5156.0,CLASSIC METAL BIRDCAGE PLANT HOLDER,3,100,0,100,0,1,0.0
8528,5157.0,CREAM HEART CARD HOLDER,10,1261,25,2600,1339,1,50.0
8529,5158.0,ENAMEL FLOWER JUG CREAM,6,113,1,200,87,1,2.0
8530,5159.0,ENAMEL FIRE BUCKET CREAM,6,301,5,600,299,1,10.0
8531,5160.0,ENAMEL BREAD BIN CREAM,3,1172,12,1300,128,1,24.0
8532,5161.0,SET 3 WICKER OVAL BASKETS W LIDS,2,596,21,2200,1604,1,42.0
8533,5162.0,JAM MAKING SET PRINTED,3,194,15,1600,1406,1,30.0
8534,5163.0,JAM MAKING SET WITH JARS,2,748,19,2000,1252,1,38.0
8535,5164.0,JUMBO BAG DOLLY GIRL DESIGN,9,512,24,2500,1988,1,48.0
8536,5165.0,TRADITIONAL CHRISTMAS RIBBONS,5,205,23,2400,2195,1,46.0
8537,5166.0,ORGANISER WOOD ANTIQUE WHITE ,10,623,11,1200,577,1,22.0
8538,5167.0,LUNCH BAG DOLLY GIRL DESIGN,4,580,21,2200,1620,1,42.0
8539,5168.0,WHITE WIRE EGG HOLDER,6,440,7,800,360,1,14.0
8540,5169.0,JUMBO  BAG BAROQUE BLACK WHITE,4,1574,20,2100,526,1,40.0
8541,5170.0,JUMBO BAG RED RETROSPOT,4,681,15,1600,919,1,30.0
8542,5171.0,CHILLI LIGHTS,10,675,14,1500,825,1,28.0
8543,5172.0,LIGHT GARLAND BUTTERFILES PINK,4,803,21,2200,1397,1,42.0
8544,5173.0,WOODEN OWLS LIGHT GARLAND ,1,758,16,1700,942,1,32.0
8545,5174.0,FAIRY TALE COTTAGE NIGHTLIGHT,1,369,9,1000,631,1,18.0
8546,5175.0,RED TOADSTOOL LED NIGHT LIGHT,2,2277,25,2600,323,1,50.0
8547,5176.0,HOME BUILDING BLOCK WORD,10,164,19,2000,1836,1,38.0
8548,5177.0,LOVE BUILDING BLOCK WORD,10,194,6,700,506,1,12.0
8549,5178.0,DOORMAT FANCY FONT HOME SWEET HOME,6,1283,14,1500,217,1,28.0
8550,5179.0,HOME SMALL WOOD LETTERS,2,741,19,2000,1259,1,38.0
8551,5180.0,GINGHAM HEART  DOORSTOP RED,6,299,14,1500,1201,1,28.0
8552,5181.0,FIVE HEART HANGING DECORATION,1,229,5,600,371,1,10.0
8553,5182.0,HANGING METAL HEART LANTERN,7,1562,21,2200,638,1,42.0
8554,5183.0,ASSORTED BOTTLE TOP  MAGNETS ,1,1185,17,1800,615,1,34.0
8555,5184.0,FRIDGE MAGNETS US DINER ASSORTED,4,918,9,1000,82,1,18.0
8556,5185.0,HOMEMADE JAM SCENTED CANDLES,2,439,6,700,261,1,12.0
8557,5186.0,FRIDGE MAGNETS LES ENFANTS ASSORTED,2,975,12,1300,325,1,24.0
8558,5187.0,ROSE CARAVAN DOORSTOP,2,1455,23,2400,945,1,46.0
8559,5188.0,HEART OF WICKER SMALL,7,779,13,1400,621,1,26.0
8560,5189.0,9 HOOK HANGER MAGIC TOADSTOOL,4,127,17,1800,1673,1,34.0
8561,5190.0,CHRISTMAS LIGHTS 10 REINDEER,4,732,8,900,168,1,16.0
8562,5191.0,VINTAGE UNION JACK CUSHION COVER,10,750,12,1300,550,1,24.0
8563,5192.0,VINTAGE HEADS AND TAILS CARD GAME ,7,720,18,1900,1180,1,36.0
8564,5193.0,SET OF 3 COLOURED  FLYING DUCKS,8,797,14,1500,703,1,28.0
8565,5194.0,SET OF 3 GOLD FLYING DUCKS,6,504,5,600,96,1,10.0
8566,5195.0,RED RETROSPOT UMBRELLA,4,134,2,300,166,1,4.0
8567,5196.0,BLACK/BLUE POLKADOT UMBRELLA,9,196,5,600,404,1,10.0
8568,5197.0,RED DINER WALL CLOCK,4,802,20,2100,1298,1,40.0
8569,5198.0,ALARM CLOCK BAKELIKE GREEN,9,224,2,300,76,1,4.0
8570,5199.0,ALARM CLOCK BAKELIKE RED ,10,426,10,1100,674,1,20.0
8571,5200.0,BLUE DINER WALL CLOCK,3,314,13,1400,1086,1,26.0
8572,5201.0,IVORY DINER WALL CLOCK,9,363,5,600,237,1,10.0
8573,5202.0,LARGE HEART MEASURING SPOONS,7,187,1,200,13,1,2.0
8574,5203.0,SMALL HEART MEASURING SPOONS,3,328,5,600,272,1,10.0
8575,5204.0,CHRISTMAS LIGHTS 10 REINDEER,7,1457,20,2100,643,1,40.0
8576,5205.0,JAM MAKING SET WITH JARS,1,100,0,100,0,1,0.0
8577,5206.0,JAM MAKING SET PRINTED,10,156,16,1700,1544,1,32.0
8578,5207.0,JAM JAR WITH PINK LID,8,695,15,1600,905,1,30.0
8579,5208.0,JAM JAR WITH GREEN LID,3,878,8,900,22,1,16.0
8580,5209.0,ROSE COTTAGE KEEPSAKE BOX ,10,543,5,600,57,1,10.0
8581,5210.0,HANGING HEART ZINC T-LIGHT HOLDER,10,1274,13,1400,126,1,26.0
8582,5211.0,PAPER CHAIN KIT VINTAGE CHRISTMAS,4,1329,15,1600,271,1,30.0
8583,5212.0,DISCO BALL CHRISTMAS DECORATION,5,592,8,900,308,1,16.0
8584,5213.0,WHITE HANGING HEART T-LIGHT HOLDER,4,243,6,700,457,1,12.0
8585,5214.0,SMALL POPCORN HOLDER,3,952,18,1900,948,1,36.0
8586,5215.0,LARGE POPCORN HOLDER ,7,766,13,1400,634,1,26.0
8587,5216.0,RETROSPOT LARGE MILK JUG,8,138,18,1900,1762,1,36.0
8588,5217.0,SET/20 RED RETROSPOT PAPER NAPKINS ,8,745,22,2300,1555,1,44.0
8589,5218.0,SET/6 RED SPOTTY PAPER PLATES,6,657,11,1200,543,1,22.0
8590,5219.0,SET/6 RED SPOTTY PAPER CUPS,10,241,3,400,159,1,6.0
8591,5220.0,POLKADOT RAIN HAT ,9,1551,18,1900,349,1,36.0
8592,5221.0,DELUXE SEWING KIT ,1,2274,24,2500,226,1,48.0
8593,5222.0,RETROSPOT HEART HOT WATER BOTTLE,2,376,14,1500,1124,1,28.0
8594,5223.0,KNITTED UNION FLAG HOT WATER BOTTLE,3,587,22,2300,1713,1,44.0
8595,5224.0,ENGLISH ROSE HOT WATER BOTTLE,3,367,13,1400,1033,1,26.0
8596,5225.0,PHOTO CUBE,10,604,15,1600,996,1,30.0
8597,5226.0,HOMEMADE JAM SCENTED CANDLES,6,100,0,100,0,1,0.0
8598,5227.0,JUMBO BAG RED RETROSPOT,9,205,2,300,95,1,4.0
8599,5228.0,PLASTERS IN TIN CIRCUS PARADE ,2,159,1,200,41,1,2.0
8600,5229.0,PACK OF 12 PINK PAISLEY TISSUES ,9,1181,25,2600,1419,1,50.0
8601,5230.0,PACK OF 12 BLUE PAISLEY TISSUES ,4,667,25,2600,1933,1,50.0
8602,5231.0,PACK OF 12 RED RETROSPOT TISSUES ,7,880,17,1800,920,1,34.0
8603,5232.0,CHICK GREY HOT WATER BOTTLE,5,254,2,300,46,1,4.0
8604,5233.0,PLASTERS IN TIN VINTAGE PAISLEY ,5,620,21,2200,1580,1,42.0
8605,5234.0,PLASTERS IN TIN SKULLS,10,280,22,2300,2020,1,44.0
8606,5235.0,7 STRIPEY MICE FELTCRAFT,10,385,9,1000,615,1,18.0
8607,5236.0,SET OF 6 SOLDIER SKITTLES,9,2096,24,2500,404,1,48.0
8608,5237.0,TRADITIONAL WOODEN SKIPPING ROPE,9,350,3,400,50,1,6.0
8609,5238.0,WOODEN BOX OF DOMINOES,6,1537,22,2300,763,1,44.0
8610,5239.0,RUSTIC  SEVENTEEN DRAWER SIDEBOARD,10,459,4,500,41,1,8.0
8611,5240.0,PARTY CONES CARNIVAL ASSORTED,1,110,23,2400,2290,1,46.0
8612,5241.0,PARTY CONES CANDY ASSORTED,4,1144,18,1900,756,1,36.0
8613,5242.0,PICNIC BASKET WICKER SMALL,6,434,13,1400,966,1,26.0
8614,5243.0,ASSORTED COLOUR BIRD ORNAMENT,3,137,2,300,163,1,4.0
8615,5244.0,STAR DECORATION PAINTED ZINC ,5,123,3,400,277,1,6.0
8616,5245.0,RETROSPOT LAMP,5,1173,16,1700,527,1,32.0
8617,5246.0,"FANCY FONT BIRTHDAY CARD, ",1,160,1,200,40,1,2.0
8618,5247.0,HAND WARMER UNION JACK,5,1243,13,1400,157,1,26.0
8619,5248.0,HAND WARMER SCOTTY DOG DESIGN,6,1194,18,1900,706,1,36.0
8620,5249.0,HAND WARMER OWL DESIGN,9,102,13,1400,1298,1,26.0
8621,5250.0,HAND WARMER RED RETROSPOT,1,344,6,700,356,1,12.0
8622,5251.0,RETROSPOT HEART HOT WATER BOTTLE,9,1174,23,2400,1226,1,46.0
8623,5252.0,DOG BOWL CHASING BALL DESIGN,7,197,2,300,103,1,4.0
8624,5253.0,CLOTHES PEGS RETROSPOT PACK 28,7,588,19,2000,1412,1,38.0
8625,5254.0,HAND OVER THE CHOCOLATE   SIGN ,6,179,2,300,121,1,4.0
8626,5255.0,WHITE HANGING HEART T-LIGHT HOLDER,1,196,1,200,4,1,2.0
8627,5256.0,TRAVEL SEWING KIT,1,153,1,200,47,1,2.0
8628,5257.0,BLACK HEART CARD HOLDER,7,1019,13,1400,381,1,26.0
8629,5258.0,ASSORTED COLOUR BIRD ORNAMENT,5,100,0,100,0,1,0.0
8630,5259.0,PACK OF 60 PINK PAISLEY CAKE CASES,8,793,13,1400,607,1,26.0
8631,5260.0,64 TEATIME FAIRY CAKE CASES,5,529,12,1300,771,1,24.0
8632,5261.0,PACK OF 72 RETROSPOT CAKE CASES,10,174,1,200,26,1,2.0
8633,5262.0,CHICK GREY HOT WATER BOTTLE,9,267,2,300,33,1,4.0
8634,5263.0,SMALL GLASS HEART TRINKET POT,10,190,2,300,110,1,4.0
8635,5264.0,ALARM CLOCK BAKELIKE IVORY,5,203,2,300,97,1,4.0
8636,5265.0,ALARM CLOCK BAKELIKE RED ,3,124,1,200,76,1,2.0
8637,5266.0,ALARM CLOCK BAKELIKE ORANGE,7,956,13,1400,444,1,26.0
8638,5267.0,ALARM CLOCK BAKELIKE GREEN,1,1376,24,2500,1124,1,48.0
8639,5268.0,HOT WATER BOTTLE TEA AND SYMPATHY,10,173,4,500,327,1,8.0
8640,5269.0,HAND WARMER BIRD DESIGN,9,2491,25,2600,109,1,50.0
8641,5270.0,HAND WARMER SCOTTY DOG DESIGN,1,648,15,1600,952,1,30.0
8642,5271.0,WHITE HANGING HEART T-LIGHT HOLDER,4,1376,18,1900,524,1,36.0
8643,5272.0,WHITE METAL LANTERN,5,1103,17,1800,697,1,34.0
8644,5273.0,CREAM CUPID HEARTS COAT HANGER,5,300,5,600,300,1,10.0
8645,5274.0,EDWARDIAN PARASOL BLACK,2,393,24,2500,2107,1,48.0
8646,5275.0,EDWARDIAN PARASOL RED,9,769,21,2200,1431,1,42.0
8647,5276.0,RETRO COFFEE MUGS ASSORTED,5,146,1,200,54,1,2.0
8648,5277.0,SAVE THE PLANET MUG,9,1544,22,2300,756,1,44.0
8649,5278.0,VINTAGE BILLBOARD DRINK ME MUG,3,234,16,1700,1466,1,32.0
8650,5279.0,VINTAGE BILLBOARD LOVE/HATE MUG,8,362,13,1400,1038,1,26.0
8651,5280.0,WOOD 2 DRAWER CABINET WHITE FINISH,6,1195,25,2600,1405,1,50.0
8652,5281.0,WOOD S/3 CABINET ANT WHITE FINISH,3,196,2,300,104,1,4.0
8653,5282.0,WOODEN PICTURE FRAME WHITE FINISH,9,170,6,700,530,1,12.0
8654,5283.0,WOODEN FRAME ANTIQUE WHITE ,3,245,5,600,355,1,10.0
8655,5284.0,KNITTED UNION FLAG HOT WATER BOTTLE,8,194,18,1900,1706,1,36.0
8656,5285.0,RED WOOLLY HOTTIE WHITE HEART.,8,535,9,1000,465,1,18.0
8657,5286.0,SET 7 BABUSHKA NESTING BOXES,5,127,5,600,473,1,10.0
8658,5287.0,IVORY EMBROIDERED QUILT ,5,1649,19,2000,351,1,38.0
8659,5288.0,GLASS STAR FROSTED T-LIGHT HOLDER,1,169,21,2200,2031,1,42.0
8660,5289.0,SET OF 3 BLACK FLYING DUCKS,4,2012,24,2500,488,1,48.0
8661,5290.0,SET OF 3 COLOURED  FLYING DUCKS,1,678,14,1500,822,1,28.0
8662,5291.0,PACK OF 12 RED RETROSPOT TISSUES ,10,369,4,500,131,1,8.0
8663,5292.0,RED RETROSPOT MUG,9,336,10,1100,764,1,20.0
8664,5293.0,BABUSHKA LIGHTS STRING OF 14,2,568,18,1900,1332,1,36.0
8665,5294.0,PIGGY BANK RETROSPOT ,1,2208,23,2400,192,1,46.0
8666,5295.0,SET 7 BABUSHKA NESTING BOXES,5,182,2,300,118,1,4.0
8667,5296.0,DOORMAT FAIRY CAKE,9,268,2,300,32,1,4.0
8668,5297.0,HAND WARMER RED RETROSPOT,5,263,6,700,437,1,12.0
8669,5298.0,HAND WARMER SCOTTY DOG DESIGN,9,1669,24,2500,831,1,48.0
8670,5299.0,HAND WARMER OWL DESIGN,6,1266,12,1300,34,1,24.0
8671,5300.0,STRAWBERRY CERAMIC TRINKET BOX,7,1195,11,1200,5,1,22.0
8672,5301.0,PINK DOUGHNUT TRINKET POT ,10,667,6,700,33,1,12.0
8673,5302.0,SILK PURSE BABUSHKA PINK,9,801,21,2200,1399,1,42.0
8674,5303.0,HOT WATER BOTTLE TEA AND SYMPATHY,5,844,17,1800,956,1,34.0
8675,5304.0,HOT WATER BOTTLE I AM SO POORLY,2,1402,17,1800,398,1,34.0
8676,5305.0,CHOCOLATE HOT WATER BOTTLE,2,786,17,1800,1014,1,34.0
8677,5306.0,WHITE SKULL HOT WATER BOTTLE ,9,258,3,400,142,1,6.0
8678,5307.0,SCOTTIE DOG HOT WATER BOTTLE,4,1553,24,2500,947,1,48.0
8679,5308.0,HAND WARMER RED POLKA DOT,1,1449,18,1900,451,1,36.0
8680,5309.0,HAND WARMER UNION JACK,2,181,10,1100,919,1,20.0
8681,5310.0,HOMEMADE JAM SCENTED CANDLES,5,1102,15,1600,498,1,30.0
8682,5311.0,BIRD HOUSE HOT WATER BOTTLE,3,265,3,400,135,1,6.0
8683,5312.0,BOUDOIR SQUARE TISSUE BOX,9,464,7,800,336,1,14.0
8684,5313.0,SKULLS SQUARE TISSUE BOX,7,2092,21,2200,108,1,42.0
8685,5314.0,PHOTO FRAME CORNICE,5,184,2,300,116,1,4.0
8686,5315.0,SILK PURSE BABUSHKA RED,8,597,7,800,203,1,14.0
8687,5316.0,PICTURE DOMINOES,6,1000,13,1400,400,1,26.0
8688,5317.0,S/6 SEW ON CROCHET FLOWERS,4,476,8,900,424,1,16.0
8689,5318.0,SCANDINAVIAN REDS RIBBONS,9,152,1,200,48,1,2.0
8690,5319.0,BALLOONS  WRITING SET ,6,236,8,900,664,1,16.0
8691,5320.0,JAM MAKING SET PRINTED,9,1897,18,1900,3,1,36.0
8692,5321.0,LAVENDER INCENSE IN TIN,9,156,5,600,444,1,10.0
8693,5322.0,TV DINNER TRAY VINTAGE PAISLEY,1,551,22,2300,1749,1,44.0
8694,5323.0,SET OF 4 ENGLISH ROSE PLACEMATS,4,1161,15,1600,439,1,30.0
8695,5324.0,SET OF 4 ENGLISH ROSE COASTERS,4,1038,20,2100,1062,1,40.0
8696,5325.0,TRIPLE PHOTO FRAME CORNICE ,1,1083,11,1200,117,1,22.0
8697,5326.0,FAMILY PHOTO FRAME CORNICE,2,940,9,1000,60,1,18.0
8698,5327.0,MIRRORED DISCO BALL ,1,512,14,1500,988,1,28.0
8699,5328.0,DISCO BALL ROTATOR BATTERY OPERATED,1,1274,13,1400,126,1,26.0
8700,5329.0,SILVER LOOKING MIRROR,10,230,13,1400,1170,1,26.0
8701,5330.0,LADIES & GENTLEMEN METAL SIGN,2,438,24,2500,2062,1,48.0
8702,5331.0,METAL SIGN HER DINNER IS SERVED ,2,111,1,200,89,1,2.0
8703,5332.0,YOU'RE CONFUSING ME METAL SIGN ,10,300,7,800,500,1,14.0
8704,5333.0,DOORMAT TOPIARY,6,365,11,1200,835,1,22.0
8705,5334.0,BATHROOM METAL SIGN,1,207,2,300,93,1,4.0
8706,5335.0,KITCHEN METAL SIGN,9,403,12,1300,897,1,24.0
8707,5336.0,TOILET METAL SIGN,3,493,20,2100,1607,1,40.0
8708,5337.0,METAL SIGN TAKE IT OR LEAVE IT ,4,175,12,1300,1125,1,24.0
8709,5338.0,I'M ON HOLIDAY METAL SIGN,2,360,5,600,240,1,10.0
8710,5339.0,GROW YOUR OWN BASIL IN ENAMEL MUG,1,1376,16,1700,324,1,32.0
8711,5340.0,SET/10 PINK POLKADOT PARTY CANDLES,10,938,18,1900,962,1,36.0
8712,5341.0,SET 20 NAPKINS FAIRY CAKES DESIGN ,1,116,12,1300,1184,1,24.0
8713,5342.0,64 TEATIME FAIRY CAKE CASES,7,1314,15,1600,286,1,30.0
8714,5343.0,SET OF 6 T-LIGHTS SNOWMEN,5,475,18,1900,1425,1,36.0
8715,5344.0,SET OF 6 T-LIGHTS SANTA,5,2127,22,2300,173,1,44.0
8716,5345.0,SET OF 9 HEART SHAPED BALLOONS,9,1669,21,2200,531,1,42.0
8717,5346.0,SANDWICH BATH SPONGE,6,528,17,1800,1272,1,34.0
8718,5347.0,APPLE BATH SPONGE,9,363,15,1600,1237,1,30.0
8719,5348.0,STRAWBERRY BATH SPONGE ,9,304,8,900,596,1,16.0
8720,5349.0,BLACK PIRATE TREASURE CHEST,1,1069,15,1600,531,1,30.0
8721,5350.0,STAR PORTABLE TABLE LIGHT ,3,1232,12,1300,68,1,24.0
8722,5351.0,SNOWFLAKE PORTABLE TABLE LIGHT ,4,1280,25,2600,1320,1,50.0
8723,5352.0,PINK OVAL JEWELLED MIRROR,5,871,9,1000,129,1,18.0
8724,5353.0,RETROSPOT CIGAR BOX MATCHES ,6,308,3,400,92,1,6.0
8725,5354.0,COSY HOUR GIANT TUBE MATCHES,3,506,7,800,294,1,14.0
8726,5355.0,JAZZ HEARTS PURSE NOTEBOOK,7,100,0,100,0,1,0.0
8727,5356.0,LUNCH BAG DOLLY GIRL DESIGN,2,852,13,1400,548,1,26.0
8728,5357.0,WHITE HANGING HEART T-LIGHT HOLDER,8,2004,20,2100,96,1,40.0
8729,5358.0,CANDLEHOLDER PINK HANGING HEART,8,100,0,100,0,1,0.0
8730,5359.0,WOOD 2 DRAWER CABINET WHITE FINISH,8,612,25,2600,1988,1,50.0
8731,5360.0,ASSORTED COLOUR MINI CASES,5,1288,12,1300,12,1,24.0
8732,5361.0,LUNCH BAG RED RETROSPOT,10,672,8,900,228,1,16.0
8733,5362.0,LUNCH BAG SPACEBOY DESIGN ,9,637,23,2400,1763,1,46.0
8734,5363.0,LUNCH BAG WOODLAND,9,192,23,2400,2208,1,46.0
8735,5364.0,LUNCH BAG PINK POLKADOT,1,575,11,1200,625,1,22.0
8736,5365.0,GUMBALL COAT RACK,3,1836,24,2500,664,1,48.0
8737,5366.0,BLUE NEW BAROQUE CANDLESTICK CANDLE,7,1477,14,1500,23,1,28.0
8738,5367.0,PINK NEW BAROQUECANDLESTICK CANDLE,7,100,0,100,0,1,0.0
8739,5368.0,FAIRY CAKE FLANNEL ASSORTED COLOUR,7,1302,17,1800,498,1,34.0
8740,5369.0,BREAD BIN DINER STYLE PINK,2,1342,15,1600,258,1,30.0
8741,5370.0,JUMBO BAG CHARLIE AND LOLA TOYS,9,288,16,1700,1412,1,32.0
8742,5371.0,TEA TIME TABLE CLOTH,5,255,10,1100,845,1,20.0
8743,5372.0,ENGLISH ROSE HOT WATER BOTTLE,4,1342,17,1800,458,1,34.0
8744,5373.0,ENAMEL FIRE BUCKET CREAM,4,1367,24,2500,1133,1,48.0
8745,5374.0,PICNIC BASKET WICKER SMALL,5,1199,11,1200,1,1,22.0
8746,5375.0,PAPER CHAIN KIT 50'S CHRISTMAS ,10,100,6,700,600,1,12.0
8747,5376.0,PAPER CHAIN KIT VINTAGE CHRISTMAS,9,179,5,600,421,1,10.0
8748,5377.0,HOT WATER BOTTLE BABUSHKA ,7,185,1,200,15,1,2.0
8749,5378.0,HAND WARMER BIRD DESIGN,1,566,10,1100,534,1,20.0
8750,5379.0,POSTAGE,7,1626,22,2300,674,1,44.0
8751,5380.0,HEART IVORY TRELLIS SMALL,4,559,18,1900,1341,1,36.0
8752,5381.0,CLEAR DRAWER KNOB ACRYLIC EDWARDIAN,1,556,5,600,44,1,10.0
8753,5382.0,PINK DRAWER KNOB ACRYLIC EDWARDIAN,5,588,12,1300,712,1,24.0
8754,5383.0,GREEN DRAWER KNOB ACRYLIC EDWARDIAN,9,1424,20,2100,676,1,40.0
8755,5384.0,BLUE DRAWER KNOB ACRYLIC EDWARDIAN,4,539,11,1200,661,1,22.0
8756,5385.0,HEART OF WICKER SMALL,2,1039,14,1500,461,1,28.0
8757,5386.0,SMALL POPCORN HOLDER,7,320,3,400,80,1,6.0
8758,5387.0,SET 6 FOOTBALL CELEBRATION CANDLES,9,890,10,1100,210,1,20.0
8759,5388.0,SET OF 6 GIRLS CELEBRATION CANDLES,1,2025,24,2500,475,1,48.0
8760,5389.0,ROMANTIC PINKS RIBBONS ,7,1925,22,2300,375,1,44.0
8761,5390.0,BRIGHT BLUES RIBBONS ,2,237,3,400,163,1,6.0
8762,5391.0,SCANDINAVIAN REDS RIBBONS,10,369,25,2600,2231,1,50.0
8763,5392.0,CHOCOLATE BOX RIBBONS ,7,182,16,1700,1518,1,32.0
8764,5393.0,PARTY INVITES FOOTBALL,8,201,13,1400,1199,1,26.0
8765,5394.0,PARTY INVITES JAZZ HEARTS,7,253,11,1200,947,1,22.0
8766,5395.0,PARTY INVITES SPACEMAN,4,278,4,500,222,1,8.0
8767,5396.0,SET OF 3 BUTTERFLY COOKIE CUTTERS,4,125,5,600,475,1,10.0
8768,5397.0,SET OF 3 HEART COOKIE CUTTERS,10,1171,23,2400,1229,1,46.0
8769,5398.0,7 PIECE SPACEBOY COOKIE CUTTER SET,10,897,25,2600,1703,1,50.0
8770,5399.0,PACK OF 72 SKULL CAKE CASES,8,669,25,2600,1931,1,50.0
8771,5400.0,PACK OF 60 SPACEBOY CAKE CASES,5,479,15,1600,1121,1,30.0
8772,5401.0,PACK OF 72 RETROSPOT CAKE CASES,8,1616,22,2300,684,1,44.0
8773,5402.0,76 SWEETHEART FAIRY CAKE CASES,9,1978,21,2200,222,1,42.0
8774,5403.0,PACK OF 60 DINOSAUR CAKE CASES,6,171,3,400,229,1,6.0
8775,5404.0,LUNCH BAG SUKI  DESIGN ,3,1112,17,1800,688,1,34.0
8776,5405.0,LUNCH BAG CARS BLUE,5,213,6,700,487,1,12.0
8777,5406.0,LUNCH BAG  BLACK SKULL.,10,621,8,900,279,1,16.0
8778,5407.0,HEART IVORY TRELLIS LARGE,6,252,3,400,148,1,6.0
8779,5408.0,SET/5 RED RETROSPOT LID GLASS BOWLS,8,791,23,2400,1609,1,46.0
8780,5409.0,WHITE HANGING HEART T-LIGHT HOLDER,10,2128,22,2300,172,1,44.0
8781,5410.0,WHITE METAL LANTERN,5,590,21,2200,1610,1,42.0
8782,5411.0,CREAM CUPID HEARTS COAT HANGER,9,917,13,1400,483,1,26.0
8783,5412.0,EDWARDIAN PARASOL RED,9,395,16,1700,1305,1,32.0
8784,5413.0,RETRO COFFEE MUGS ASSORTED,6,904,12,1300,396,1,24.0
8785,5414.0,SAVE THE PLANET MUG,9,209,4,500,291,1,8.0
8786,5415.0,VINTAGE BILLBOARD DRINK ME MUG,10,872,22,2300,1428,1,44.0
8787,5416.0,VINTAGE BILLBOARD LOVE/HATE MUG,5,1628,19,2000,372,1,38.0
8788,5417.0,WOOD 2 DRAWER CABINET WHITE FINISH,10,615,11,1200,585,1,22.0
8789,5418.0,WOOD S/3 CABINET ANT WHITE FINISH,10,1330,22,2300,970,1,44.0
8790,5419.0,WOODEN PICTURE FRAME WHITE FINISH,3,1191,14,1500,309,1,28.0
8791,5420.0,WOODEN FRAME ANTIQUE WHITE ,2,369,3,400,31,1,6.0
8792,5421.0,KNITTED UNION FLAG HOT WATER BOTTLE,7,293,13,1400,1107,1,26.0
8793,5422.0,RED WOOLLY HOTTIE WHITE HEART.,6,1691,21,2200,509,1,42.0
8794,5423.0,SET 7 BABUSHKA NESTING BOXES,7,2080,21,2200,120,1,42.0
8795,5424.0,IVORY EMBROIDERED QUILT ,6,158,7,800,642,1,14.0
8796,5425.0,GLASS STAR FROSTED T-LIGHT HOLDER,7,377,9,1000,623,1,18.0
8797,5426.0,HAND WARMER RED POLKA DOT,5,1925,21,2200,275,1,42.0
8798,5427.0,HAND WARMER UNION JACK,4,701,12,1300,599,1,24.0
8799,5428.0,MAGIC DRAWING SLATE DINOSAUR,3,510,10,1100,590,1,20.0
8800,5429.0,MAGIC DRAWING SLATE BAKE A CAKE ,6,100,0,100,0,1,0.0
8801,5430.0,16 PENCILS TALL TUBE SKULLS,8,100,0,100,0,1,0.0
8802,5431.0,CHOCOLATE CALCULATOR,7,1618,24,2500,882,1,48.0
8803,5432.0,RED  HARMONICA IN BOX ,9,246,8,900,654,1,16.0
8804,5433.0,BLUE HARMONICA IN BOX ,10,100,0,100,0,1,0.0
8805,5434.0,SKULLS  WATER TRANSFER TATTOOS ,3,1559,20,2100,541,1,40.0
8806,5435.0,PACK 3 BOXES BIRD PANNETONE ,7,1359,17,1800,441,1,34.0
8807,5436.0,HOT WATER BOTTLE TEA AND SYMPATHY,1,303,3,400,97,1,6.0
8808,5437.0,RED WOOLLY HOTTIE WHITE HEART.,8,437,12,1300,863,1,24.0
8809,5438.0,WHITE SKULL HOT WATER BOTTLE ,8,503,7,800,297,1,14.0
8810,5439.0,7 PIECE SPACEBOY COOKIE CUTTER SET,3,608,12,1300,692,1,24.0
8811,5440.0,SET OF 20 KIDS COOKIE CUTTERS,5,1535,18,1900,365,1,36.0
8812,5441.0,14 COLOUR SPACEBOY PEN,7,131,4,500,369,1,8.0
8813,5442.0,VICTORIAN GLASS HANGING T-LIGHT,2,904,23,2400,1496,1,46.0
8814,5443.0,SINGLE HEART ZINC T-LIGHT HOLDER,7,355,11,1200,845,1,22.0
8815,5444.0,RED HANGING HEART T-LIGHT HOLDER,2,145,6,700,555,1,12.0
8816,5445.0,HANGING METAL STAR LANTERN,9,100,0,100,0,1,0.0
8817,5446.0,SILVER HANGING T-LIGHT HOLDER,6,1065,21,2200,1135,1,42.0
8818,5447.0,DOORMAT RED RETROSPOT,2,270,14,1500,1230,1,28.0
8819,5448.0,DOORMAT HEARTS,8,1980,24,2500,520,1,48.0
8820,5449.0,NATURAL SLATE RECTANGLE CHALKBOARD,9,1833,24,2500,667,1,48.0
8821,5450.0,LOVEBIRD HANGING DECORATION WHITE ,10,1299,13,1400,101,1,26.0
8822,5451.0,ASSORTED COLOUR BIRD ORNAMENT,10,127,16,1700,1573,1,32.0
8823,5452.0,HOME BUILDING BLOCK WORD,10,252,2,300,48,1,4.0
8824,5453.0,LOVE BUILDING BLOCK WORD,6,453,6,700,247,1,12.0
8825,5454.0,PHOTO FRAME CORNICE,6,168,5,600,432,1,10.0
8826,5455.0,PENS ASSORTED FUNNY FACE,8,106,3,400,294,1,6.0
8827,5456.0,CARD CIRCUS PARADE,10,220,2,300,80,1,4.0
8828,5457.0,WRAP COWBOYS  ,7,1323,24,2500,1177,1,48.0
8829,5458.0,AIRLINE BAG VINTAGE TOKYO 82,5,1754,23,2400,646,1,46.0
8830,5459.0,RED RETROSPOT UMBRELLA,10,818,8,900,82,1,16.0
8831,5460.0,BLACK/BLUE POLKADOT UMBRELLA,7,1041,11,1200,159,1,22.0
8832,5461.0,RED 3 PIECE RETROSPOT CUTLERY SET,8,329,18,1900,1571,1,36.0
8833,5462.0,PACK OF 72 RETROSPOT CAKE CASES,9,1626,18,1900,274,1,36.0
8834,5463.0,SET OF 72 RETROSPOT PAPER  DOILIES,3,431,24,2500,2069,1,48.0
8835,5464.0,BLUE COAT RACK PARIS FASHION,4,1590,16,1700,110,1,32.0
8836,5465.0,PLASTERS IN TIN SKULLS,10,1324,13,1400,76,1,26.0
8837,5466.0,SLEEPING CAT ERASERS,4,100,0,100,0,1,0.0
8838,5467.0,CARD BIRTHDAY COWBOY,4,183,12,1300,1117,1,24.0
8839,5468.0,PACK 3 BOXES CHRISTMAS PANNETONE,2,268,2,300,32,1,4.0
8840,5469.0,ROTATING SILVER ANGELS T-LIGHT HLDR,1,1690,19,2000,310,1,38.0
8841,5470.0,COSY HOUR GIANT TUBE MATCHES,1,375,19,2000,1625,1,38.0
8842,5471.0,RIBBON REEL MAKING SNOWMEN ,4,578,19,2000,1422,1,38.0
8843,5472.0,MINI PAINT SET VINTAGE ,4,614,24,2500,1886,1,48.0
8844,5473.0,8 TRADITIONAL SPINNING TOPS,7,110,21,2200,2090,1,42.0
8845,5474.0,SET OF 6 SOLDIER SKITTLES,4,1106,22,2300,1194,1,44.0
8846,5475.0,BAG 500g SWIRLY MARBLES,7,616,18,1900,1284,1,36.0
8847,5476.0,9 STRAND GLASS NECKLACE CRYSTAL,6,1777,17,1800,23,1,34.0
8848,5477.0,WHITE SKULL HOT WATER BOTTLE ,7,225,3,400,175,1,6.0
8849,5478.0,SCOTTIE DOG HOT WATER BOTTLE,2,100,0,100,0,1,0.0
8850,5479.0,SQUARECUSHION COVER PINK UNION FLAG,3,1406,14,1500,94,1,28.0
8851,5480.0,SPACEBOY CHILDRENS EGG CUP,2,100,0,100,0,1,0.0
8852,5481.0,CHILDREN'S SPACEBOY MUG,1,485,5,600,115,1,10.0
8853,5482.0,HAND WARMER SCOTTY DOG DESIGN,7,557,5,600,43,1,10.0
8854,5483.0,FELTCRAFT CUSHION OWL,4,273,7,800,527,1,14.0
8855,5484.0,BLACK CANDELABRA T-LIGHT HOLDER,8,331,5,600,269,1,10.0
8856,5485.0,TOY TIDY DOLLY GIRL DESIGN,9,406,5,600,194,1,10.0
8857,5486.0,SET 12 LAVENDER  BOTANICAL T-LIGHTS,1,122,3,400,278,1,6.0
8858,5487.0,UNION JACK FLAG LUGGAGE TAG,6,626,6,700,74,1,12.0
8859,5488.0,RED HEART LUGGAGE TAG,1,799,9,1000,201,1,18.0
8860,5489.0,RED GLASS TASSLE BAG CHARM,9,1078,20,2100,1022,1,40.0
8861,5490.0,CLEAR ACRYLIC FACETED BANGLE,2,160,10,1100,940,1,20.0
8862,5491.0,9 STRAND GLASS NECKLACE CRYSTAL,7,163,6,700,537,1,12.0
8863,5492.0,DOORMAT UNION JACK GUNS AND ROSES,9,1972,19,2000,28,1,38.0
8864,5493.0,VANILLA SCENT CANDLE JEWELLED BOX,3,246,18,1900,1654,1,36.0
8865,5494.0,FULL ENGLISH BREAKFAST PLATE,7,648,6,700,52,1,12.0
8866,5495.0,BLACK CANDELABRA T-LIGHT HOLDER,3,100,0,100,0,1,0.0
8867,5496.0,MAGIC DRAWING SLATE CIRCUS PARADE  ,9,619,21,2200,1581,1,42.0
8868,5497.0,CHRISTMAS HANGING HEART WITH BELL,5,357,21,2200,1843,1,42.0
8869,5498.0,CAKE STAND VICTORIAN FILIGREE MED,9,412,8,900,488,1,16.0
8870,5499.0,PAISLEY PATTERN  STICKERS,10,157,1,200,43,1,2.0
8871,5500.0,FLOWERS  STICKERS,9,320,15,1600,1280,1,30.0
8872,5501.0,PINK NEW BAROQUECANDLESTICK CANDLE,9,1212,16,1700,488,1,32.0
8873,5502.0,BLUE NEW BAROQUE CANDLESTICK CANDLE,1,746,8,900,154,1,16.0
8874,5503.0,JUMBO STORAGE BAG SUKI,7,2294,24,2500,206,1,48.0
8875,5504.0,BLACK LOVE BIRD CANDLE,5,784,11,1200,416,1,22.0
8876,5505.0,PARTY TIME PENCIL ERASERS,3,128,15,1600,1472,1,30.0
8877,5506.0,DISCO BALL CHRISTMAS DECORATION,8,1314,20,2100,786,1,40.0
8878,5507.0,PINK B'FLY C/COVER W BOBBLES,9,2122,24,2500,378,1,48.0
8879,5508.0,PINK UNION JACK  LUGGAGE TAG,8,1500,18,1900,400,1,36.0
8880,5509.0,10 RIBBONS ELEGANT CHRISTMAS ,2,1197,18,1900,703,1,36.0
8881,5510.0,UNION JACK FLAG LUGGAGE TAG,8,1048,17,1800,752,1,34.0
8882,5511.0,AGED GLASS SILVER T-LIGHT HOLDER,6,1144,14,1500,356,1,28.0
8883,5512.0,BOOM BOX SPEAKER GIRLS,10,920,9,1000,80,1,18.0
8884,5513.0,10 RIBBONS SHIMMERING PINKS ,7,135,3,400,265,1,6.0
8885,5514.0, SET 2 TEA TOWELS I LOVE LONDON ,8,256,3,400,144,1,6.0
8886,5515.0,JUMBO BAG OWLS,9,1159,20,2100,941,1,40.0
8887,5516.0,SANDWICH BATH SPONGE,6,810,11,1200,390,1,22.0
8888,5517.0,OWL DOORSTOP,5,1171,23,2400,1229,1,46.0
8889,5518.0,9 STRAND GLASS NECKLACE CRYSTAL,6,624,11,1200,576,1,22.0
8890,5519.0,HAND WARMER UNION JACK,7,1511,23,2400,889,1,46.0
8891,5520.0,HAND WARMER SCOTTY DOG DESIGN,2,856,12,1300,444,1,24.0
8892,5521.0,LARGE POPCORN HOLDER ,8,1575,21,2200,625,1,42.0
8893,5522.0,PAINTED METAL STAR WITH HOLLY BELLS,8,2406,24,2500,94,1,48.0
8894,5523.0,PAINTED METAL HEART WITH HOLLY BELL,10,963,14,1500,537,1,28.0
8895,5524.0,ANGEL DECORATION STARS ON DRESS,9,111,16,1700,1589,1,32.0
8896,5525.0,SMALL POPCORN HOLDER,6,859,19,2000,1141,1,38.0
8897,5526.0,JUMBO BAG RED RETROSPOT,2,1351,16,1700,349,1,32.0
8898,5527.0,JUMBO BAG STRAWBERRY,7,131,11,1200,1069,1,22.0
8899,5528.0,STRAWBERRY SHOPPER BAG,3,549,6,700,151,1,12.0
8900,5529.0,STRAWBERRY CHARLOTTE BAG,4,306,7,800,494,1,14.0
8901,5530.0, SET 2 TEA TOWELS I LOVE LONDON ,3,196,2,300,104,1,4.0
8902,5531.0,PACK OF 12 RED RETROSPOT TISSUES ,7,1064,21,2200,1136,1,42.0
8903,5532.0,SCOTTIE DOG HOT WATER BOTTLE,3,100,0,100,0,1,0.0
8904,5533.0,CHOCOLATE HOT WATER BOTTLE,2,247,3,400,153,1,6.0
8905,5534.0,LUNCH BAG CARS BLUE,7,992,9,1000,8,1,18.0
8906,5535.0,LUNCH BAG SPACEBOY DESIGN ,8,1723,21,2200,477,1,42.0
8907,5536.0,ROUND SNACK BOXES SET OF4 WOODLAND ,1,489,11,1200,711,1,22.0
8908,5537.0,LUNCH BAG DOLLY GIRL DESIGN,10,169,9,1000,831,1,18.0
8909,5538.0,LUNCH BAG SUKI  DESIGN ,2,758,12,1300,542,1,24.0
8910,5539.0,LUNCH BAG  BLACK SKULL.,10,2200,24,2500,300,1,48.0
8911,5540.0,ROUND SNACK BOXES SET OF 4 FRUITS ,10,132,9,1000,868,1,18.0
8912,5541.0,ROUND SNACK BOXES SET OF 4 SKULLS,4,122,2,300,178,1,4.0
8913,5542.0,DOLLY GIRL LUNCH BOX,1,1140,20,2100,960,1,40.0
8914,5543.0,SPACEBOY LUNCH BOX ,1,109,3,400,291,1,6.0
8915,5544.0,GREEN POLKADOT PLATE ,6,1028,13,1400,372,1,26.0
8916,5545.0,BLUE POLKADOT PLATE ,3,693,15,1600,907,1,30.0
8917,5546.0,RED RETROSPOT PLATE ,8,1952,22,2300,348,1,44.0
8918,5547.0,PINK  POLKADOT PLATE ,10,750,14,1500,750,1,28.0
8919,5548.0,ROUND SNACK BOXES SET OF 4 SKULLS,10,901,18,1900,999,1,36.0
8920,5549.0,FELTCRAFT DOLL MOLLY,2,555,13,1400,845,1,26.0
8921,5550.0,FELTCRAFT CHRISTMAS FAIRY,4,955,21,2200,1245,1,42.0
8922,5551.0,TRAVEL SEWING KIT,9,646,7,800,154,1,14.0
8923,5552.0,SET OF 3 NOTEBOOKS IN PARCEL,9,177,1,200,23,1,2.0
8924,5553.0,RED RETROSPOT TAPE,7,316,3,400,84,1,6.0
8925,5554.0,COSY SLIPPER SHOES SMALL  RED ,3,1453,19,2000,547,1,38.0
8926,5555.0,10 RIBBONS RUSTIC CHARM,3,948,10,1100,152,1,20.0
8927,5556.0,SCANDINAVIAN REDS RIBBONS,8,397,16,1700,1303,1,32.0
8928,5557.0,JAM MAKING SET PRINTED,3,379,13,1400,1021,1,26.0
8929,5558.0,16 DAISY PEGS IN WOOD BOX,4,481,4,500,19,1,8.0
8930,5559.0,HOT WATER BOTTLE BABUSHKA ,8,1491,22,2300,809,1,44.0
8931,5560.0,FELTCRAFT PRINCESS CHARLOTTE DOLL,9,814,15,1600,786,1,30.0
8932,5561.0,FELTCRAFT CHRISTMAS FAIRY,4,1431,16,1700,269,1,32.0
8933,5562.0,FELTCRAFT PRINCESS CHARLOTTE DOLL,5,265,5,600,335,1,10.0
8934,5563.0,10 RIBBONS RUSTIC CHARM,7,139,3,400,261,1,6.0
8935,5564.0,COSY SLIPPER SHOES SMALL  RED ,10,328,5,600,272,1,10.0
8936,5565.0,SCANDINAVIAN REDS RIBBONS,8,830,13,1400,570,1,26.0
8937,5566.0,9 HOOK HANGER RED MAGIC TOADSTOOL,2,337,6,700,363,1,12.0
8938,5567.0,CHRISTMAS CRAFT TREE TOP ANGEL,8,1152,20,2100,948,1,40.0
8939,5568.0,CHRISTMAS CRAFT LITTLE FRIENDS,9,100,0,100,0,1,0.0
8940,5569.0,9 HOOK HANGER RED MAGIC TOADSTOOL,8,394,4,500,106,1,8.0
8941,5570.0,10 RIBBONS RUSTIC CHARM,9,1285,19,2000,715,1,38.0
8942,5571.0,16 DAISY PEGS IN WOOD BOX,1,199,6,700,501,1,12.0
8943,5572.0,SET OF 3 NOTEBOOKS IN PARCEL,2,226,3,400,174,1,6.0
8944,5573.0,9 HOOK HANGER MAGIC TOADSTOOL,8,879,13,1400,521,1,26.0
8945,5574.0,SCANDINAVIAN REDS RIBBONS,2,111,1,200,89,1,2.0
8946,5575.0,RED TOADSTOOL LED NIGHT LIGHT,10,375,21,2200,1825,1,42.0
8947,5576.0,9 HOOK HANGER RED MAGIC TOADSTOOL,10,534,14,1500,966,1,28.0
8948,5577.0,COSY SLIPPER SHOES SMALL GREEN,4,1610,18,1900,290,1,36.0
8949,5578.0,COSY SLIPPER SHOES SMALL  RED ,2,214,19,2000,1786,1,38.0
8950,5579.0,FELTCRAFT DOLL ROSIE,9,1064,21,2200,1136,1,42.0
8951,5580.0,FELTCRAFT DOLL MOLLY,6,1581,18,1900,319,1,36.0
8952,5581.0,FELTCRAFT DOLL EMILY,5,589,15,1600,1011,1,30.0
8953,5582.0,FELTCRAFT PRINCESS CHARLOTTE DOLL,7,447,20,2100,1653,1,40.0
8954,5583.0,FELTCRAFT PRINCESS OLIVIA DOLL,4,855,9,1000,145,1,18.0
8955,5584.0,REX CASH+CARRY JUMBO SHOPPER,7,140,9,1000,860,1,18.0
8956,5585.0,FELTCRAFT DOLL MOLLY,9,637,6,700,63,1,12.0
8957,5586.0,FELTCRAFT CUSHION OWL,5,252,15,1600,1348,1,30.0
8958,5587.0,CHRISTMAS CRAFT TREE TOP ANGEL,4,1091,22,2300,1209,1,44.0
8959,5588.0,CHRISTMAS CRAFT LITTLE FRIENDS,7,1027,18,1900,873,1,36.0
8960,5589.0,FELTCRAFT CUSHION RABBIT,8,802,16,1700,898,1,32.0
8961,5590.0,FELTCRAFT CUSHION BUTTERFLY,6,170,2,300,130,1,4.0
8962,5591.0,16 DAISY PEGS IN WOOD BOX,9,1259,13,1400,141,1,26.0
8963,5592.0,PAPER CHAIN KIT 50'S CHRISTMAS ,1,100,0,100,0,1,0.0
8964,5593.0,FELTCRAFT CUSHION BUTTERFLY,3,661,6,700,39,1,12.0
8965,5594.0,16 DAISY PEGS IN WOOD BOX,10,1545,15,1600,55,1,30.0
8966,5595.0,ROSE COTTAGE KEEPSAKE BOX ,1,688,11,1200,512,1,22.0
8967,5596.0,TOTE BAG I LOVE LONDON,7,742,11,1200,458,1,22.0
8968,5597.0,16 DAISY PEGS IN WOOD BOX,8,1335,18,1900,565,1,36.0
8969,5598.0,TOTE BAG I LOVE LONDON,2,2030,24,2500,470,1,48.0
8970,5599.0,FOLDING UMBRELLA PINKWHITE POLKADOT,1,710,16,1700,990,1,32.0
8971,5600.0,FOLDING UMBRELLA CREAM POLKADOT,3,134,6,700,566,1,12.0
8972,5601.0,FOLDING UMBRELLA WHITE/RED POLKADOT,3,206,16,1700,1494,1,32.0
8973,5602.0,SET 10 LIGHTS NIGHT OWL,1,1054,16,1700,646,1,32.0
8974,5603.0,SMALL POPCORN HOLDER,1,126,2,300,174,1,4.0
8975,5604.0, SET 2 TEA TOWELS I LOVE LONDON ,9,286,2,300,14,1,4.0
8976,5605.0,FOLDING UMBRELLA RED/WHITE POLKADOT,7,1769,19,2000,231,1,38.0
8977,5606.0,BABUSHKA LIGHTS STRING OF 14,4,1406,16,1700,294,1,32.0
8978,5607.0,LUNCH BAG RED RETROSPOT,10,154,4,500,346,1,8.0
8979,5608.0,S/4 VALENTINE DECOUPAGE HEART BOX,6,195,1,200,5,1,2.0
8980,5609.0,FOLDING UMBRELLA CREAM POLKADOT,8,155,20,2100,1945,1,40.0
8981,5610.0, SET 2 TEA TOWELS I LOVE LONDON ,8,545,8,900,355,1,16.0
8982,5611.0,FOLDING UMBRELLA RED/WHITE POLKADOT,1,555,8,900,345,1,16.0
8983,5612.0,SOLDIERS EGG CUP ,3,702,8,900,198,1,16.0
8984,5613.0,S/4 VALENTINE DECOUPAGE HEART BOX,6,308,5,600,292,1,10.0
8985,5614.0,RED RETROSPOT MINI CASES,3,1023,11,1200,177,1,22.0
8986,5615.0,,5,233,4,500,267,1,8.0
8987,5616.0,64 CAKE CASES VINTAGE CHRISTMAS,5,763,14,1500,737,1,28.0
8988,5617.0,PAPER CHAIN KIT VINTAGE CHRISTMAS,4,149,19,2000,1851,1,38.0
8989,5618.0,RIBBON REEL CHRISTMAS SOCK BAUBLE,9,523,14,1500,977,1,28.0
8990,5619.0,RIBBON REEL SNOWY VILLAGE,2,653,13,1400,747,1,26.0
8991,5620.0,RIBBON REEL MAKING SNOWMEN ,9,1618,19,2000,382,1,38.0
8992,5621.0,SET OF 20 VINTAGE CHRISTMAS NAPKINS,1,1335,17,1800,465,1,34.0
8993,5622.0,TURQUOISE CHRISTMAS TREE ,2,2015,22,2300,285,1,44.0
8994,5623.0,RED STAR CARD HOLDER,9,165,18,1900,1735,1,36.0
8995,5624.0,WICKER WREATH SMALL,6,116,1,200,84,1,2.0
8996,5625.0,HEART OF WICKER LARGE,6,222,2,300,78,1,4.0
8997,5626.0,ADVENT CALENDAR GINGHAM SACK,5,1102,20,2100,998,1,40.0
8998,5627.0,HEART OF WICKER SMALL,2,1245,25,2600,1355,1,50.0
8999,5628.0,FELTCRAFT BUTTERFLY HEARTS,8,360,17,1800,1440,1,34.0
9000,5629.0,PARTY CONE CHRISTMAS DECORATION ,5,1751,22,2300,549,1,44.0
9001,5630.0,VINTAGE HEADS AND TAILS CARD GAME ,6,376,3,400,24,1,6.0
9002,5631.0,WICKER STAR ,8,1962,20,2100,138,1,40.0
9003,5632.0,VINTAGE SNAP CARDS,10,264,21,2200,1936,1,42.0
9004,5633.0,FELTCRAFT 6 FLOWER FRIENDS,3,1532,22,2300,768,1,44.0
9005,5634.0, SET 2 TEA TOWELS I LOVE LONDON ,9,222,2,300,78,1,4.0
9006,5635.0,JAM MAKING SET PRINTED,8,1448,19,2000,552,1,38.0
9007,5636.0,BIRD DECORATION RED RETROSPOT,5,589,11,1200,611,1,22.0
9008,5637.0,CHRISTMAS GINGHAM TREE,4,2442,25,2600,158,1,50.0
9009,5638.0,CHRISTMAS GINGHAM STAR,8,662,17,1800,1138,1,34.0
9010,5639.0,CHRISTMAS GINGHAM HEART,5,192,1,200,8,1,2.0
9011,5640.0,PACK OF 12 PINK POLKADOT TISSUES,3,878,19,2000,1122,1,38.0
9012,5641.0,FELTCRAFT PRINCESS LOLA DOLL,4,120,1,200,80,1,2.0
9013,5642.0,PACK OF 12 LONDON TISSUES ,1,554,5,600,46,1,10.0
9014,5643.0,PURPLE DRAWERKNOB ACRYLIC EDWARDIAN,1,533,6,700,167,1,12.0
9015,5644.0,CHILDREN'S APRON DOLLY GIRL ,4,685,15,1600,915,1,30.0
9016,5645.0,CHILDRENS APRON SPACEBOY DESIGN,9,994,17,1800,806,1,34.0
9017,5646.0,CHRISTMAS LIGHTS 10 SANTAS ,5,203,10,1100,897,1,20.0
9018,5647.0,CHRISTMAS LIGHTS 10 REINDEER,9,1050,14,1500,450,1,28.0
9019,5648.0,PAPER CHAIN KIT 50'S CHRISTMAS ,2,515,7,800,285,1,14.0
9020,5649.0,FELTCRAFT CHRISTMAS FAIRY,1,1204,23,2400,1196,1,46.0
9021,5650.0,PACK OF 72 RETROSPOT CAKE CASES,2,756,14,1500,744,1,28.0
9022,5651.0,PACK OF 60 MUSHROOM CAKE CASES,4,937,12,1300,363,1,24.0
9023,5652.0,64 CAKE CASES DOLLY GIRL DESIGN,10,1120,15,1600,480,1,30.0
9024,5653.0,PACK OF 60 PINK PAISLEY CAKE CASES,8,1462,15,1600,138,1,30.0
9025,5654.0,HAND WARMER BABUSHKA DESIGN,8,531,12,1300,769,1,24.0
9026,5655.0,HAND WARMER BIRD DESIGN,1,182,12,1300,1118,1,24.0
9027,5656.0,HAND WARMER OWL DESIGN,4,317,12,1300,983,1,24.0
9028,5657.0,HAND WARMER RED RETROSPOT,3,949,10,1100,151,1,20.0
9029,5658.0,SET 12 RETRO WHITE CHALK STICKS,9,145,4,500,355,1,8.0
9030,5659.0,FELTCRAFT HAIRBAND RED AND BLUE,2,282,2,300,18,1,4.0
9031,5660.0,FELTCRAFT HAIRBAND PINK AND PURPLE,10,412,9,1000,588,1,18.0
9032,5661.0,FELTCRAFT HAIRBANDS PINK AND WHITE ,3,422,9,1000,578,1,18.0
9033,5662.0,TV DINNER TRAY DOLLY GIRL,6,177,1,200,23,1,2.0
9034,5663.0,PLASTERS IN TIN VINTAGE PAISLEY ,4,100,0,100,0,1,0.0
9035,5664.0,PLASTERS IN TIN SPACEBOY,2,926,11,1200,274,1,22.0
9036,5665.0,PLASTERS IN TIN WOODLAND ANIMALS,8,570,25,2600,2030,1,50.0
9037,5666.0,MAGIC DRAWING SLATE SPACEBOY ,10,100,0,100,0,1,0.0
9038,5667.0,MAGIC DRAWING SLATE CIRCUS PARADE  ,4,849,13,1400,551,1,26.0
9039,5668.0,MAGIC DRAWING SLATE GO TO THE FAIR ,6,768,14,1500,732,1,28.0
9040,5669.0,MAGIC DRAWING SLATE DOLLY GIRL ,7,913,10,1100,187,1,20.0
9041,5670.0,CHARLIE + LOLA RED HOT WATER BOTTLE,9,602,25,2600,1998,1,50.0
9042,5671.0,HOT WATER BOTTLE BABUSHKA ,2,1837,19,2000,163,1,38.0
9043,5672.0,URBAN BLACK RIBBONS ,4,185,11,1200,1015,1,22.0
9044,5673.0,FELTCRAFT PRINCESS CHARLOTTE DOLL,9,1324,23,2400,1076,1,46.0
9045,5674.0,SET OF 6 T-LIGHTS TOADSTOOLS,2,615,9,1000,385,1,18.0
9046,5675.0,ROTATING LEAVES T-LIGHT HOLDER,9,218,22,2300,2082,1,44.0
9047,5676.0,RED  HARMONICA IN BOX ,5,522,23,2400,1878,1,46.0
9048,5677.0,CUPCAKE LACE PAPER SET 10,3,223,3,400,177,1,6.0
9049,5678.0,FAMILY PHOTO FRAME CORNICE,7,127,1,200,73,1,2.0
9050,5679.0,TRIPLE PHOTO FRAME CORNICE ,3,583,5,600,17,1,10.0
9051,5680.0,WOODEN FRAME ANTIQUE WHITE ,6,100,0,100,0,1,0.0
9052,5681.0,WOODEN BOX OF DOMINOES,4,1485,18,1900,415,1,36.0
9053,5682.0,TRADITIONAL WOODEN CATCH CUP GAME ,6,1671,18,1900,229,1,36.0
9054,5683.0,TRADITIONAL WOODEN SKIPPING ROPE,7,1935,19,2000,65,1,38.0
9055,5684.0,S/6 WOODEN SKITTLES IN COTTON BAG,1,1297,15,1600,303,1,30.0
9056,5685.0,RED METAL BEACH SPADE ,7,519,11,1200,681,1,22.0
9057,5686.0,BOYS VINTAGE TIN SEASIDE BUCKET,9,1649,20,2100,451,1,40.0
9058,5687.0,GIRLS VINTAGE TIN SEASIDE BUCKET,8,1623,18,1900,277,1,36.0
9059,5688.0,GREY HEART HOT WATER BOTTLE,10,309,10,1100,791,1,20.0
9060,5689.0,SCOTTIE DOG HOT WATER BOTTLE,1,262,6,700,438,1,12.0
9061,5690.0,BIRD HOUSE HOT WATER BOTTLE,2,655,9,1000,345,1,18.0
9062,5691.0,KINGS CHOICE TEA CADDY ,4,382,3,400,18,1,6.0
9063,5692.0,KINGS CHOICE BISCUIT TIN,8,119,2,300,181,1,4.0
9064,5693.0,METAL SIGN EMPIRE TEA,5,1177,19,2000,823,1,38.0
9065,5694.0,HOMEMADE JAM SCENTED CANDLES,5,1000,11,1200,200,1,22.0
9066,5695.0,SET OF 6 SOLDIER SKITTLES,2,456,10,1100,644,1,20.0
9067,5696.0,FAWN BLUE HOT WATER BOTTLE,1,2276,25,2600,324,1,50.0
9068,5697.0,HAND WARMER RED RETROSPOT,2,310,6,700,390,1,12.0
9069,5698.0,HOT WATER BOTTLE BABUSHKA ,6,1506,21,2200,694,1,42.0
9070,5699.0,WHITE SKULL HOT WATER BOTTLE ,4,222,22,2300,2078,1,44.0
9071,5700.0,RETROSPOT HEART HOT WATER BOTTLE,9,1222,22,2300,1078,1,44.0
9072,5701.0,RED WOOLLY HOTTIE WHITE HEART.,6,1067,13,1400,333,1,26.0
9073,5702.0,SCOTTIE DOG HOT WATER BOTTLE,9,1307,18,1900,593,1,36.0
9074,5703.0,GREY HEART HOT WATER BOTTLE,8,231,5,600,369,1,10.0
9075,5704.0,HOT WATER BOTTLE BABUSHKA ,8,1456,24,2500,1044,1,48.0
9076,5705.0,PACK OF 6 BIRDY GIFT TAGS,2,538,16,1700,1162,1,32.0
9077,5706.0,CHILLI LIGHTS,9,398,9,1000,602,1,18.0
9078,5707.0,PIGGY BANK RETROSPOT ,2,109,2,300,191,1,4.0
9079,5708.0,CERAMIC STRAWBERRY MONEY BOX,10,215,6,700,485,1,12.0
9080,5709.0,CERAMIC STRAWBERRY CAKE MONEY BANK,3,1003,20,2100,1097,1,40.0
9081,5710.0,CERAMIC CHERRY CAKE MONEY BANK,10,196,1,200,4,1,2.0
9082,5711.0,CERAMIC HEART FAIRY CAKE MONEY BANK,7,1413,21,2200,787,1,42.0
9083,5712.0,CERAMIC PIRATE CHEST MONEY BANK,10,2312,25,2600,288,1,50.0
9084,5713.0,DOORSTOP RETROSPOT HEART,5,170,1,200,30,1,2.0
9085,5714.0,GINGHAM HEART  DOORSTOP RED,3,275,7,800,525,1,14.0
9086,5715.0,RETROSPOT BABUSHKA DOORSTOP,9,445,7,800,355,1,14.0
9087,5716.0,SILK PURSE BABUSHKA RED,7,171,19,2000,1829,1,38.0
9088,5717.0,SILK PURSE BABUSHKA PINK,9,305,6,700,395,1,12.0
9089,5718.0,FAMILY PHOTO FRAME CORNICE,10,334,3,400,66,1,6.0
9090,5719.0,SWEETHEART WIRE WALL TIDY,4,872,22,2300,1428,1,44.0
9091,5720.0,JAM MAKING SET PRINTED,2,180,22,2300,2120,1,44.0
9092,5721.0,RED RETROSPOT OVEN GLOVE ,3,100,0,100,0,1,0.0
9093,5722.0,CREAM HEART CARD HOLDER,9,1285,16,1700,415,1,32.0
9094,5723.0,NAMASTE SWAGAT INCENSE,6,1426,18,1900,474,1,36.0
9095,5724.0,CERAMIC STRAWBERRY DESIGN MUG,1,698,14,1500,802,1,28.0
9096,5725.0,BLACK HEART CARD HOLDER,9,781,7,800,19,1,14.0
9097,5726.0,CLASSICAL ROSE SMALL VASE,2,859,8,900,41,1,16.0
9098,5727.0,HYACINTH BULB T-LIGHT CANDLES,10,871,22,2300,1429,1,44.0
9099,5728.0,CHRISTMAS CRAFT WHITE FAIRY ,10,1447,24,2500,1053,1,48.0
9100,5729.0,CHRISTMAS CRAFT LITTLE FRIENDS,9,1613,23,2400,787,1,46.0
9101,5730.0,COSY HOUR CIGAR BOX MATCHES ,1,1298,20,2100,802,1,40.0
9102,5731.0,RED TEA TOWEL CLASSIC DESIGN,5,1246,14,1500,254,1,28.0
9103,5732.0,HEART FILIGREE DOVE  SMALL,7,1591,15,1600,9,1,30.0
9104,5733.0,RETROSPOT CHILDRENS APRON,1,353,4,500,147,1,8.0
9105,5734.0,COLOURING PENCILS BROWN TUBE,8,204,3,400,196,1,6.0
9106,5735.0,8 IVORY DINNER CANDLES SILVER FLOCK,5,627,10,1100,473,1,20.0
9107,5736.0,HEART FILIGREE DOVE  SMALL,6,2081,25,2600,519,1,50.0
9108,5737.0,ZINC METAL HEART DECORATION,5,350,5,600,250,1,10.0
9109,5738.0,GREEN FERN NOTEBOOK,1,1736,23,2400,664,1,46.0
9110,5739.0,BLUE PAISLEY NOTEBOOK,5,218,17,1800,1582,1,34.0
9111,5740.0,CHRYSANTHEMUM NOTEBOOK,4,975,13,1400,425,1,26.0
9112,5741.0,LARGE CHINESE STYLE SCISSOR,5,286,14,1500,1214,1,28.0
9113,5742.0,SMALL CHINESE STYLE SCISSOR,10,426,13,1400,974,1,26.0
9114,5743.0,S/6 WOODEN SKITTLES IN COTTON BAG,3,537,5,600,63,1,10.0
9115,5744.0,TRADITIONAL WOODEN SKIPPING ROPE,6,184,2,300,116,1,4.0
9116,5745.0,SET OF 6 SOLDIER SKITTLES,6,2123,22,2300,177,1,44.0
9117,5746.0,8 TRADITIONAL SPINNING TOPS,2,535,18,1900,1365,1,36.0
9118,5747.0,ROTATING SILVER ANGELS T-LIGHT HLDR,5,385,7,800,415,1,14.0
9119,5748.0,BLACK LOVE BIRD CANDLE,4,851,10,1100,249,1,20.0
9120,5749.0,RETROSPOT CHILDRENS APRON,8,153,1,200,47,1,2.0
9121,5750.0,HANGING GLASS ETCHED TEALIGHT,8,169,22,2300,2131,1,44.0
9122,5751.0,HANGING GLASS ETCHED TEALIGHT,4,1704,24,2500,796,1,48.0
9123,5752.0,BLUE NEW BAROQUE CANDLESTICK CANDLE,1,156,12,1300,1144,1,24.0
9124,5753.0,COOKING SET RETROSPOT,5,1890,18,1900,10,1,36.0
9125,5754.0,KINGS CHOICE GIANT TUBE MATCHES,7,295,3,400,105,1,6.0
9126,5755.0,COSY HOUR GIANT TUBE MATCHES,2,572,12,1300,728,1,24.0
9127,5756.0,PLACE SETTING WHITE STAR,9,1236,14,1500,264,1,28.0
9128,5757.0,HYACINTH BULB T-LIGHT CANDLES,1,608,7,800,192,1,14.0
9129,5758.0,S/15 SILVER GLASS BAUBLES IN BAG,1,641,14,1500,859,1,28.0
9130,5759.0,FRENCH WC SIGN BLUE METAL,5,867,21,2200,1333,1,42.0
9131,5760.0,KINGS CHOICE GIANT TUBE MATCHES,5,1144,17,1800,656,1,34.0
9132,5761.0,76 SWEETHEART FAIRY CAKE CASES,3,804,23,2400,1596,1,46.0
9133,5762.0,ASSORTED COLOUR BIRD ORNAMENT,3,137,6,700,563,1,12.0
9134,5763.0,FAIRY SOAP SOAP HOLDER,9,1093,25,2600,1507,1,50.0
9135,5764.0,GREEN GIANT GARDEN THERMOMETER,5,1253,22,2300,1047,1,44.0
9136,5765.0,IVORY GIANT GARDEN THERMOMETER,8,873,15,1600,727,1,30.0
9137,5766.0,BLUE GIANT GARDEN THERMOMETER,5,641,12,1300,659,1,24.0
9138,5767.0,PACK OF 60 PINK PAISLEY CAKE CASES,10,1850,21,2200,350,1,42.0
9139,5768.0,RETROSPOT HEART HOT WATER BOTTLE,9,488,7,800,312,1,14.0
9140,5769.0,CHICK GREY HOT WATER BOTTLE,3,1710,17,1800,90,1,34.0
9141,5770.0,VICTORIAN SEWING BOX SMALL ,9,166,7,800,634,1,14.0
9142,5771.0,VICTORIAN SEWING BOX MEDIUM,3,495,12,1300,805,1,24.0
9143,5772.0,SET/10 RED POLKADOT PARTY CANDLES,10,1174,17,1800,626,1,34.0
9144,5773.0,WASHROOM METAL SIGN,1,723,20,2100,1377,1,40.0
9145,5774.0,BLACK SWEETHEART BRACELET,1,1575,18,1900,325,1,36.0
9146,5775.0,DIAMANTE HAIR GRIP PACK/2 BLACK DIA,10,526,6,700,174,1,12.0
9147,5776.0,BLACK DIAMANTE EXPANDABLE RING,6,947,18,1900,953,1,36.0
9148,5777.0,DIAMANTE HAIR GRIP PACK/2 RUBY,1,455,16,1700,1245,1,32.0
9149,5778.0,DIAMANTE HAIR GRIP PACK/2 MONTANA,6,1546,17,1800,254,1,34.0
9150,5779.0,BLUE SWEETHEART BRACELET,2,113,5,600,487,1,10.0
9151,5780.0,PINK SWEETHEART BRACELET,8,110,6,700,590,1,12.0
9152,5781.0,PURPLE SWEETHEART BRACELET,6,1352,21,2200,848,1,42.0
9153,5782.0,JUMBO BAG PINK POLKADOT,6,190,11,1200,1010,1,22.0
9154,5783.0,JUMBO BAG RED RETROSPOT,7,1125,13,1400,275,1,26.0
9155,5784.0,ASSORTED COLOUR BIRD ORNAMENT,3,530,6,700,170,1,12.0
9156,5785.0,PAPER CHAIN KIT 50'S CHRISTMAS ,5,1055,14,1500,445,1,28.0
9157,5786.0,RIBBON REEL CHRISTMAS PRESENT ,4,170,2,300,130,1,4.0
9158,5787.0,FIRST AID TIN,2,113,2,300,187,1,4.0
9159,5788.0,MAKE YOUR OWN MONSOON CARD KIT,7,782,10,1100,318,1,20.0
9160,5789.0,PACK OF 12 HEARTS DESIGN TISSUES ,8,764,24,2500,1736,1,48.0
9161,5790.0,PACK OF 12 RED RETROSPOT TISSUES ,3,984,18,1900,916,1,36.0
9162,5791.0,SOLDIERS EGG CUP ,4,1817,18,1900,83,1,36.0
9163,5792.0,HEART IVORY TRELLIS SMALL,9,153,3,400,247,1,6.0
9164,5793.0,HEART FILIGREE DOVE  SMALL,3,1091,16,1700,609,1,32.0
9165,5794.0,HEART FILIGREE DOVE LARGE,6,303,9,1000,697,1,18.0
9166,5795.0,PACK 3 BOXES BIRD PANNETONE ,10,637,19,2000,1363,1,38.0
9167,5796.0,PACK 3 BOXES CHRISTMAS PANNETONE,2,1281,17,1800,519,1,34.0
9168,5797.0,SMALL POPCORN HOLDER,3,151,13,1400,1249,1,26.0
9169,5798.0,PACK OF 60 PINK PAISLEY CAKE CASES,10,980,11,1200,220,1,22.0
9170,5799.0,SET OF 6 SOLDIER SKITTLES,8,960,11,1200,240,1,22.0
9171,5800.0,SWIRLY CIRCULAR RUBBERS IN BAG,2,1100,22,2300,1200,1,44.0
9172,5801.0,VINTAGE PAISLEY STATIONERY SET,10,531,7,800,269,1,14.0
9173,5802.0,PAPER CHAIN KIT VINTAGE CHRISTMAS,7,1094,20,2100,1006,1,40.0
9174,5803.0,SET/10 BLUE POLKADOT PARTY CANDLES,4,1306,14,1500,194,1,28.0
9175,5804.0,RIBBON REEL SOCKS AND MITTENS,10,177,1,200,23,1,2.0
9176,5805.0,64 CAKE CASES VINTAGE CHRISTMAS,2,735,13,1400,665,1,26.0
9177,5806.0,CHRISTMAS METAL TAGS ASSORTED ,5,663,9,1000,337,1,18.0
9178,5807.0,CHRISTMAS TREE T-LIGHT HOLDER,2,430,17,1800,1370,1,34.0
9179,5808.0,STAR  T-LIGHT HOLDER ,6,158,1,200,42,1,2.0
9180,5809.0,HEART T-LIGHT HOLDER ,5,334,25,2600,2266,1,50.0
9181,5810.0,MINI FUNKY DESIGN TAPES,8,132,9,1000,868,1,18.0
9182,5811.0,SET OF 6 T-LIGHTS SNOWMEN,10,558,6,700,142,1,12.0
9183,5812.0,STAR WOODEN CHRISTMAS DECORATION,3,515,21,2200,1685,1,42.0
9184,5813.0,WOODEN HEART CHRISTMAS SCANDINAVIAN,8,1323,25,2600,1277,1,50.0
9185,5814.0,CHRISTMAS RETROSPOT TREE WOOD,10,922,15,1600,678,1,30.0
9186,5815.0,SET OF 6 T-LIGHTS SANTA,4,135,1,200,65,1,2.0
9187,5816.0,SET/9 CHRISTMAS T-LIGHTS SCENTED ,6,118,1,200,82,1,2.0
9188,5817.0,BLUE ROSE FABRIC MIRROR,5,364,5,600,236,1,10.0
9189,5818.0,THREE CANVAS LUGGAGE TAGS,9,750,19,2000,1250,1,38.0
9190,5819.0,RETROSPOT PARTY BAG + STICKER SET,7,199,5,600,401,1,10.0
9191,5820.0,PLASTERS IN TIN VINTAGE PAISLEY ,10,1839,20,2100,261,1,40.0
9192,5821.0,RETROSPOT SMALL TUBE MATCHES,7,533,8,900,367,1,16.0
9193,5822.0,HAND WARMER SCOTTY DOG DESIGN,2,464,9,1000,536,1,18.0
9194,5823.0,3D CHRISTMAS STAMPS STICKERS ,4,1565,24,2500,935,1,48.0
9195,5824.0,HAND WARMER SCOTTY DOG DESIGN,2,447,8,900,453,1,16.0
9196,5825.0,HAND WARMER SCOTTY DOG DESIGN,2,828,8,900,72,1,16.0
9197,5826.0,CLOTHES PEGS RETROSPOT PACK 28,5,590,18,1900,1310,1,36.0
9198,5827.0,40 FOIL HEART CAKE CASES,1,510,17,1800,1290,1,34.0
9199,5828.0,CHRISTMAS METAL TAGS ASSORTED ,8,1754,21,2200,446,1,42.0
9200,5829.0,PACK OF 6 SWEETIE GIFT BOXES,3,1550,19,2000,450,1,38.0
9201,5830.0,PACK OF 72 RETROSPOT CAKE CASES,1,998,9,1000,2,1,18.0
9202,5831.0,PACK OF 72 RETROSPOT CAKE CASES,5,939,14,1500,561,1,28.0
9203,5832.0,PACK OF 6 BIRDY GIFT TAGS,7,497,4,500,3,1,8.0
9204,5833.0,SET/10 RED POLKADOT PARTY CANDLES,10,692,8,900,208,1,16.0
9205,5834.0,SET/10 PINK POLKADOT PARTY CANDLES,7,109,4,500,391,1,8.0
9206,5835.0,SET OF 3 NOTEBOOKS IN PARCEL,7,833,9,1000,167,1,18.0
9207,5836.0,STAR  T-LIGHT HOLDER ,6,786,24,2500,1714,1,48.0
9208,5837.0,CINAMMON SET OF 9 T-LIGHTS,2,803,24,2500,1697,1,48.0
9209,5838.0,ORANGE SCENTED SET/9 T-LIGHTS,3,100,0,100,0,1,0.0
9210,5839.0,RIBBON REEL STRIPES DESIGN ,7,1999,25,2600,601,1,50.0
9211,5840.0,SET OF 2 TINS JARDIN DE PROVENCE,1,112,11,1200,1088,1,22.0
9212,5841.0,MAKE YOUR OWN PLAYTIME CARD KIT,6,1406,14,1500,94,1,28.0
9213,5842.0,DINOSAURS  WRITING SET ,4,1220,15,1600,380,1,30.0
9214,5843.0,BALLOONS  WRITING SET ,6,120,1,200,80,1,2.0
9215,5844.0,SKULLS WRITING SET ,6,221,6,700,479,1,12.0
9216,5845.0,VINTAGE PAISLEY STATIONERY SET,10,756,10,1100,344,1,20.0
9217,5846.0,COSY SLIPPER SHOES SMALL  RED ,5,2592,25,2600,8,1,50.0
9218,5847.0,DOORMAT BLACK FLOCK ,6,2466,24,2500,34,1,48.0
9219,5848.0,JUMBO  BAG BAROQUE BLACK WHITE,8,937,12,1300,363,1,24.0
9220,5849.0,JAM MAKING SET WITH JARS,7,289,22,2300,2011,1,44.0
9221,5850.0,ORANGE SCENTED SET/9 T-LIGHTS,2,1174,11,1200,26,1,22.0
9222,5851.0,CINAMMON SET OF 9 T-LIGHTS,5,100,0,100,0,1,0.0
9223,5852.0,HAND WARMER SCOTTY DOG DESIGN,9,423,14,1500,1077,1,28.0
9224,5853.0,CHRISTMAS DECOUPAGE CANDLE,7,1642,17,1800,158,1,34.0
9225,5854.0,HEART T-LIGHT HOLDER ,7,132,19,2000,1868,1,38.0
9226,5855.0,GROW YOUR OWN BASIL IN ENAMEL MUG,1,1464,22,2300,836,1,44.0
9227,5856.0,OFFICE MUG WARMER POLKADOT,8,1030,14,1500,470,1,28.0
9228,5857.0,SMALL POPCORN HOLDER,8,689,14,1500,811,1,28.0
9229,5858.0,JUMBO BAG DOLLY GIRL DESIGN,8,536,23,2400,1864,1,46.0
9230,5859.0,JAM MAKING SET WITH JARS,9,951,16,1700,749,1,32.0
9231,5860.0,JAM MAKING SET PRINTED,4,534,15,1600,1066,1,30.0
9232,5861.0,SMALL GLASS HEART TRINKET POT,3,551,25,2600,2049,1,50.0
9233,5862.0,RED WOOLLY HOTTIE WHITE HEART.,6,344,23,2400,2056,1,46.0
9234,5863.0,BLACK RECORD COVER FRAME,4,1872,25,2600,728,1,50.0
9235,5864.0,"RECORD FRAME 7"" SINGLE SIZE ",10,1938,23,2400,462,1,46.0
9236,5865.0,40 PENCILS TUBE RED RETROSPOT,10,259,7,800,541,1,14.0
9237,5866.0,40 PENCILS TUBE WOODLAND,8,166,1,200,34,1,2.0
9238,5867.0,SET OF 6 SOLDIER SKITTLES,1,257,21,2200,1943,1,42.0
9239,5868.0,ROCKING HORSE RED CHRISTMAS ,10,1056,21,2200,1144,1,42.0
9240,5869.0,CHRISTMAS GINGHAM HEART,4,768,15,1600,832,1,30.0
9241,5870.0,CHRISTMAS GINGHAM STAR,7,743,16,1700,957,1,32.0
9242,5871.0,HAND WARMER UNION JACK,9,1879,20,2100,221,1,40.0
9243,5872.0,HAND WARMER RED RETROSPOT,10,1464,14,1500,36,1,28.0
9244,5873.0,REGENCY CAKESTAND 3 TIER,7,190,9,1000,810,1,18.0
9245,5874.0,JUMBO SHOPPER VINTAGE RED PAISLEY,6,100,0,100,0,1,0.0
9246,5875.0,RIBBON REEL SNOWY VILLAGE,6,836,13,1400,564,1,26.0
9247,5876.0,VINTAGE UNION JACK BUNTING,7,169,14,1500,1331,1,28.0
9248,5877.0,JAM MAKING SET WITH JARS,1,357,5,600,243,1,10.0
9249,5878.0,RIBBON REEL STRIPES DESIGN ,2,138,4,500,362,1,8.0
9250,5879.0,RETRO LONGBOARD IRONING BOARD COVER,4,197,1,200,3,1,2.0
9251,5880.0,3D DOG PICTURE PLAYING CARDS,8,190,12,1300,1110,1,24.0
9252,5881.0,RETROSPOT CIGAR BOX MATCHES ,10,419,5,600,181,1,10.0
9253,5882.0,SET/9 CHRISTMAS T-LIGHTS SCENTED ,4,120,2,300,180,1,4.0
9254,5883.0,ROTATING SILVER ANGELS T-LIGHT HLDR,2,219,7,800,581,1,14.0
9255,5884.0,ROTATING SILVER ANGELS T-LIGHT HLDR,6,1143,22,2300,1157,1,44.0
9256,5885.0,SAVE THE PLANET COTTON TOTE BAG,8,234,10,1100,866,1,20.0
9257,5886.0,SET OF 20 VINTAGE CHRISTMAS NAPKINS,4,283,6,700,417,1,12.0
9258,5887.0,PAPER BUNTING WHITE LACE,7,681,16,1700,1019,1,32.0
9259,5888.0,GENTLEMAN SHIRT REPAIR KIT ,8,675,10,1100,425,1,20.0
9260,5889.0,CARD I LOVE LONDON ,4,653,15,1600,947,1,30.0
9261,5890.0,PAPER CHAIN KIT VINTAGE CHRISTMAS,5,488,22,2300,1812,1,44.0
9262,5891.0,MIRRORED WALL ART FOXY,3,1001,25,2600,1599,1,50.0
9263,5892.0,MIRRORED WALL ART GENTS,7,1218,15,1600,382,1,30.0
9264,5893.0,AIRLINE BAG VINTAGE JET SET WHITE,7,1061,20,2100,1039,1,40.0
9265,5894.0,JAM MAKING SET PRINTED,6,1362,16,1700,338,1,32.0
9266,5895.0,POTTING SHED SOW 'N' GROW SET,3,205,3,400,195,1,6.0
9267,5896.0,BABUSHKA LIGHTS STRING OF 14,10,155,16,1700,1545,1,32.0
9268,5897.0,REX CASH+CARRY JUMBO SHOPPER,5,801,19,2000,1199,1,38.0
9269,5898.0,AIRLINE BAG VINTAGE WORLD CHAMPION ,2,679,12,1300,621,1,24.0
9270,5899.0,HAND WARMER BIRD DESIGN,8,285,4,500,215,1,8.0
9271,5900.0,CHRISTMAS CRAFT LITTLE FRIENDS,10,1245,12,1300,55,1,24.0
9272,5901.0,PINK HEARTS PAPER GARLAND,10,761,8,900,139,1,16.0
9273,5902.0,POTTING SHED SEED ENVELOPES,6,923,22,2300,1377,1,44.0
9274,5903.0,HI TEC ALPINE HAND WARMER,6,1019,24,2500,1481,1,48.0
9275,5904.0,FELTCRAFT CHRISTMAS FAIRY,3,192,14,1500,1308,1,28.0
9276,5905.0,HI TEC ALPINE HAND WARMER,4,635,21,2200,1565,1,42.0
9277,5906.0,ROTATING SILVER ANGELS T-LIGHT HLDR,6,973,20,2100,1127,1,40.0
9278,5907.0,7 STRIPEY MICE FELTCRAFT,3,451,19,2000,1549,1,38.0
9279,5908.0,FELTCRAFT 6 FLOWER FRIENDS,2,561,9,1000,439,1,18.0
9280,5909.0,CHRISTMAS CRAFT LITTLE FRIENDS,2,804,8,900,96,1,16.0
9281,5910.0,VINTAGE UNION JACK CUSHION COVER,3,837,15,1600,763,1,30.0
9282,5911.0,POLYESTER FILLER PAD 45x45cm,9,460,6,700,240,1,12.0
9283,5912.0,DOLLY GIRL LUNCH BOX,10,576,11,1200,624,1,22.0
9284,5913.0,PACK OF 12 LONDON TISSUES ,1,320,4,500,180,1,8.0
9285,5914.0,CARD DOLLY GIRL ,9,1675,20,2100,425,1,40.0
9286,5915.0,CARD BILLBOARD FONT,10,500,13,1400,900,1,26.0
9287,5916.0,RAINY LADIES BIRTHDAY CARD,8,451,4,500,49,1,8.0
9288,5917.0,GREY HEART HOT WATER BOTTLE,8,898,15,1600,702,1,30.0
9289,5918.0,RED WOOLLY HOTTIE WHITE HEART.,2,189,1,200,11,1,2.0
9290,5919.0,RED WHITE SCARF  HOT WATER BOTTLE,1,1261,23,2400,1139,1,46.0
9291,5920.0, SET 2 TEA TOWELS I LOVE LONDON ,1,722,7,800,78,1,14.0
9292,5921.0,SET OF 2 TEA TOWELS APPLE AND PEARS,4,1022,15,1600,578,1,30.0
9293,5922.0,SET/2 RED RETROSPOT TEA TOWELS ,8,327,4,500,173,1,8.0
9294,5923.0,LOVE BUILDING BLOCK WORD,8,270,16,1700,1430,1,32.0
9295,5924.0,HOME BUILDING BLOCK WORD,2,861,8,900,39,1,16.0
9296,5925.0,ASSORTED COLOUR BIRD ORNAMENT,1,1718,21,2200,482,1,42.0
9297,5926.0,LANTERN CREAM GAZEBO ,9,2069,23,2400,331,1,46.0
9298,5927.0,BLUE BIRDHOUSE DECORATION,3,800,17,1800,1000,1,34.0
9299,5928.0,WHITE HANGING HEART T-LIGHT HOLDER,7,831,8,900,69,1,16.0
9300,5929.0,REGENCY CAKESTAND 3 TIER,2,1447,22,2300,853,1,44.0
9301,5930.0,ANTIQUE SILVER TEA GLASS ENGRAVED,2,512,12,1300,788,1,24.0
9302,5931.0,AGED GLASS SILVER T-LIGHT HOLDER,2,571,6,700,129,1,12.0
9303,5932.0,JAM MAKING SET WITH JARS,2,210,22,2300,2090,1,44.0
9304,5933.0,HAND WARMER OWL DESIGN,9,434,13,1400,966,1,26.0
9305,5934.0,SET OF 2 WOODEN MARKET CRATES,1,2567,25,2600,33,1,50.0
9306,5935.0,SET OF 6 T-LIGHTS TOADSTOOLS,3,231,17,1800,1569,1,34.0
9307,5936.0,HAND WARMER UNION JACK,5,1486,24,2500,1014,1,48.0
9308,5937.0,HAND WARMER SCOTTY DOG DESIGN,8,123,2,300,177,1,4.0
9309,5938.0,CLASSIC FRENCH STYLE BASKET NATURAL,6,213,11,1200,987,1,22.0
9310,5939.0,CRAZY DAISY HEART DECORATION,4,988,25,2600,1612,1,50.0
9311,5940.0,GIN + TONIC DIET METAL SIGN,10,1431,14,1500,69,1,28.0
9312,5941.0,IVORY GIANT GARDEN THERMOMETER,2,339,5,600,261,1,10.0
9313,5942.0,CARD HOLDER GINGHAM HEART,5,100,0,100,0,1,0.0
9314,5943.0,SMALL STRIPES CHOCOLATE GIFT BAG ,2,239,5,600,361,1,10.0
9315,5944.0,S/6 WOODEN SKITTLES IN COTTON BAG,6,163,20,2100,1937,1,40.0
9316,5945.0,HAND WARMER RED RETROSPOT,1,1442,17,1800,358,1,34.0
9317,5946.0,HAND WARMER UNION JACK,1,840,10,1100,260,1,20.0
9318,5947.0,FRENCH WC SIGN BLUE METAL,5,1309,13,1400,91,1,26.0
9319,5948.0,PINK UNION JACK  LUGGAGE TAG,1,372,13,1400,1028,1,26.0
9320,5949.0,"TRAY, BREAKFAST IN BED",8,784,20,2100,1316,1,40.0
9321,5950.0,PIZZA PLATE IN BOX,5,1482,22,2300,818,1,44.0
9322,5951.0,HEART OF WICKER LARGE,2,1226,14,1500,274,1,28.0
9323,5952.0,PINK HEART DOTS HOT WATER BOTTLE,3,289,2,300,11,1,4.0
9324,5953.0,PLACE SETTING WHITE HEART,8,344,18,1900,1556,1,36.0
9325,5954.0,SET OF 4 NAPKIN CHARMS LEAVES   ,10,801,13,1400,599,1,26.0
9326,5955.0,SET OF 4 NAPKIN CHARMS STARS   ,10,373,11,1200,827,1,22.0
9327,5956.0,SET OF 4 NAPKIN CHARMS CUTLERY,4,201,15,1600,1399,1,30.0
9328,5957.0,CARAVAN SQUARE TISSUE BOX,3,883,8,900,17,1,16.0
9329,5958.0,PLASTERS IN TIN SKULLS,9,700,16,1700,1000,1,32.0
9330,5959.0,PLASTERS IN TIN SPACEBOY,1,1957,24,2500,543,1,48.0
9331,5960.0,BUTTON BOX ,1,956,13,1400,444,1,26.0
9332,5961.0,PLASTERS IN TIN VINTAGE PAISLEY ,4,140,15,1600,1460,1,30.0
9333,5962.0,16 MESSAGE CARDS WITH ENVELOPES,4,1866,22,2300,434,1,44.0
9334,5963.0,SMALL RED BABUSHKA NOTEBOOK ,6,2116,21,2200,84,1,42.0
9335,5964.0,CUPCAKE LACE PAPER SET 10,2,749,16,1700,951,1,32.0
9336,5965.0,PACK 3 BOXES CHRISTMAS PANNETONE,8,1718,19,2000,282,1,38.0
9337,5966.0,HERB MARKER MINT,5,735,24,2500,1765,1,48.0
9338,5967.0,HERB MARKER ROSEMARY,4,2255,25,2600,345,1,50.0
9339,5968.0,HERB MARKER BASIL,9,743,8,900,157,1,16.0
9340,5969.0,HERB MARKER CHIVES ,4,1548,15,1600,52,1,30.0
9341,5970.0,HERB MARKER PARSLEY,5,2043,21,2200,157,1,42.0
9342,5971.0,HERB MARKER THYME,5,168,5,600,432,1,10.0
9343,5972.0,WHITE HANGING HEART T-LIGHT HOLDER,2,499,17,1800,1301,1,34.0
9344,5973.0,METAL MERRY CHRISTMAS WREATH,4,864,12,1300,436,1,24.0
9345,5974.0,WHITE CHRISTMAS GARLAND STARS TREES,2,858,9,1000,142,1,18.0
9346,5975.0,RETROSPOT SMALL TUBE MATCHES,10,301,7,800,499,1,14.0
9347,5976.0,RETROSPOT GIANT TUBE MATCHES,7,516,11,1200,684,1,22.0
9348,5977.0,PLACE SETTING WHITE STAR,1,1262,25,2600,1338,1,50.0
9349,5978.0,GROW YOUR OWN BASIL IN ENAMEL MUG,5,783,7,800,17,1,14.0
9350,5979.0,40 FOIL STAR CAKE CASES ,6,2165,25,2600,435,1,50.0
9351,5980.0,40 FOIL HEART CAKE CASES,8,1382,24,2500,1118,1,48.0
9352,5981.0,PACK OF 6 SWEETIE GIFT BOXES,7,263,14,1500,1237,1,28.0
9353,5982.0,PACK OF 6 HANDBAG GIFT BOXES,1,187,4,500,313,1,8.0
9354,5983.0,GARLAND WOODEN HAPPY EASTER,9,1952,21,2200,248,1,42.0
9355,5984.0,CALENDAR PAPER CUT DESIGN,2,1311,16,1700,389,1,32.0
9356,5985.0,CALENDAR IN SEASON DESIGN,2,1061,14,1500,439,1,28.0
9357,5986.0,SMALL POPCORN HOLDER,3,183,2,300,117,1,4.0
9358,5987.0,BLUE PAISLEY TISSUE BOX,9,421,10,1100,679,1,20.0
9359,5988.0,HEART OF WICKER SMALL,6,650,15,1600,950,1,30.0
9360,5989.0,SKULLS SQUARE TISSUE BOX,2,523,5,600,77,1,10.0
9361,5990.0,SKULLS SQUARE TISSUE BOX,5,1228,19,2000,772,1,38.0
9362,5991.0,WHITE HANGING HEART T-LIGHT HOLDER,1,622,24,2500,1878,1,48.0
9363,5992.0,WHITE METAL LANTERN,4,767,8,900,133,1,16.0
9364,5993.0,CREAM CUPID HEARTS COAT HANGER,9,1551,21,2200,649,1,42.0
9365,5994.0,KNITTED UNION FLAG HOT WATER BOTTLE,9,1345,24,2500,1155,1,48.0
9366,5995.0,RED WOOLLY HOTTIE WHITE HEART.,3,311,3,400,89,1,6.0
9367,5996.0,SET 7 BABUSHKA NESTING BOXES,3,702,18,1900,1198,1,36.0
9368,5997.0,GLASS STAR FROSTED T-LIGHT HOLDER,10,1480,20,2100,620,1,40.0
9369,5998.0,HAND WARMER UNION JACK,1,1556,24,2500,944,1,48.0
9370,5999.0,HAND WARMER RED POLKA DOT,10,231,2,300,69,1,4.0
9371,6000.0,ASSORTED COLOUR BIRD ORNAMENT,8,794,15,1600,806,1,30.0
9372,6001.0,POPPY'S PLAYHOUSE BEDROOM ,2,726,15,1600,874,1,30.0
9373,6002.0,POPPY'S PLAYHOUSE KITCHEN,7,173,3,400,227,1,6.0
9374,6003.0,FELTCRAFT PRINCESS CHARLOTTE DOLL,10,1721,24,2500,779,1,48.0
9375,6004.0,IVORY KNITTED MUG COSY ,10,1687,17,1800,113,1,34.0
9376,6005.0,BOX OF 6 ASSORTED COLOUR TEASPOONS,4,245,13,1400,1155,1,26.0
9377,6006.0,BOX OF VINTAGE JIGSAW BLOCKS ,10,354,10,1100,746,1,20.0
9378,6007.0,BOX OF VINTAGE ALPHABET BLOCKS,3,1198,15,1600,402,1,30.0
9379,6008.0,HOME BUILDING BLOCK WORD,10,315,5,600,285,1,10.0
9380,6009.0,LOVE BUILDING BLOCK WORD,5,199,11,1200,1001,1,22.0
9381,6010.0,RECIPE BOX WITH METAL HEART,4,2194,24,2500,306,1,48.0
9382,6011.0,DOORMAT NEW ENGLAND,10,823,14,1500,677,1,28.0
9383,6012.0,JAM MAKING SET WITH JARS,3,669,22,2300,1631,1,44.0
9384,6013.0,RED COAT RACK PARIS FASHION,1,928,14,1500,572,1,28.0
9385,6014.0,YELLOW COAT RACK PARIS FASHION,6,180,6,700,520,1,12.0
9386,6015.0,BLUE COAT RACK PARIS FASHION,3,1539,22,2300,761,1,44.0
9387,6016.0,BATH BUILDING BLOCK WORD,4,174,8,900,726,1,16.0
9388,6017.0,ALARM CLOCK BAKELIKE PINK,2,533,19,2000,1467,1,38.0
9389,6018.0,ALARM CLOCK BAKELIKE RED ,1,167,4,500,333,1,8.0
9390,6019.0,ALARM CLOCK BAKELIKE GREEN,6,400,9,1000,600,1,18.0
9391,6020.0,PANDA AND BUNNIES STICKER SHEET,8,1945,19,2000,55,1,38.0
9392,6021.0,STARS GIFT TAPE ,10,1113,25,2600,1487,1,50.0
9393,6022.0,INFLATABLE POLITICAL GLOBE ,1,1281,16,1700,419,1,32.0
9394,6023.0,VINTAGE HEADS AND TAILS CARD GAME ,1,100,0,100,0,1,0.0
9395,6024.0,SET/2 RED RETROSPOT TEA TOWELS ,5,1054,25,2600,1546,1,50.0
9396,6025.0,ROUND SNACK BOXES SET OF4 WOODLAND ,7,1159,12,1300,141,1,24.0
9397,6026.0,SPACEBOY LUNCH BOX ,1,1276,14,1500,224,1,28.0
9398,6027.0,LUNCH BOX I LOVE LONDON,4,168,2,300,132,1,4.0
9399,6028.0,CIRCUS PARADE LUNCH BOX ,5,1731,24,2500,769,1,48.0
9400,6029.0,CHARLOTTE BAG DOLLY GIRL DESIGN,5,363,23,2400,2037,1,46.0
9401,6030.0,RED TOADSTOOL LED NIGHT LIGHT,7,507,11,1200,693,1,22.0
9402,6031.0, SET 2 TEA TOWELS I LOVE LONDON ,5,220,16,1700,1480,1,32.0
9403,6032.0,VINTAGE SEASIDE JIGSAW PUZZLES,1,914,10,1100,186,1,20.0
9404,6033.0,MINI JIGSAW CIRCUS PARADE ,4,1852,25,2600,748,1,50.0
9405,6034.0,MINI JIGSAW SPACEBOY,5,952,11,1200,248,1,22.0
9406,6035.0,MINI PAINT SET VINTAGE ,4,227,23,2400,2173,1,46.0
9407,6036.0,POSTAGE,8,1208,14,1500,292,1,28.0
9408,6037.0,PAPER CHAIN KIT 50'S CHRISTMAS ,5,1724,20,2100,376,1,40.0
9409,6038.0,HAND WARMER RED POLKA DOT,2,472,8,900,428,1,16.0
9410,6039.0,HAND WARMER UNION JACK,4,1523,16,1700,177,1,32.0
9411,6040.0,WHITE HANGING HEART T-LIGHT HOLDER,1,1528,15,1600,72,1,30.0
9412,6041.0,WHITE METAL LANTERN,8,1616,24,2500,884,1,48.0
9413,6042.0,CREAM CUPID HEARTS COAT HANGER,6,151,3,400,249,1,6.0
9414,6043.0,EDWARDIAN PARASOL RED,4,727,12,1300,573,1,24.0
9415,6044.0,RETRO COFFEE MUGS ASSORTED,4,928,12,1300,372,1,24.0
9416,6045.0,SAVE THE PLANET MUG,5,977,22,2300,1323,1,44.0
9417,6046.0,VINTAGE BILLBOARD DRINK ME MUG,9,1232,14,1500,268,1,28.0
9418,6047.0,VINTAGE BILLBOARD LOVE/HATE MUG,1,1274,17,1800,526,1,34.0
9419,6048.0,WOOD 2 DRAWER CABINET WHITE FINISH,9,992,23,2400,1408,1,46.0
9420,6049.0,WOOD S/3 CABINET ANT WHITE FINISH,6,103,3,400,297,1,6.0
9421,6050.0,WOODEN PICTURE FRAME WHITE FINISH,6,447,23,2400,1953,1,46.0
9422,6051.0,WOODEN FRAME ANTIQUE WHITE ,6,1078,14,1500,422,1,28.0
9423,6052.0,KNITTED UNION FLAG HOT WATER BOTTLE,7,100,0,100,0,1,0.0
9424,6053.0,RED WOOLLY HOTTIE WHITE HEART.,2,576,6,700,124,1,12.0
9425,6054.0,SET 7 BABUSHKA NESTING BOXES,3,254,6,700,446,1,12.0
9426,6055.0,GLASS STAR FROSTED T-LIGHT HOLDER,7,1964,24,2500,536,1,48.0
9427,6056.0,VICTORIAN SEWING BOX LARGE,9,100,0,100,0,1,0.0
9428,6057.0,WHITE HANGING HEART T-LIGHT HOLDER,9,103,2,300,197,1,4.0
9429,6058.0,WHITE METAL LANTERN,9,645,10,1100,455,1,20.0
9430,6059.0,CREAM CUPID HEARTS COAT HANGER,6,475,17,1800,1325,1,34.0
9431,6060.0,EDWARDIAN PARASOL RED,3,386,10,1100,714,1,20.0
9432,6061.0,RETRO COFFEE MUGS ASSORTED,3,1182,19,2000,818,1,38.0
9433,6062.0,SAVE THE PLANET MUG,10,1967,22,2300,333,1,44.0
9434,6063.0,VINTAGE BILLBOARD DRINK ME MUG,4,285,10,1100,815,1,20.0
9435,6064.0,VINTAGE BILLBOARD LOVE/HATE MUG,2,1739,20,2100,361,1,40.0
9436,6065.0,WOOD 2 DRAWER CABINET WHITE FINISH,9,1150,12,1300,150,1,24.0
9437,6066.0,WOOD S/3 CABINET ANT WHITE FINISH,2,227,4,500,273,1,8.0
9438,6067.0,WOODEN PICTURE FRAME WHITE FINISH,3,258,10,1100,842,1,20.0
9439,6068.0,WOODEN FRAME ANTIQUE WHITE ,7,218,2,300,82,1,4.0
9440,6069.0,KNITTED UNION FLAG HOT WATER BOTTLE,1,361,4,500,139,1,8.0
9441,6070.0,RED WOOLLY HOTTIE WHITE HEART.,4,473,23,2400,1927,1,46.0
9442,6071.0,SET 7 BABUSHKA NESTING BOXES,7,111,7,800,689,1,14.0
9443,6072.0,GLASS STAR FROSTED T-LIGHT HOLDER,7,811,9,1000,189,1,18.0
9444,6073.0,HOT WATER BOTTLE TEA AND SYMPATHY,7,279,2,300,21,1,4.0
9445,6074.0,RED HANGING HEART T-LIGHT HOLDER,8,265,5,600,335,1,10.0
9446,6075.0,HAND WARMER RED POLKA DOT,3,412,7,800,388,1,14.0
9447,6076.0,HAND WARMER UNION JACK,2,520,11,1200,680,1,22.0
9448,6077.0,JUMBO BAG PINK POLKADOT,6,200,1,200,0,1,2.0
9449,6078.0,JUMBO  BAG BAROQUE BLACK WHITE,8,1086,15,1600,514,1,30.0
9450,6079.0,JUMBO BAG CHARLIE AND LOLA TOYS,2,333,4,500,167,1,8.0
9451,6080.0,STRAWBERRY CHARLOTTE BAG,7,712,19,2000,1288,1,38.0
9452,6081.0,RED 3 PIECE RETROSPOT CUTLERY SET,8,1275,15,1600,325,1,30.0
9453,6082.0,BLUE 3 PIECE POLKADOT CUTLERY SET,3,409,7,800,391,1,14.0
9454,6083.0,SET/6 RED SPOTTY PAPER PLATES,7,1800,18,1900,100,1,36.0
9455,6084.0,LUNCH BAG RED RETROSPOT,9,156,1,200,44,1,2.0
9456,6085.0,STRAWBERRY LUNCH BOX WITH CUTLERY,3,1311,22,2300,989,1,44.0
9457,6086.0,LUNCH BOX WITH CUTLERY RETROSPOT ,5,928,20,2100,1172,1,40.0
9458,6087.0,PACK OF 72 RETROSPOT CAKE CASES,8,1028,17,1800,772,1,34.0
9459,6088.0,PACK OF 60 DINOSAUR CAKE CASES,3,942,10,1100,158,1,20.0
9460,6089.0,PACK OF 60 PINK PAISLEY CAKE CASES,8,942,9,1000,58,1,18.0
9461,6090.0,65 TEATIME FAIRY CAKE CASES,5,138,1,200,62,1,2.0
9462,6091.0,TOMATO CHARLIE+LOLA COASTER SET,10,970,18,1900,930,1,36.0
9463,6092.0,CHARLIE & LOLA WASTEPAPER BIN FLORA,1,352,19,2000,1648,1,38.0
9464,6093.0,RED CHARLIE+LOLA PERSONAL DOORSIGN,6,119,3,400,281,1,6.0
9465,6094.0,JUMBO STORAGE BAG SUKI,4,100,0,100,0,1,0.0
9466,6095.0,JUMBO BAG PINK VINTAGE PAISLEY,10,1317,15,1600,283,1,30.0
9467,6096.0,JAM MAKING SET PRINTED,4,125,13,1400,1275,1,26.0
9468,6097.0,RETROSPOT TEA SET CERAMIC 11 PC ,8,926,23,2400,1474,1,46.0
9469,6098.0,GIRLY PINK TOOL SET,5,344,4,500,156,1,8.0
9470,6099.0,JUMBO SHOPPER VINTAGE RED PAISLEY,7,1522,18,1900,378,1,36.0
9471,6100.0,"AIRLINE LOUNGE,METAL SIGN",9,755,18,1900,1145,1,36.0
9472,6101.0,WHITE SPOT RED CERAMIC DRAWER KNOB,4,100,0,100,0,1,0.0
9473,6102.0,RED DRAWER KNOB ACRYLIC EDWARDIAN,7,331,8,900,569,1,16.0
9474,6103.0,CLEAR DRAWER KNOB ACRYLIC EDWARDIAN,6,218,8,900,682,1,16.0
9475,6104.0,PHOTO CLIP LINE,3,376,17,1800,1424,1,34.0
9476,6105.0,FELT EGG COSY CHICKEN,8,714,21,2200,1486,1,42.0
9477,6106.0,PIGGY BANK RETROSPOT ,3,352,5,600,248,1,10.0
9478,6107.0,SKULL SHOULDER BAG,8,169,3,400,231,1,6.0
9479,6108.0,YOU'RE CONFUSING ME METAL SIGN ,5,169,7,800,631,1,14.0
9480,6109.0,COOK WITH WINE METAL SIGN ,9,203,11,1200,997,1,22.0
9481,6110.0,GIN + TONIC DIET METAL SIGN,7,167,1,200,33,1,2.0
9482,6111.0,YELLOW BREAKFAST CUP AND SAUCER,8,271,14,1500,1229,1,28.0
9483,6112.0,PINK BREAKFAST CUP AND SAUCER ,4,1129,24,2500,1371,1,48.0
9484,6113.0,PAPER CHAIN KIT 50'S CHRISTMAS ,8,578,6,700,122,1,12.0
9485,6114.0,PAPER CHAIN KIT RETROSPOT,10,216,14,1500,1284,1,28.0
9486,6115.0,SMALL HEART FLOWERS HOOK ,7,299,3,400,101,1,6.0
9487,6116.0,PHOTO CLIP LINE,5,2244,23,2400,156,1,46.0
9488,6117.0,TEA TIME DES TEA COSY,2,368,7,800,432,1,14.0
9489,6118.0,FELT EGG COSY WHITE RABBIT ,1,381,17,1800,1419,1,34.0
9490,6119.0,ZINC WILLIE WINKIE  CANDLE STICK,10,468,19,2000,1532,1,38.0
9491,6120.0,CERAMIC CHERRY CAKE MONEY BANK,6,1123,15,1600,477,1,30.0
9492,6121.0,RETROSPOT LARGE MILK JUG,1,968,10,1100,132,1,20.0
9493,6122.0,SET OF 6 FUNKY BEAKERS,7,144,1,200,56,1,2.0
9494,6123.0,EDWARDIAN PARASOL BLACK,5,317,9,1000,683,1,18.0
9495,6124.0,EDWARDIAN PARASOL NATURAL,1,122,7,800,678,1,14.0
9496,6125.0,CERAMIC STRAWBERRY CAKE MONEY BANK,2,238,2,300,62,1,4.0
9497,6126.0,BLUE OWL SOFT TOY,3,1709,25,2600,891,1,50.0
9498,6127.0,BALLOON ART MAKE YOUR OWN FLOWERS,3,153,14,1500,1347,1,28.0
9499,6128.0,RED TOADSTOOL LED NIGHT LIGHT,3,1321,20,2100,779,1,40.0
9500,6129.0,GLASS CLOCHE SMALL,4,110,1,200,90,1,2.0
9501,6130.0,GUMBALL MONOCHROME COAT RACK,2,399,17,1800,1401,1,34.0
9502,6131.0,DOORMAT FANCY FONT HOME SWEET HOME,4,814,15,1600,786,1,30.0
9503,6132.0,Discount,3,609,13,1400,791,1,26.0
9504,6133.0,INFLATABLE POLITICAL GLOBE ,2,278,17,1800,1522,1,34.0
9505,6134.0,VINTAGE SNAKES & LADDERS,5,1676,23,2400,724,1,46.0
9506,6135.0,CHOCOLATE CALCULATOR,1,482,8,900,418,1,16.0
9507,6136.0,JUMBO SHOPPER VINTAGE RED PAISLEY,2,491,8,900,409,1,16.0
9508,6137.0,RECYCLING BAG RETROSPOT ,6,438,17,1800,1362,1,34.0
9509,6138.0,TOY TIDY PINK POLKADOT,2,1059,25,2600,1541,1,50.0
9510,6139.0,ANTIQUE GLASS DRESSING TABLE POT,8,884,14,1500,616,1,28.0
9511,6140.0,ALARM CLOCK BAKELIKE GREEN,6,1094,13,1400,306,1,26.0
9512,6141.0,IVORY GIANT GARDEN THERMOMETER,8,348,7,800,452,1,14.0
9513,6142.0,8 TIER CAKE TIN GREEN AND CREAM,7,1078,24,2500,1422,1,48.0
9514,6143.0,8 TIER CAKE TIN RED AND CREAM,9,680,16,1700,1020,1,32.0
9515,6144.0,SET 3 WICKER OVAL BASKETS W LIDS,9,478,18,1900,1422,1,36.0
9516,6145.0,SET OF 3 COLOURED  FLYING DUCKS,10,245,13,1400,1155,1,26.0
9517,6146.0,WOOD BLACK BOARD ANT WHITE FINISH,1,394,6,700,306,1,12.0
9518,6147.0,COLOUR GLASS T-LIGHT HOLDER HANGING,5,273,2,300,27,1,4.0
9519,6148.0,HANGING METAL HEART LANTERN,1,515,10,1100,585,1,20.0
9520,6149.0,HANGING MEDINA LANTERN SMALL,2,123,25,2600,2477,1,50.0
9521,6150.0,NATURAL SLATE HEART CHALKBOARD ,6,348,6,700,352,1,12.0
9522,6151.0,HEART OF WICKER SMALL,6,898,18,1900,1002,1,36.0
9523,6152.0,HEART OF WICKER LARGE,1,676,14,1500,824,1,28.0
9524,6153.0,WHITE LOVEBIRD LANTERN,5,238,5,600,362,1,10.0
9525,6154.0,CLASSIC METAL BIRDCAGE PLANT HOLDER,10,1110,20,2100,990,1,40.0
9526,6155.0,CREAM HEART CARD HOLDER,9,2039,23,2400,361,1,46.0
9527,6156.0,ENAMEL FLOWER JUG CREAM,10,737,14,1500,763,1,28.0
9528,6157.0,ENAMEL FIRE BUCKET CREAM,3,353,6,700,347,1,12.0
9529,6158.0,ENAMEL BREAD BIN CREAM,9,172,7,800,628,1,14.0
9530,6159.0,SET 3 WICKER OVAL BASKETS W LIDS,3,348,5,600,252,1,10.0
9531,6160.0,JAM MAKING SET PRINTED,10,900,10,1100,200,1,20.0
9532,6161.0,JAM MAKING SET WITH JARS,5,143,11,1200,1057,1,22.0
9533,6162.0,JUMBO BAG DOLLY GIRL DESIGN,2,178,3,400,222,1,6.0
9534,6163.0,TRADITIONAL CHRISTMAS RIBBONS,9,1748,24,2500,752,1,48.0
9535,6164.0,ORGANISER WOOD ANTIQUE WHITE ,6,1972,25,2600,628,1,50.0
9536,6165.0,LUNCH BAG DOLLY GIRL DESIGN,7,373,6,700,327,1,12.0
9537,6166.0,WHITE WIRE EGG HOLDER,7,125,1,200,75,1,2.0
9538,6167.0,JUMBO  BAG BAROQUE BLACK WHITE,3,855,13,1400,545,1,26.0
9539,6168.0,JUMBO BAG RED RETROSPOT,9,100,0,100,0,1,0.0
9540,6169.0,CHILLI LIGHTS,5,245,21,2200,1955,1,42.0
9541,6170.0,LIGHT GARLAND BUTTERFILES PINK,6,1953,25,2600,647,1,50.0
9542,6171.0,WOODEN OWLS LIGHT GARLAND ,4,100,0,100,0,1,0.0
9543,6172.0,FAIRY TALE COTTAGE NIGHTLIGHT,1,260,2,300,40,1,4.0
9544,6173.0,RED TOADSTOOL LED NIGHT LIGHT,2,1866,21,2200,334,1,42.0
9545,6174.0,HOME BUILDING BLOCK WORD,1,116,11,1200,1084,1,22.0
9546,6175.0,LOVE BUILDING BLOCK WORD,5,1421,24,2500,1079,1,48.0
9547,6176.0,DOORMAT FANCY FONT HOME SWEET HOME,1,1230,23,2400,1170,1,46.0
9548,6177.0,HOME SMALL WOOD LETTERS,8,2033,22,2300,267,1,44.0
9549,6178.0,GINGHAM HEART  DOORSTOP RED,2,641,10,1100,459,1,20.0
9550,6179.0,FIVE HEART HANGING DECORATION,2,356,11,1200,844,1,22.0
9551,6180.0,HANGING METAL HEART LANTERN,6,231,10,1100,869,1,20.0
9552,6181.0,ASSORTED BOTTLE TOP  MAGNETS ,4,100,0,100,0,1,0.0
9553,6182.0,FRIDGE MAGNETS US DINER ASSORTED,8,837,15,1600,763,1,30.0
9554,6183.0,HOMEMADE JAM SCENTED CANDLES,6,569,10,1100,531,1,20.0
9555,6184.0,FRIDGE MAGNETS LES ENFANTS ASSORTED,8,864,23,2400,1536,1,46.0
9556,6185.0,ROSE CARAVAN DOORSTOP,8,887,8,900,13,1,16.0
9557,6186.0,HEART OF WICKER SMALL,10,100,0,100,0,1,0.0
9558,6187.0,10 HOOK HANGER MAGIC TOADSTOOL,7,357,13,1400,1043,1,26.0
9559,6188.0,CHRISTMAS LIGHTS 10 REINDEER,9,520,17,1800,1280,1,34.0
9560,6189.0,VINTAGE UNION JACK CUSHION COVER,4,1093,18,1900,807,1,36.0
9561,6190.0,VINTAGE HEADS AND TAILS CARD GAME ,3,100,0,100,0,1,0.0
9562,6191.0,SET OF 3 COLOURED  FLYING DUCKS,3,651,9,1000,349,1,18.0
9563,6192.0,SET OF 3 GOLD FLYING DUCKS,1,1542,25,2600,1058,1,50.0
9564,6193.0,RED RETROSPOT UMBRELLA,7,449,13,1400,951,1,26.0
9565,6194.0,BLACK/BLUE POLKADOT UMBRELLA,10,461,23,2400,1939,1,46.0
9566,6195.0,RED DINER WALL CLOCK,4,1449,17,1800,351,1,34.0
9567,6196.0,ALARM CLOCK BAKELIKE GREEN,9,164,5,600,436,1,10.0
9568,6197.0,ALARM CLOCK BAKELIKE RED ,6,112,19,2000,1888,1,38.0
9569,6198.0,BLUE DINER WALL CLOCK,1,651,9,1000,349,1,18.0
9570,6199.0,IVORY DINER WALL CLOCK,2,427,14,1500,1073,1,28.0
9571,6200.0,LARGE HEART MEASURING SPOONS,1,976,23,2400,1424,1,46.0
9572,6201.0,SMALL HEART MEASURING SPOONS,10,1358,20,2100,742,1,40.0
9573,6202.0,CHRISTMAS LIGHTS 10 REINDEER,4,1540,15,1600,60,1,30.0
9574,6203.0,JAM MAKING SET WITH JARS,3,1071,20,2100,1029,1,40.0
9575,6204.0,JAM MAKING SET PRINTED,8,1340,22,2300,960,1,44.0
9576,6205.0,JAM JAR WITH PINK LID,10,1072,15,1600,528,1,30.0
9577,6206.0,JAM JAR WITH GREEN LID,6,650,10,1100,450,1,20.0
9578,6207.0,ROSE COTTAGE KEEPSAKE BOX ,3,576,5,600,24,1,10.0
9579,6208.0,HANGING HEART ZINC T-LIGHT HOLDER,5,1022,18,1900,878,1,36.0
9580,6209.0,PAPER CHAIN KIT VINTAGE CHRISTMAS,8,292,4,500,208,1,8.0
9581,6210.0,DISCO BALL CHRISTMAS DECORATION,7,162,2,300,138,1,4.0
9582,6211.0,WHITE HANGING HEART T-LIGHT HOLDER,6,914,14,1500,586,1,28.0
9583,6212.0,SMALL POPCORN HOLDER,1,146,3,400,254,1,6.0
9584,6213.0,LARGE POPCORN HOLDER ,8,849,10,1100,251,1,20.0
9585,6214.0,RETROSPOT LARGE MILK JUG,1,1417,19,2000,583,1,38.0
9586,6215.0,SET/20 RED RETROSPOT PAPER NAPKINS ,6,121,14,1500,1379,1,28.0
9587,6216.0,SET/6 RED SPOTTY PAPER PLATES,8,424,10,1100,676,1,20.0
9588,6217.0,SET/6 RED SPOTTY PAPER CUPS,8,358,6,700,342,1,12.0
9589,6218.0,POLKADOT RAIN HAT ,6,935,16,1700,765,1,32.0
9590,6219.0,DELUXE SEWING KIT ,10,905,9,1000,95,1,18.0
9591,6220.0,RETROSPOT HEART HOT WATER BOTTLE,8,2130,22,2300,170,1,44.0
9592,6221.0,KNITTED UNION FLAG HOT WATER BOTTLE,1,1403,20,2100,697,1,40.0
9593,6222.0,ENGLISH ROSE HOT WATER BOTTLE,2,100,0,100,0,1,0.0
9594,6223.0,PHOTO CUBE,8,977,16,1700,723,1,32.0
9595,6224.0,HOMEMADE JAM SCENTED CANDLES,7,377,5,600,223,1,10.0
9596,6225.0,JUMBO BAG RED RETROSPOT,6,1110,23,2400,1290,1,46.0
9597,6226.0,PLASTERS IN TIN CIRCUS PARADE ,3,1389,25,2600,1211,1,50.0
9598,6227.0,PACK OF 12 PINK PAISLEY TISSUES ,6,100,0,100,0,1,0.0
9599,6228.0,PACK OF 12 BLUE PAISLEY TISSUES ,6,1093,18,1900,807,1,36.0
9600,6229.0,PACK OF 12 RED RETROSPOT TISSUES ,5,199,1,200,1,1,2.0
9601,6230.0,CHICK GREY HOT WATER BOTTLE,1,205,23,2400,2195,1,46.0
9602,6231.0,PLASTERS IN TIN VINTAGE PAISLEY ,9,149,9,1000,851,1,18.0
9603,6232.0,PLASTERS IN TIN SKULLS,1,1989,22,2300,311,1,44.0
9604,6233.0,8 STRIPEY MICE FELTCRAFT,4,875,9,1000,125,1,18.0
9605,6234.0,SET OF 6 SOLDIER SKITTLES,5,1513,22,2300,787,1,44.0
9606,6235.0,TRADITIONAL WOODEN SKIPPING ROPE,5,731,8,900,169,1,16.0
9607,6236.0,WOODEN BOX OF DOMINOES,7,774,19,2000,1226,1,38.0
9608,6237.0,RUSTIC  SEVENTEEN DRAWER SIDEBOARD,8,1463,15,1600,137,1,30.0
9609,6238.0,PARTY CONES CARNIVAL ASSORTED,6,826,22,2300,1474,1,44.0
9610,6239.0,PARTY CONES CANDY ASSORTED,5,1409,15,1600,191,1,30.0
9611,6240.0,PICNIC BASKET WICKER SMALL,10,200,4,500,300,1,8.0
9612,6241.0,ASSORTED COLOUR BIRD ORNAMENT,7,174,2,300,126,1,4.0
9613,6242.0,STAR DECORATION PAINTED ZINC ,9,100,0,100,0,1,0.0
9614,6243.0,RETROSPOT LAMP,4,206,15,1600,1394,1,30.0
9615,6244.0,"FANCY FONT BIRTHDAY CARD, ",7,1390,19,2000,610,1,38.0
9616,6245.0,HAND WARMER UNION JACK,2,126,2,300,174,1,4.0
9617,6246.0,HAND WARMER SCOTTY DOG DESIGN,2,421,12,1300,879,1,24.0
9618,6247.0,HAND WARMER OWL DESIGN,7,100,0,100,0,1,0.0
9619,6248.0,HAND WARMER RED RETROSPOT,10,184,7,800,616,1,14.0
9620,6249.0,RETROSPOT HEART HOT WATER BOTTLE,8,100,0,100,0,1,0.0
9621,6250.0,DOG BOWL CHASING BALL DESIGN,1,270,4,500,230,1,8.0
9622,6251.0,CLOTHES PEGS RETROSPOT PACK 29,10,224,2,300,76,1,4.0
9623,6252.0,HAND OVER THE CHOCOLATE   SIGN ,6,113,5,600,487,1,10.0
9624,6253.0,WHITE HANGING HEART T-LIGHT HOLDER,10,2444,24,2500,56,1,48.0
9625,6254.0,TRAVEL SEWING KIT,8,2178,23,2400,222,1,46.0
9626,6255.0,BLACK HEART CARD HOLDER,9,1587,20,2100,513,1,40.0
9627,6256.0,ASSORTED COLOUR BIRD ORNAMENT,9,1522,23,2400,878,1,46.0
9628,6257.0,PACK OF 60 PINK PAISLEY CAKE CASES,5,244,2,300,56,1,4.0
9629,6258.0,65 TEATIME FAIRY CAKE CASES,8,482,12,1300,818,1,24.0
9630,6259.0,PACK OF 72 RETROSPOT CAKE CASES,1,377,14,1500,1123,1,28.0
9631,6260.0,CHICK GREY HOT WATER BOTTLE,8,1671,22,2300,629,1,44.0
9632,6261.0,SMALL GLASS HEART TRINKET POT,5,108,6,700,592,1,12.0
9633,6262.0,ALARM CLOCK BAKELIKE IVORY,9,600,9,1000,400,1,18.0
9634,6263.0,ALARM CLOCK BAKELIKE RED ,5,783,15,1600,817,1,30.0
9635,6264.0,ALARM CLOCK BAKELIKE ORANGE,4,1695,21,2200,505,1,42.0
9636,6265.0,ALARM CLOCK BAKELIKE GREEN,4,1418,21,2200,782,1,42.0
9637,6266.0,HOT WATER BOTTLE TEA AND SYMPATHY,7,1979,21,2200,221,1,42.0
9638,6267.0,HAND WARMER BIRD DESIGN,4,295,19,2000,1705,1,38.0
9639,6268.0,HAND WARMER SCOTTY DOG DESIGN,2,178,13,1400,1222,1,26.0
9640,6269.0,WHITE HANGING HEART T-LIGHT HOLDER,8,1765,25,2600,835,1,50.0
9641,6270.0,WHITE METAL LANTERN,6,1661,24,2500,839,1,48.0
9642,6271.0,CREAM CUPID HEARTS COAT HANGER,6,425,22,2300,1875,1,44.0
9643,6272.0,EDWARDIAN PARASOL BLACK,4,827,13,1400,573,1,26.0
9644,6273.0,EDWARDIAN PARASOL RED,3,659,8,900,241,1,16.0
9645,6274.0,RETRO COFFEE MUGS ASSORTED,8,116,6,700,584,1,12.0
9646,6275.0,SAVE THE PLANET MUG,7,794,25,2600,1806,1,50.0
9647,6276.0,VINTAGE BILLBOARD DRINK ME MUG,7,2276,25,2600,324,1,50.0
9648,6277.0,VINTAGE BILLBOARD LOVE/HATE MUG,4,1045,22,2300,1255,1,44.0
9649,6278.0,WOOD 2 DRAWER CABINET WHITE FINISH,6,1613,22,2300,687,1,44.0
9650,6279.0,WOOD S/3 CABINET ANT WHITE FINISH,2,208,2,300,92,1,4.0
9651,6280.0,WOODEN PICTURE FRAME WHITE FINISH,6,100,0,100,0,1,0.0
9652,6281.0,WOODEN FRAME ANTIQUE WHITE ,9,271,3,400,129,1,6.0
9653,6282.0,KNITTED UNION FLAG HOT WATER BOTTLE,6,763,7,800,37,1,14.0
9654,6283.0,RED WOOLLY HOTTIE WHITE HEART.,3,655,7,800,145,1,14.0
9655,6284.0,SET 7 BABUSHKA NESTING BOXES,9,185,12,1300,1115,1,24.0
9656,6285.0,IVORY EMBROIDERED QUILT ,9,100,0,100,0,1,0.0
9657,6286.0,GLASS STAR FROSTED T-LIGHT HOLDER,5,315,3,400,85,1,6.0
9658,6287.0,SET OF 3 BLACK FLYING DUCKS,3,1641,18,1900,259,1,36.0
9659,6288.0,SET OF 3 COLOURED  FLYING DUCKS,2,1547,22,2300,753,1,44.0
9660,6289.0,PACK OF 12 RED RETROSPOT TISSUES ,4,100,0,100,0,1,0.0
9661,6290.0,RED RETROSPOT MUG,5,1052,17,1800,748,1,34.0
9662,6291.0,BABUSHKA LIGHTS STRING OF 15,8,337,6,700,363,1,12.0
9663,6292.0,PIGGY BANK RETROSPOT ,10,1830,23,2400,570,1,46.0
9664,6293.0,SET 7 BABUSHKA NESTING BOXES,10,410,7,800,390,1,14.0
9665,6294.0,DOORMAT FAIRY CAKE,9,350,3,400,50,1,6.0
9666,6295.0,HAND WARMER RED RETROSPOT,6,1035,22,2300,1265,1,44.0
9667,6296.0,HAND WARMER SCOTTY DOG DESIGN,3,236,7,800,564,1,14.0
9668,6297.0,HAND WARMER OWL DESIGN,1,778,16,1700,922,1,32.0
9669,6298.0,STRAWBERRY CERAMIC TRINKET BOX,7,716,12,1300,584,1,24.0
9670,6299.0,PINK DOUGHNUT TRINKET POT ,2,368,10,1100,732,1,20.0
9671,6300.0,SILK PURSE BABUSHKA PINK,6,115,4,500,385,1,8.0
9672,6301.0,HOT WATER BOTTLE TEA AND SYMPATHY,6,1181,16,1700,519,1,32.0
9673,6302.0,HOT WATER BOTTLE I AM SO POORLY,8,1585,20,2100,515,1,40.0
9674,6303.0,CHOCOLATE HOT WATER BOTTLE,10,591,5,600,9,1,10.0
9675,6304.0,WHITE SKULL HOT WATER BOTTLE ,10,182,17,1800,1618,1,34.0
9676,6305.0,SCOTTIE DOG HOT WATER BOTTLE,2,128,2,300,172,1,4.0
9677,6306.0,HAND WARMER RED POLKA DOT,9,100,0,100,0,1,0.0
9678,6307.0,HAND WARMER UNION JACK,7,436,5,600,164,1,10.0
9679,6308.0,HOMEMADE JAM SCENTED CANDLES,10,207,17,1800,1593,1,34.0
9680,6309.0,BIRD HOUSE HOT WATER BOTTLE,10,1594,24,2500,906,1,48.0
9681,6310.0,BOUDOIR SQUARE TISSUE BOX,1,1592,16,1700,108,1,32.0
9682,6311.0,SKULLS SQUARE TISSUE BOX,3,148,1,200,52,1,2.0
9683,6312.0,PHOTO FRAME CORNICE,1,652,6,700,48,1,12.0
9684,6313.0,SILK PURSE BABUSHKA RED,2,128,3,400,272,1,6.0
9685,6314.0,PICTURE DOMINOES,7,2073,22,2300,227,1,44.0
9686,6315.0,S/6 SEW ON CROCHET FLOWERS,4,973,18,1900,927,1,36.0
9687,6316.0,SCANDINAVIAN REDS RIBBONS,8,286,12,1300,1014,1,24.0
9688,6317.0,BALLOONS  WRITING SET ,2,1004,22,2300,1296,1,44.0
9689,6318.0,JAM MAKING SET PRINTED,6,100,0,100,0,1,0.0
9690,6319.0,LAVENDER INCENSE IN TIN,9,2196,25,2600,404,1,50.0
9691,6320.0,TV DINNER TRAY VINTAGE PAISLEY,5,360,11,1200,840,1,22.0
9692,6321.0,SET OF 4 ENGLISH ROSE PLACEMATS,4,424,18,1900,1476,1,36.0
9693,6322.0,SET OF 4 ENGLISH ROSE COASTERS,5,172,1,200,28,1,2.0
9694,6323.0,TRIPLE PHOTO FRAME CORNICE ,9,807,21,2200,1393,1,42.0
9695,6324.0,FAMILY PHOTO FRAME CORNICE,8,655,6,700,45,1,12.0
9696,6325.0,MIRRORED DISCO BALL ,1,276,4,500,224,1,8.0
9697,6326.0,DISCO BALL ROTATOR BATTERY OPERATED,5,1664,17,1800,136,1,34.0
9698,6327.0,SILVER LOOKING MIRROR,4,100,0,100,0,1,0.0
9699,6328.0,LADIES & GENTLEMEN METAL SIGN,3,1394,20,2100,706,1,40.0
9700,6329.0,METAL SIGN HER DINNER IS SERVED ,7,882,12,1300,418,1,24.0
9701,6330.0,YOU'RE CONFUSING ME METAL SIGN ,2,398,3,400,2,1,6.0
9702,6331.0,DOORMAT TOPIARY,8,2412,24,2500,88,1,48.0
9703,6332.0,BATHROOM METAL SIGN,1,463,4,500,37,1,8.0
9704,6333.0,KITCHEN METAL SIGN,7,1186,13,1400,214,1,26.0
9705,6334.0,TOILET METAL SIGN,3,731,10,1100,369,1,20.0
9706,6335.0,METAL SIGN TAKE IT OR LEAVE IT ,7,256,10,1100,844,1,20.0
9707,6336.0,I'M ON HOLIDAY METAL SIGN,7,671,25,2600,1929,1,50.0
9708,6337.0,GROW YOUR OWN BASIL IN ENAMEL MUG,2,155,7,800,645,1,14.0
9709,6338.0,SET/10 PINK POLKADOT PARTY CANDLES,3,844,22,2300,1456,1,44.0
9710,6339.0,SET 20 NAPKINS FAIRY CAKES DESIGN ,9,241,2,300,59,1,4.0
9711,6340.0,65 TEATIME FAIRY CAKE CASES,9,1761,24,2500,739,1,48.0
9712,6341.0,SET OF 6 T-LIGHTS SNOWMEN,7,300,2,300,0,1,4.0
9713,6342.0,SET OF 6 T-LIGHTS SANTA,10,790,16,1700,910,1,32.0
9714,6343.0,SET OF 9 HEART SHAPED BALLOONS,10,257,2,300,43,1,4.0
9715,6344.0,SANDWICH BATH SPONGE,5,204,20,2100,1896,1,40.0
9716,6345.0,APPLE BATH SPONGE,4,1130,20,2100,970,1,40.0
9717,6346.0,STRAWBERRY BATH SPONGE ,2,1274,14,1500,226,1,28.0
9718,6347.0,BLACK PIRATE TREASURE CHEST,8,1124,12,1300,176,1,24.0
9719,6348.0,STAR PORTABLE TABLE LIGHT ,9,1920,21,2200,280,1,42.0
9720,6349.0,SNOWFLAKE PORTABLE TABLE LIGHT ,3,553,20,2100,1547,1,40.0
9721,6350.0,PINK OVAL JEWELLED MIRROR,10,1036,11,1200,164,1,22.0
9722,6351.0,RETROSPOT CIGAR BOX MATCHES ,3,100,0,100,0,1,0.0
9723,6352.0,COSY HOUR GIANT TUBE MATCHES,2,371,16,1700,1329,1,32.0
9724,6353.0,JAZZ HEARTS PURSE NOTEBOOK,5,311,21,2200,1889,1,42.0
9725,6354.0,LUNCH BAG DOLLY GIRL DESIGN,8,848,8,900,52,1,16.0
9726,6355.0,WHITE HANGING HEART T-LIGHT HOLDER,1,286,2,300,14,1,4.0
9727,6356.0,CANDLEHOLDER PINK HANGING HEART,4,1196,16,1700,504,1,32.0
9728,6357.0,WOOD 2 DRAWER CABINET WHITE FINISH,1,135,2,300,165,1,4.0
9729,6358.0,ASSORTED COLOUR MINI CASES,9,825,24,2500,1675,1,48.0
9730,6359.0,LUNCH BAG RED RETROSPOT,4,121,12,1300,1179,1,24.0
9731,6360.0,LUNCH BAG SPACEBOY DESIGN ,1,881,15,1600,719,1,30.0
9732,6361.0,LUNCH BAG WOODLAND,6,148,14,1500,1352,1,28.0
9733,6362.0,LUNCH BAG PINK POLKADOT,10,1182,12,1300,118,1,24.0
9734,6363.0,GUMBALL COAT RACK,1,808,14,1500,692,1,28.0
9735,6364.0,BLUE NEW BAROQUE CANDLESTICK CANDLE,8,1560,21,2200,640,1,42.0
9736,6365.0,PINK NEW BAROQUECANDLESTICK CANDLE,9,895,15,1600,705,1,30.0
9737,6366.0,FAIRY CAKE FLANNEL ASSORTED COLOUR,9,2092,20,2100,8,1,40.0
9738,6367.0,BREAD BIN DINER STYLE PINK,4,100,0,100,0,1,0.0
9739,6368.0,JUMBO BAG CHARLIE AND LOLA TOYS,7,526,13,1400,874,1,26.0
9740,6369.0,TEA TIME TABLE CLOTH,3,228,2,300,72,1,4.0
9741,6370.0,ENGLISH ROSE HOT WATER BOTTLE,1,112,2,300,188,1,4.0
9742,6371.0,ENAMEL FIRE BUCKET CREAM,4,848,15,1600,752,1,30.0
9743,6372.0,PICNIC BASKET WICKER SMALL,3,544,10,1100,556,1,20.0
9744,6373.0,PAPER CHAIN KIT 50'S CHRISTMAS ,2,692,6,700,8,1,12.0
9745,6374.0,PAPER CHAIN KIT VINTAGE CHRISTMAS,5,369,25,2600,2231,1,50.0
9746,6375.0,HOT WATER BOTTLE BABUSHKA ,8,1466,21,2200,734,1,42.0
9747,6376.0,HAND WARMER BIRD DESIGN,10,254,23,2400,2146,1,46.0
9748,6377.0,POSTAGE,3,1469,17,1800,331,1,34.0
9749,6378.0,HEART IVORY TRELLIS SMALL,8,651,7,800,149,1,14.0
9750,6379.0,CLEAR DRAWER KNOB ACRYLIC EDWARDIAN,4,1952,19,2000,48,1,38.0
9751,6380.0,PINK DRAWER KNOB ACRYLIC EDWARDIAN,7,426,24,2500,2074,1,48.0
9752,6381.0,GREEN DRAWER KNOB ACRYLIC EDWARDIAN,4,1035,11,1200,165,1,22.0
9753,6382.0,BLUE DRAWER KNOB ACRYLIC EDWARDIAN,7,1021,15,1600,579,1,30.0
9754,6383.0,HEART OF WICKER SMALL,10,1520,18,1900,380,1,36.0
9755,6384.0,SMALL POPCORN HOLDER,10,783,10,1100,317,1,20.0
9756,6385.0,SET 6 FOOTBALL CELEBRATION CANDLES,9,1155,12,1300,145,1,24.0
9757,6386.0,SET OF 6 GIRLS CELEBRATION CANDLES,9,1037,19,2000,963,1,38.0
9758,6387.0,ROMANTIC PINKS RIBBONS ,9,547,11,1200,653,1,22.0
9759,6388.0,BRIGHT BLUES RIBBONS ,1,1544,21,2200,656,1,42.0
9760,6389.0,SCANDINAVIAN REDS RIBBONS,5,153,1,200,47,1,2.0
9761,6390.0,CHOCOLATE BOX RIBBONS ,4,121,9,1000,879,1,18.0
9762,6391.0,PARTY INVITES FOOTBALL,1,161,2,300,139,1,4.0
9763,6392.0,PARTY INVITES JAZZ HEARTS,9,848,12,1300,452,1,24.0
9764,6393.0,PARTY INVITES SPACEMAN,1,1036,22,2300,1264,1,44.0
9765,6394.0,SET OF 3 BUTTERFLY COOKIE CUTTERS,2,255,10,1100,845,1,20.0
9766,6395.0,SET OF 3 HEART COOKIE CUTTERS,2,878,24,2500,1622,1,48.0
9767,6396.0,8 PIECE SPACEBOY COOKIE CUTTER SET,2,102,3,400,298,1,6.0
9768,6397.0,PACK OF 72 SKULL CAKE CASES,6,525,5,600,75,1,10.0
9769,6398.0,PACK OF 60 SPACEBOY CAKE CASES,2,136,1,200,64,1,2.0
9770,6399.0,PACK OF 72 RETROSPOT CAKE CASES,4,111,11,1200,1089,1,22.0
9771,6400.0,77 SWEETHEART FAIRY CAKE CASES,7,314,11,1200,886,1,22.0
9772,6401.0,PACK OF 60 DINOSAUR CAKE CASES,2,1329,14,1500,171,1,28.0
9773,6402.0,LUNCH BAG SUKI  DESIGN ,6,249,2,300,51,1,4.0
9774,6403.0,LUNCH BAG CARS BLUE,10,130,8,900,770,1,16.0
9775,6404.0,LUNCH BAG  BLACK SKULL.,2,1343,15,1600,257,1,30.0
9776,6405.0,HEART IVORY TRELLIS LARGE,2,140,2,300,160,1,4.0
9777,6406.0,SET/5 RED RETROSPOT LID GLASS BOWLS,8,2187,21,2200,13,1,42.0
9778,6407.0,WHITE HANGING HEART T-LIGHT HOLDER,8,100,0,100,0,1,0.0
9779,6408.0,WHITE METAL LANTERN,6,849,10,1100,251,1,20.0
9780,6409.0,CREAM CUPID HEARTS COAT HANGER,9,159,5,600,441,1,10.0
9781,6410.0,EDWARDIAN PARASOL RED,5,117,1,200,83,1,2.0
9782,6411.0,RETRO COFFEE MUGS ASSORTED,3,1730,21,2200,470,1,42.0
9783,6412.0,SAVE THE PLANET MUG,8,536,20,2100,1564,1,40.0
9784,6413.0,VINTAGE BILLBOARD DRINK ME MUG,1,175,1,200,25,1,2.0
9785,6414.0,VINTAGE BILLBOARD LOVE/HATE MUG,9,192,14,1500,1308,1,28.0
9786,6415.0,WOOD 2 DRAWER CABINET WHITE FINISH,4,333,3,400,67,1,6.0
9787,6416.0,WOOD S/3 CABINET ANT WHITE FINISH,3,268,6,700,432,1,12.0
9788,6417.0,WOODEN PICTURE FRAME WHITE FINISH,6,441,19,2000,1559,1,38.0
9789,6418.0,WOODEN FRAME ANTIQUE WHITE ,8,493,14,1500,1007,1,28.0
9790,6419.0,KNITTED UNION FLAG HOT WATER BOTTLE,10,117,6,700,583,1,12.0
9791,6420.0,RED WOOLLY HOTTIE WHITE HEART.,10,989,15,1600,611,1,30.0
9792,6421.0,SET 7 BABUSHKA NESTING BOXES,4,149,8,900,751,1,16.0
9793,6422.0,IVORY EMBROIDERED QUILT ,7,366,14,1500,1134,1,28.0
9794,6423.0,GLASS STAR FROSTED T-LIGHT HOLDER,10,1681,19,2000,319,1,38.0
9795,6424.0,HAND WARMER RED POLKA DOT,6,873,10,1100,227,1,20.0
9796,6425.0,HAND WARMER UNION JACK,8,239,6,700,461,1,12.0
9797,6426.0,MAGIC DRAWING SLATE DINOSAUR,2,1083,21,2200,1117,1,42.0
9798,6427.0,MAGIC DRAWING SLATE BAKE A CAKE ,2,130,6,700,570,1,12.0
9799,6428.0,17 PENCILS TALL TUBE SKULLS,7,1208,16,1700,492,1,32.0
9800,6429.0,CHOCOLATE CALCULATOR,10,450,23,2400,1950,1,46.0
9801,6430.0,RED  HARMONICA IN BOX ,3,208,5,600,392,1,10.0
9802,6431.0,BLUE HARMONICA IN BOX ,1,106,5,600,494,1,10.0
9803,6432.0,SKULLS  WATER TRANSFER TATTOOS ,7,1348,17,1800,452,1,34.0
9804,6433.0,PACK 3 BOXES BIRD PANNETONE ,5,1058,11,1200,142,1,22.0
9805,6434.0,HOT WATER BOTTLE TEA AND SYMPATHY,6,584,12,1300,716,1,24.0
9806,6435.0,RED WOOLLY HOTTIE WHITE HEART.,3,1262,25,2600,1338,1,50.0
9807,6436.0,WHITE SKULL HOT WATER BOTTLE ,2,998,19,2000,1002,1,38.0
9808,6437.0,8 PIECE SPACEBOY COOKIE CUTTER SET,7,169,12,1300,1131,1,24.0
9809,6438.0,SET OF 20 KIDS COOKIE CUTTERS,5,1497,21,2200,703,1,42.0
9810,6439.0,15 COLOUR SPACEBOY PEN,3,255,3,400,145,1,6.0
9811,6440.0,VICTORIAN GLASS HANGING T-LIGHT,7,754,23,2400,1646,1,46.0
9812,6441.0,SINGLE HEART ZINC T-LIGHT HOLDER,9,993,15,1600,607,1,30.0
9813,6442.0,RED HANGING HEART T-LIGHT HOLDER,8,255,10,1100,845,1,20.0
9814,6443.0,HANGING METAL STAR LANTERN,1,161,15,1600,1439,1,30.0
9815,6444.0,SILVER HANGING T-LIGHT HOLDER,5,792,16,1700,908,1,32.0
9816,6445.0,DOORMAT RED RETROSPOT,1,1350,15,1600,250,1,30.0
9817,6446.0,DOORMAT HEARTS,10,1478,15,1600,122,1,30.0
9818,6447.0,NATURAL SLATE RECTANGLE CHALKBOARD,3,1732,21,2200,468,1,42.0
9819,6448.0,LOVEBIRD HANGING DECORATION WHITE ,5,808,10,1100,292,1,20.0
9820,6449.0,ASSORTED COLOUR BIRD ORNAMENT,5,363,18,1900,1537,1,36.0
9821,6450.0,HOME BUILDING BLOCK WORD,1,353,15,1600,1247,1,30.0
9822,6451.0,LOVE BUILDING BLOCK WORD,3,2299,22,2300,1,1,44.0
9823,6452.0,PHOTO FRAME CORNICE,5,1400,17,1800,400,1,34.0
9824,6453.0,PENS ASSORTED FUNNY FACE,7,698,7,800,102,1,14.0
9825,6454.0,CARD CIRCUS PARADE,10,792,23,2400,1608,1,46.0
9826,6455.0,WRAP COWBOYS  ,4,999,9,1000,1,1,18.0
9827,6456.0,AIRLINE BAG VINTAGE TOKYO 83,6,793,10,1100,307,1,20.0
9828,6457.0,RED RETROSPOT UMBRELLA,3,1147,15,1600,453,1,30.0
9829,6458.0,BLACK/BLUE POLKADOT UMBRELLA,7,356,8,900,544,1,16.0
9830,6459.0,RED 3 PIECE RETROSPOT CUTLERY SET,1,648,21,2200,1552,1,42.0
9831,6460.0,PACK OF 72 RETROSPOT CAKE CASES,1,100,0,100,0,1,0.0
9832,6461.0,SET OF 72 RETROSPOT PAPER  DOILIES,3,147,4,500,353,1,8.0
9833,6462.0,BLUE COAT RACK PARIS FASHION,4,409,8,900,491,1,16.0
9834,6463.0,PLASTERS IN TIN SKULLS,8,220,7,800,580,1,14.0
9835,6464.0,SLEEPING CAT ERASERS,2,609,17,1800,1191,1,34.0
9836,6465.0,CARD BIRTHDAY COWBOY,3,597,14,1500,903,1,28.0
9837,6466.0,PACK 3 BOXES CHRISTMAS PANNETONE,4,100,0,100,0,1,0.0
9838,6467.0,ROTATING SILVER ANGELS T-LIGHT HLDR,5,434,6,700,266,1,12.0
9839,6468.0,COSY HOUR GIANT TUBE MATCHES,9,770,7,800,30,1,14.0
9840,6469.0,RIBBON REEL MAKING SNOWMEN ,4,395,23,2400,2005,1,46.0
9841,6470.0,MINI PAINT SET VINTAGE ,8,1011,19,2000,989,1,38.0
9842,6471.0,9 TRADITIONAL SPINNING TOPS,4,597,13,1400,803,1,26.0
9843,6472.0,SET OF 6 SOLDIER SKITTLES,1,1845,18,1900,55,1,36.0
9844,6473.0,BAG 500g SWIRLY MARBLES,6,563,20,2100,1537,1,40.0
9845,6474.0,10 STRAND GLASS NECKLACE CRYSTAL,2,1006,23,2400,1394,1,46.0
9846,6475.0,WHITE SKULL HOT WATER BOTTLE ,5,745,10,1100,355,1,20.0
9847,6476.0,SCOTTIE DOG HOT WATER BOTTLE,8,1050,21,2200,1150,1,42.0
9848,6477.0,SQUARECUSHION COVER PINK UNION FLAG,2,575,11,1200,625,1,22.0
9849,6478.0,SPACEBOY CHILDRENS EGG CUP,3,193,10,1100,907,1,20.0
9850,6479.0,CHILDREN'S SPACEBOY MUG,2,1668,23,2400,732,1,46.0
9851,6480.0,HAND WARMER SCOTTY DOG DESIGN,1,580,23,2400,1820,1,46.0
9852,6481.0,FELTCRAFT CUSHION OWL,4,100,0,100,0,1,0.0
9853,6482.0,BLACK CANDELABRA T-LIGHT HOLDER,3,1905,19,2000,95,1,38.0
9854,6483.0,TOY TIDY DOLLY GIRL DESIGN,1,1022,13,1400,378,1,26.0
9855,6484.0,SET 12 LAVENDER  BOTANICAL T-LIGHTS,2,1425,14,1500,75,1,28.0
9856,6485.0,UNION JACK FLAG LUGGAGE TAG,2,456,10,1100,644,1,20.0
9857,6486.0,RED HEART LUGGAGE TAG,10,562,6,700,138,1,12.0
9858,6487.0,RED GLASS TASSLE BAG CHARM,1,460,4,500,40,1,8.0
9859,6488.0,CLEAR ACRYLIC FACETED BANGLE,4,2095,20,2100,5,1,40.0
9860,6489.0,10 STRAND GLASS NECKLACE CRYSTAL,9,131,1,200,69,1,2.0
9861,6490.0,DOORMAT UNION JACK GUNS AND ROSES,2,751,8,900,149,1,16.0
9862,6491.0,VANILLA SCENT CANDLE JEWELLED BOX,3,1106,24,2500,1394,1,48.0
9863,6492.0,FULL ENGLISH BREAKFAST PLATE,3,2017,22,2300,283,1,44.0
9864,6493.0,BLACK CANDELABRA T-LIGHT HOLDER,6,1310,19,2000,690,1,38.0
9865,6494.0,MAGIC DRAWING SLATE CIRCUS PARADE  ,8,2100,23,2400,300,1,46.0
9866,6495.0,CHRISTMAS HANGING HEART WITH BELL,9,537,5,600,63,1,10.0
9867,6496.0,CAKE STAND VICTORIAN FILIGREE MED,6,1667,16,1700,33,1,32.0
9868,6497.0,PAISLEY PATTERN  STICKERS,9,1760,23,2400,640,1,46.0
9869,6498.0,FLOWERS  STICKERS,5,1407,23,2400,993,1,46.0
9870,6499.0,PINK NEW BAROQUECANDLESTICK CANDLE,6,1214,14,1500,286,1,28.0
9871,6500.0,BLUE NEW BAROQUE CANDLESTICK CANDLE,7,785,17,1800,1015,1,34.0
9872,6501.0,JUMBO STORAGE BAG SUKI,9,676,13,1400,724,1,26.0
9873,6502.0,BLACK LOVE BIRD CANDLE,4,152,1,200,48,1,2.0
9874,6503.0,PARTY TIME PENCIL ERASERS,9,157,2,300,143,1,4.0
9875,6504.0,DISCO BALL CHRISTMAS DECORATION,4,537,11,1200,663,1,22.0
9876,6505.0,PINK B'FLY C/COVER W BOBBLES,1,461,19,2000,1539,1,38.0
9877,6506.0,PINK UNION JACK  LUGGAGE TAG,6,1061,10,1100,39,1,20.0
9878,6507.0,11 RIBBONS ELEGANT CHRISTMAS ,6,1248,17,1800,552,1,34.0
9879,6508.0,UNION JACK FLAG LUGGAGE TAG,4,873,14,1500,627,1,28.0
9880,6509.0,AGED GLASS SILVER T-LIGHT HOLDER,5,274,2,300,26,1,4.0
9881,6510.0,BOOM BOX SPEAKER GIRLS,3,232,7,800,568,1,14.0
9882,6511.0,11 RIBBONS SHIMMERING PINKS ,3,898,10,1100,202,1,20.0
9883,6512.0, SET 2 TEA TOWELS I LOVE LONDON ,1,1390,13,1400,10,1,26.0
9884,6513.0,JUMBO BAG OWLS,8,698,11,1200,502,1,22.0
9885,6514.0,SANDWICH BATH SPONGE,7,276,2,300,24,1,4.0
9886,6515.0,OWL DOORSTOP,2,642,18,1900,1258,1,36.0
9887,6516.0,10 STRAND GLASS NECKLACE CRYSTAL,6,851,12,1300,449,1,24.0
9888,6517.0,HAND WARMER UNION JACK,2,372,6,700,328,1,12.0
9889,6518.0,HAND WARMER SCOTTY DOG DESIGN,5,1106,14,1500,394,1,28.0
9890,6519.0,LARGE POPCORN HOLDER ,7,1595,24,2500,905,1,48.0
9891,6520.0,PAINTED METAL STAR WITH HOLLY BELLS,4,343,6,700,357,1,12.0
9892,6521.0,PAINTED METAL HEART WITH HOLLY BELL,3,2183,22,2300,117,1,44.0
9893,6522.0,ANGEL DECORATION STARS ON DRESS,9,941,22,2300,1359,1,44.0
9894,6523.0,SMALL POPCORN HOLDER,1,936,9,1000,64,1,18.0
9895,6524.0,JUMBO BAG RED RETROSPOT,5,407,4,500,93,1,8.0
9896,6525.0,JUMBO BAG STRAWBERRY,8,702,25,2600,1898,1,50.0
9897,6526.0,STRAWBERRY SHOPPER BAG,8,223,14,1500,1277,1,28.0
9898,6527.0,STRAWBERRY CHARLOTTE BAG,1,1370,23,2400,1030,1,46.0
9899,6528.0, SET 2 TEA TOWELS I LOVE LONDON ,10,199,1,200,1,1,2.0
9900,6529.0,PACK OF 12 RED RETROSPOT TISSUES ,6,474,7,800,326,1,14.0
9901,6530.0,SCOTTIE DOG HOT WATER BOTTLE,6,425,4,500,75,1,8.0
9902,6531.0,CHOCOLATE HOT WATER BOTTLE,10,937,14,1500,563,1,28.0
9903,6532.0,LUNCH BAG CARS BLUE,5,266,16,1700,1434,1,32.0
9904,6533.0,LUNCH BAG SPACEBOY DESIGN ,1,100,0,100,0,1,0.0
9905,6534.0,ROUND SNACK BOXES SET OF4 WOODLAND ,3,554,18,1900,1346,1,36.0
9906,6535.0,LUNCH BAG DOLLY GIRL DESIGN,4,1362,19,2000,638,1,38.0
9907,6536.0,LUNCH BAG SUKI  DESIGN ,2,636,16,1700,1064,1,32.0
9908,6537.0,LUNCH BAG  BLACK SKULL.,6,455,6,700,245,1,12.0
9909,6538.0,ROUND SNACK BOXES SET OF 4 FRUITS ,5,129,12,1300,1171,1,24.0
9910,6539.0,ROUND SNACK BOXES SET OF 4 SKULLS,3,504,6,700,196,1,12.0
9911,6540.0,DOLLY GIRL LUNCH BOX,6,1371,24,2500,1129,1,48.0
9912,6541.0,SPACEBOY LUNCH BOX ,3,913,11,1200,287,1,22.0
9913,6542.0,GREEN POLKADOT PLATE ,1,758,13,1400,642,1,26.0
9914,6543.0,BLUE POLKADOT PLATE ,6,100,0,100,0,1,0.0
9915,6544.0,RED RETROSPOT PLATE ,2,100,0,100,0,1,0.0
9916,6545.0,PINK  POLKADOT PLATE ,3,223,6,700,477,1,12.0
9917,6546.0,ROUND SNACK BOXES SET OF 4 SKULLS,1,115,3,400,285,1,6.0
9918,6547.0,FELTCRAFT DOLL MOLLY,4,147,1,200,53,1,2.0
9919,6548.0,FELTCRAFT CHRISTMAS FAIRY,6,499,8,900,401,1,16.0
9920,6549.0,TRAVEL SEWING KIT,10,100,0,100,0,1,0.0
9921,6550.0,SET OF 3 NOTEBOOKS IN PARCEL,1,219,11,1200,981,1,22.0
9922,6551.0,RED RETROSPOT TAPE,3,385,13,1400,1015,1,26.0
9923,6552.0,COSY SLIPPER SHOES SMALL  RED ,4,1894,19,2000,106,1,38.0
9924,6553.0,11 RIBBONS RUSTIC CHARM,1,411,4,500,89,1,8.0
9925,6554.0,SCANDINAVIAN REDS RIBBONS,3,261,10,1100,839,1,20.0
9926,6555.0,JAM MAKING SET PRINTED,8,825,8,900,75,1,16.0
9927,6556.0,17 DAISY PEGS IN WOOD BOX,4,1149,12,1300,151,1,24.0
9928,6557.0,HOT WATER BOTTLE BABUSHKA ,4,371,8,900,529,1,16.0
9929,6558.0,FELTCRAFT PRINCESS CHARLOTTE DOLL,3,1020,11,1200,180,1,22.0
9930,6559.0,FELTCRAFT CHRISTMAS FAIRY,10,650,8,900,250,1,16.0
9931,6560.0,FELTCRAFT PRINCESS CHARLOTTE DOLL,3,365,3,400,35,1,6.0
9932,6561.0,11 RIBBONS RUSTIC CHARM,2,100,0,100,0,1,0.0
9933,6562.0,COSY SLIPPER SHOES SMALL  RED ,4,673,21,2200,1527,1,42.0
9934,6563.0,SCANDINAVIAN REDS RIBBONS,9,1536,17,1800,264,1,34.0
9935,6564.0,10 HOOK HANGER RED MAGIC TOADSTOOL,5,1080,23,2400,1320,1,46.0
9936,6565.0,CHRISTMAS CRAFT TREE TOP ANGEL,5,192,18,1900,1708,1,36.0
9937,6566.0,CHRISTMAS CRAFT LITTLE FRIENDS,5,254,12,1300,1046,1,24.0
9938,6567.0,10 HOOK HANGER RED MAGIC TOADSTOOL,10,951,9,1000,49,1,18.0
9939,6568.0,11 RIBBONS RUSTIC CHARM,6,672,15,1600,928,1,30.0
9940,6569.0,17 DAISY PEGS IN WOOD BOX,10,474,8,900,426,1,16.0
9941,6570.0,SET OF 3 NOTEBOOKS IN PARCEL,9,188,3,400,212,1,6.0
9942,6571.0,10 HOOK HANGER MAGIC TOADSTOOL,6,591,19,2000,1409,1,38.0
9943,6572.0,SCANDINAVIAN REDS RIBBONS,8,530,11,1200,670,1,22.0
9944,6573.0,RED TOADSTOOL LED NIGHT LIGHT,3,345,5,600,255,1,10.0
9945,6574.0,10 HOOK HANGER RED MAGIC TOADSTOOL,9,1299,15,1600,301,1,30.0
9946,6575.0,COSY SLIPPER SHOES SMALL GREEN,9,100,0,100,0,1,0.0
9947,6576.0,COSY SLIPPER SHOES SMALL  RED ,5,185,4,500,315,1,8.0
9948,6577.0,FELTCRAFT DOLL ROSIE,4,273,4,500,227,1,8.0
9949,6578.0,FELTCRAFT DOLL MOLLY,10,208,15,1600,1392,1,30.0
9950,6579.0,FELTCRAFT DOLL EMILY,1,218,13,1400,1182,1,26.0
9951,6580.0,FELTCRAFT PRINCESS CHARLOTTE DOLL,8,297,3,400,103,1,6.0
9952,6581.0,FELTCRAFT PRINCESS OLIVIA DOLL,10,486,24,2500,2014,1,48.0
9953,6582.0,REX CASH+CARRY JUMBO SHOPPER,9,1216,15,1600,384,1,30.0
9954,6583.0,FELTCRAFT DOLL MOLLY,9,100,1,200,100,1,2.0
9955,6584.0,FELTCRAFT CUSHION OWL,6,355,25,2600,2245,1,50.0
9956,6585.0,CHRISTMAS CRAFT TREE TOP ANGEL,3,317,15,1600,1283,1,30.0
9957,6586.0,CHRISTMAS CRAFT LITTLE FRIENDS,5,175,4,500,325,1,8.0
9958,6587.0,FELTCRAFT CUSHION RABBIT,8,332,17,1800,1468,1,34.0
9959,6588.0,FELTCRAFT CUSHION BUTTERFLY,4,1654,21,2200,546,1,42.0
9960,6589.0,17 DAISY PEGS IN WOOD BOX,6,1389,20,2100,711,1,40.0
9961,6590.0,PAPER CHAIN KIT 50'S CHRISTMAS ,1,348,4,500,152,1,8.0
9962,6591.0,FELTCRAFT CUSHION BUTTERFLY,7,770,11,1200,430,1,22.0
9963,6592.0,17 DAISY PEGS IN WOOD BOX,4,432,10,1100,668,1,20.0
9964,6593.0,ROSE COTTAGE KEEPSAKE BOX ,8,520,14,1500,980,1,28.0
9965,6594.0,TOTE BAG I LOVE LONDON,7,919,16,1700,781,1,32.0
9966,6595.0,17 DAISY PEGS IN WOOD BOX,4,1549,15,1600,51,1,30.0
9967,6596.0,TOTE BAG I LOVE LONDON,6,1277,20,2100,823,1,40.0
9968,6597.0,FOLDING UMBRELLA PINKWHITE POLKADOT,6,1772,20,2100,328,1,40.0
9969,6598.0,FOLDING UMBRELLA CREAM POLKADOT,6,136,5,600,464,1,10.0
9970,6599.0,FOLDING UMBRELLA WHITE/RED POLKADOT,1,325,5,600,275,1,10.0
9971,6600.0,SET 10 LIGHTS NIGHT OWL,3,1215,24,2500,1285,1,48.0
9972,6601.0,SMALL POPCORN HOLDER,8,732,13,1400,668,1,26.0
9973,6602.0, SET 2 TEA TOWELS I LOVE LONDON ,5,277,9,1000,723,1,18.0
9974,6603.0,FOLDING UMBRELLA RED/WHITE POLKADOT,1,854,14,1500,646,1,28.0
9975,6604.0,BABUSHKA LIGHTS STRING OF 15,6,1461,16,1700,239,1,32.0
9976,6605.0,LUNCH BAG RED RETROSPOT,9,1980,19,2000,20,1,38.0
9977,6606.0,S/4 VALENTINE DECOUPAGE HEART BOX,1,646,18,1900,1254,1,36.0
9978,6607.0,FOLDING UMBRELLA CREAM POLKADOT,7,100,0,100,0,1,0.0
9979,6608.0, SET 2 TEA TOWELS I LOVE LONDON ,6,273,7,800,527,1,14.0
9980,6609.0,FOLDING UMBRELLA RED/WHITE POLKADOT,2,1217,12,1300,83,1,24.0
9981,6610.0,SOLDIERS EGG CUP ,1,723,21,2200,1477,1,42.0
9982,6611.0,S/4 VALENTINE DECOUPAGE HEART BOX,10,717,9,1000,283,1,18.0
9983,6612.0,RED RETROSPOT MINI CASES,1,752,17,1800,1048,1,34.0
9984,6613.0,,4,171,7,800,629,1,14.0
9985,6614.0,65 CAKE CASES VINTAGE CHRISTMAS,6,543,6,700,157,1,12.0
9986,6615.0,PAPER CHAIN KIT VINTAGE CHRISTMAS,3,1173,14,1500,327,1,28.0
9987,6616.0,RIBBON REEL CHRISTMAS SOCK BAUBLE,4,1669,22,2300,631,1,44.0
9988,6617.0,RIBBON REEL SNOWY VILLAGE,7,1309,23,2400,1091,1,46.0
9989,6618.0,RIBBON REEL MAKING SNOWMEN ,3,453,9,1000,547,1,18.0
9990,6619.0,SET OF 20 VINTAGE CHRISTMAS NAPKINS,5,592,14,1500,908,1,28.0
9991,6620.0,TURQUOISE CHRISTMAS TREE ,2,1566,17,1800,234,1,34.0
9992,6621.0,RED STAR CARD HOLDER,2,155,2,300,145,1,4.0
9993,6622.0,WICKER WREATH SMALL,9,378,18,1900,1522,1,36.0
9994,6623.0,HEART OF WICKER LARGE,1,593,5,600,7,1,10.0
9995,6624.0,ADVENT CALENDAR GINGHAM SACK,9,201,14,1500,1299,1,28.0
9996,6625.0,HEART OF WICKER SMALL,5,352,4,500,148,1,8.0
9997,6626.0,FELTCRAFT BUTTERFLY HEARTS,9,1157,23,2400,1243,1,46.0
9998,6627.0,PARTY CONE CHRISTMAS DECORATION ,1,130,4,500,370,1,8.0
9999,6628.0,VINTAGE HEADS AND TAILS CARD GAME ,1,1238,18,1900,662,1,36.0
10000,6629.0,WICKER STAR ,3,455,19,2000,1545,1,38.0
10001,6630.0,VINTAGE SNAP CARDS,2,315,6,700,385,1,12.0
10002,6631.0,FELTCRAFT 6 FLOWER FRIENDS,6,348,8,900,552,1,16.0
10003,6632.0, SET 2 TEA TOWELS I LOVE LONDON ,4,100,0,100,0,1,0.0
10004,6633.0,JAM MAKING SET PRINTED,4,246,10,1100,854,1,20.0
10005,6634.0,BIRD DECORATION RED RETROSPOT,10,643,10,1100,457,1,20.0
10006,6635.0,CHRISTMAS GINGHAM TREE,8,625,14,1500,875,1,28.0
10007,6636.0,CHRISTMAS GINGHAM STAR,6,2250,22,2300,50,1,44.0
10008,6637.0,CHRISTMAS GINGHAM HEART,1,513,11,1200,687,1,22.0
10009,6638.0,PACK OF 12 PINK POLKADOT TISSUES,7,117,13,1400,1283,1,26.0
10010,6639.0,FELTCRAFT PRINCESS LOLA DOLL,1,233,4,500,267,1,8.0
10011,6640.0,PACK OF 12 LONDON TISSUES ,5,1543,16,1700,157,1,32.0
10012,6641.0,PURPLE DRAWERKNOB ACRYLIC EDWARDIAN,1,1079,13,1400,321,1,26.0
10013,6642.0,CHILDREN'S APRON DOLLY GIRL ,7,285,7,800,515,1,14.0
10014,6643.0,CHILDRENS APRON SPACEBOY DESIGN,9,673,16,1700,1027,1,32.0
10015,6644.0,CHRISTMAS LIGHTS 10 SANTAS ,5,332,6,700,368,1,12.0
10016,6645.0,CHRISTMAS LIGHTS 10 REINDEER,10,522,14,1500,978,1,28.0
10017,6646.0,PAPER CHAIN KIT 50'S CHRISTMAS ,4,112,3,400,288,1,6.0
10018,6647.0,FELTCRAFT CHRISTMAS FAIRY,10,766,13,1400,634,1,26.0
10019,6648.0,PACK OF 72 RETROSPOT CAKE CASES,4,789,8,900,111,1,16.0
10020,6649.0,PACK OF 60 MUSHROOM CAKE CASES,5,100,0,100,0,1,0.0
10021,6650.0,65 CAKE CASES DOLLY GIRL DESIGN,6,169,1,200,31,1,2.0
10022,6651.0,PACK OF 60 PINK PAISLEY CAKE CASES,4,2058,25,2600,542,1,50.0
10023,6652.0,HAND WARMER BABUSHKA DESIGN,7,613,6,700,87,1,12.0
10024,6653.0,HAND WARMER BIRD DESIGN,3,290,10,1100,810,1,20.0
10025,6654.0,HAND WARMER OWL DESIGN,9,906,11,1200,294,1,22.0
10026,6655.0,HAND WARMER RED RETROSPOT,6,1138,13,1400,262,1,26.0
10027,6656.0,SET 12 RETRO WHITE CHALK STICKS,6,1817,18,1900,83,1,36.0
10028,6657.0,FELTCRAFT HAIRBAND RED AND BLUE,6,722,19,2000,1278,1,38.0
10029,6658.0,FELTCRAFT HAIRBAND PINK AND PURPLE,3,126,21,2200,2074,1,42.0
10030,6659.0,FELTCRAFT HAIRBANDS PINK AND WHITE ,3,405,16,1700,1295,1,32.0
10031,6660.0,TV DINNER TRAY DOLLY GIRL,1,440,6,700,260,1,12.0
10032,6661.0,PLASTERS IN TIN VINTAGE PAISLEY ,5,199,9,1000,801,1,18.0
10033,6662.0,PLASTERS IN TIN SPACEBOY,8,158,18,1900,1742,1,36.0
10034,6663.0,PLASTERS IN TIN WOODLAND ANIMALS,6,373,21,2200,1827,1,42.0
10035,6664.0,MAGIC DRAWING SLATE SPACEBOY ,5,1784,18,1900,116,1,36.0
10036,6665.0,MAGIC DRAWING SLATE CIRCUS PARADE  ,4,575,5,600,25,1,10.0
10037,6666.0,MAGIC DRAWING SLATE GO TO THE FAIR ,1,1009,15,1600,591,1,30.0
10038,6667.0,MAGIC DRAWING SLATE DOLLY GIRL ,3,363,10,1100,737,1,20.0
10039,6668.0,CHARLIE + LOLA RED HOT WATER BOTTLE,5,164,1,200,36,1,2.0
10040,6669.0,HOT WATER BOTTLE BABUSHKA ,2,171,8,900,729,1,16.0
10041,6670.0,URBAN BLACK RIBBONS ,5,175,7,800,625,1,14.0
10042,6671.0,FELTCRAFT PRINCESS CHARLOTTE DOLL,9,213,12,1300,1087,1,24.0
10043,6672.0,SET OF 6 T-LIGHTS TOADSTOOLS,5,421,21,2200,1779,1,42.0
10044,6673.0,ROTATING LEAVES T-LIGHT HOLDER,5,575,9,1000,425,1,18.0
10045,6674.0,RED  HARMONICA IN BOX ,2,812,12,1300,488,1,24.0
10046,6675.0,CUPCAKE LACE PAPER SET 11,8,180,1,200,20,1,2.0
10047,6676.0,FAMILY PHOTO FRAME CORNICE,2,221,8,900,679,1,16.0
10048,6677.0,TRIPLE PHOTO FRAME CORNICE ,6,525,16,1700,1175,1,32.0
10049,6678.0,WOODEN FRAME ANTIQUE WHITE ,6,167,5,600,433,1,10.0
10050,6679.0,WOODEN BOX OF DOMINOES,4,524,23,2400,1876,1,46.0
10051,6680.0,TRADITIONAL WOODEN CATCH CUP GAME ,3,312,5,600,288,1,10.0
10052,6681.0,TRADITIONAL WOODEN SKIPPING ROPE,7,1212,18,1900,688,1,36.0
10053,6682.0,S/6 WOODEN SKITTLES IN COTTON BAG,8,1046,21,2200,1154,1,42.0
10054,6683.0,RED METAL BEACH SPADE ,7,886,9,1000,114,1,18.0
10055,6684.0,BOYS VINTAGE TIN SEASIDE BUCKET,2,100,0,100,0,1,0.0
10056,6685.0,GIRLS VINTAGE TIN SEASIDE BUCKET,10,1131,24,2500,1369,1,48.0
10057,6686.0,GREY HEART HOT WATER BOTTLE,5,100,0,100,0,1,0.0
10058,6687.0,SCOTTIE DOG HOT WATER BOTTLE,1,383,23,2400,2017,1,46.0
10059,6688.0,BIRD HOUSE HOT WATER BOTTLE,4,100,0,100,0,1,0.0
10060,6689.0,KINGS CHOICE TEA CADDY ,1,737,11,1200,463,1,22.0
10061,6690.0,KINGS CHOICE BISCUIT TIN,3,752,12,1300,548,1,24.0
10062,6691.0,METAL SIGN EMPIRE TEA,3,828,12,1300,472,1,24.0
10063,6692.0,HOMEMADE JAM SCENTED CANDLES,6,270,2,300,30,1,4.0
10064,6693.0,SET OF 6 SOLDIER SKITTLES,9,100,0,100,0,1,0.0
10065,6694.0,FAWN BLUE HOT WATER BOTTLE,5,1391,17,1800,409,1,34.0
10066,6695.0,HAND WARMER RED RETROSPOT,6,748,13,1400,652,1,26.0
10067,6696.0,HOT WATER BOTTLE BABUSHKA ,10,283,8,900,617,1,16.0
10068,6697.0,WHITE SKULL HOT WATER BOTTLE ,6,100,0,100,0,1,0.0
10069,6698.0,RETROSPOT HEART HOT WATER BOTTLE,6,1208,20,2100,892,1,40.0
10070,6699.0,RED WOOLLY HOTTIE WHITE HEART.,6,100,0,100,0,1,0.0
10071,6700.0,SCOTTIE DOG HOT WATER BOTTLE,7,723,9,1000,277,1,18.0
10072,6701.0,GREY HEART HOT WATER BOTTLE,9,686,25,2600,1914,1,50.0
10073,6702.0,HOT WATER BOTTLE BABUSHKA ,4,170,2,300,130,1,4.0
10074,6703.0,PACK OF 6 BIRDY GIFT TAGS,9,741,7,800,59,1,14.0
10075,6704.0,CHILLI LIGHTS,1,999,21,2200,1201,1,42.0
10076,6705.0,PIGGY BANK RETROSPOT ,7,366,10,1100,734,1,20.0
10077,6706.0,CERAMIC STRAWBERRY MONEY BOX,6,1469,15,1600,131,1,30.0
10078,6707.0,CERAMIC STRAWBERRY CAKE MONEY BANK,2,2460,24,2500,40,1,48.0
10079,6708.0,CERAMIC CHERRY CAKE MONEY BANK,6,106,16,1700,1594,1,32.0
10080,6709.0,CERAMIC HEART FAIRY CAKE MONEY BANK,7,489,14,1500,1011,1,28.0
10081,6710.0,CERAMIC PIRATE CHEST MONEY BANK,10,637,17,1800,1163,1,34.0
10082,6711.0,DOORSTOP RETROSPOT HEART,10,317,6,700,383,1,12.0
10083,6712.0,GINGHAM HEART  DOORSTOP RED,5,205,13,1400,1195,1,26.0
10084,6713.0,RETROSPOT BABUSHKA DOORSTOP,5,1808,20,2100,292,1,40.0
10085,6714.0,SILK PURSE BABUSHKA RED,4,356,3,400,44,1,6.0
10086,6715.0,SILK PURSE BABUSHKA PINK,6,470,13,1400,930,1,26.0
10087,6716.0,FAMILY PHOTO FRAME CORNICE,4,1279,15,1600,321,1,30.0
10088,6717.0,SWEETHEART WIRE WALL TIDY,3,437,7,800,363,1,14.0
10089,6718.0,JAM MAKING SET PRINTED,10,1238,23,2400,1162,1,46.0
10090,6719.0,RED RETROSPOT OVEN GLOVE ,5,294,5,600,306,1,10.0
10091,6720.0,CREAM HEART CARD HOLDER,7,290,24,2500,2210,1,48.0
10092,6721.0,NAMASTE SWAGAT INCENSE,2,184,4,500,316,1,8.0
10093,6722.0,CERAMIC STRAWBERRY DESIGN MUG,2,268,13,1400,1132,1,26.0
10094,6723.0,BLACK HEART CARD HOLDER,8,776,23,2400,1624,1,46.0
10095,6724.0,CLASSICAL ROSE SMALL VASE,3,297,8,900,603,1,16.0
10096,6725.0,HYACINTH BULB T-LIGHT CANDLES,4,845,15,1600,755,1,30.0
10097,6726.0,CHRISTMAS CRAFT WHITE FAIRY ,1,319,4,500,181,1,8.0
10098,6727.0,CHRISTMAS CRAFT LITTLE FRIENDS,8,1142,18,1900,758,1,36.0
10099,6728.0,COSY HOUR CIGAR BOX MATCHES ,4,690,20,2100,1410,1,40.0
10100,6729.0,RED TEA TOWEL CLASSIC DESIGN,1,1433,20,2100,667,1,40.0
10101,6730.0,HEART FILIGREE DOVE  SMALL,5,2401,25,2600,199,1,50.0
10102,6731.0,RETROSPOT CHILDRENS APRON,8,1910,22,2300,390,1,44.0
10103,6732.0,COLOURING PENCILS BROWN TUBE,3,1039,16,1700,661,1,32.0
10104,6733.0,9 IVORY DINNER CANDLES SILVER FLOCK,5,325,3,400,75,1,6.0
10105,6734.0,HEART FILIGREE DOVE  SMALL,5,350,3,400,50,1,6.0
10106,6735.0,ZINC METAL HEART DECORATION,5,1244,15,1600,356,1,30.0
10107,6736.0,GREEN FERN NOTEBOOK,2,206,13,1400,1194,1,26.0
10108,6737.0,BLUE PAISLEY NOTEBOOK,1,612,7,800,188,1,14.0
10109,6738.0,CHRYSANTHEMUM NOTEBOOK,3,360,4,500,140,1,8.0
10110,6739.0,LARGE CHINESE STYLE SCISSOR,2,512,16,1700,1188,1,32.0
10111,6740.0,SMALL CHINESE STYLE SCISSOR,6,731,12,1300,569,1,24.0
10112,6741.0,S/6 WOODEN SKITTLES IN COTTON BAG,6,100,0,100,0,1,0.0
10113,6742.0,TRADITIONAL WOODEN SKIPPING ROPE,8,1635,19,2000,365,1,38.0
10114,6743.0,SET OF 6 SOLDIER SKITTLES,5,123,6,700,577,1,12.0
10115,6744.0,9 TRADITIONAL SPINNING TOPS,4,198,11,1200,1002,1,22.0
10116,6745.0,ROTATING SILVER ANGELS T-LIGHT HLDR,8,842,18,1900,1058,1,36.0
10117,6746.0,BLACK LOVE BIRD CANDLE,7,380,23,2400,2020,1,46.0
10118,6747.0,RETROSPOT CHILDRENS APRON,3,458,6,700,242,1,12.0
10119,6748.0,HANGING GLASS ETCHED TEALIGHT,3,100,0,100,0,1,0.0
10120,6749.0,HANGING GLASS ETCHED TEALIGHT,4,1486,21,2200,714,1,42.0
10121,6750.0,BLUE NEW BAROQUE CANDLESTICK CANDLE,6,232,2,300,68,1,4.0
10122,6751.0,COOKING SET RETROSPOT,10,1712,19,2000,288,1,38.0
10123,6752.0,KINGS CHOICE GIANT TUBE MATCHES,7,446,13,1400,954,1,26.0
10124,6753.0,COSY HOUR GIANT TUBE MATCHES,2,532,5,600,68,1,10.0
10125,6754.0,PLACE SETTING WHITE STAR,10,1733,22,2300,567,1,44.0
10126,6755.0,HYACINTH BULB T-LIGHT CANDLES,8,597,5,600,3,1,10.0
10127,6756.0,S/15 SILVER GLASS BAUBLES IN BAG,6,113,23,2400,2287,1,46.0
10128,6757.0,FRENCH WC SIGN BLUE METAL,8,724,13,1400,676,1,26.0
10129,6758.0,KINGS CHOICE GIANT TUBE MATCHES,1,1272,14,1500,228,1,28.0
10130,6759.0,77 SWEETHEART FAIRY CAKE CASES,9,229,2,300,71,1,4.0
10131,6760.0,ASSORTED COLOUR BIRD ORNAMENT,1,1466,19,2000,534,1,38.0
10132,6761.0,FAIRY SOAP SOAP HOLDER,2,1314,20,2100,786,1,40.0
10133,6762.0,GREEN GIANT GARDEN THERMOMETER,1,959,11,1200,241,1,22.0
10134,6763.0,IVORY GIANT GARDEN THERMOMETER,1,354,8,900,546,1,16.0
10135,6764.0,BLUE GIANT GARDEN THERMOMETER,2,976,21,2200,1224,1,42.0
10136,6765.0,PACK OF 60 PINK PAISLEY CAKE CASES,6,618,11,1200,582,1,22.0
10137,6766.0,RETROSPOT HEART HOT WATER BOTTLE,7,345,21,2200,1855,1,42.0
10138,6767.0,CHICK GREY HOT WATER BOTTLE,3,1126,11,1200,74,1,22.0
10139,6768.0,VICTORIAN SEWING BOX SMALL ,8,276,13,1400,1124,1,26.0
10140,6769.0,VICTORIAN SEWING BOX MEDIUM,2,492,13,1400,908,1,26.0
10141,6770.0,SET/10 RED POLKADOT PARTY CANDLES,6,146,16,1700,1554,1,32.0
10142,6771.0,WASHROOM METAL SIGN,10,2402,24,2500,98,1,48.0
10143,6772.0,BLACK SWEETHEART BRACELET,6,360,14,1500,1140,1,28.0
10144,6773.0,DIAMANTE HAIR GRIP PACK/2 BLACK DIA,3,440,9,1000,560,1,18.0
10145,6774.0,BLACK DIAMANTE EXPANDABLE RING,5,264,10,1100,836,1,20.0
10146,6775.0,DIAMANTE HAIR GRIP PACK/2 RUBY,10,757,12,1300,543,1,24.0
10147,6776.0,DIAMANTE HAIR GRIP PACK/2 MONTANA,9,554,6,700,146,1,12.0
10148,6777.0,BLUE SWEETHEART BRACELET,7,161,3,400,239,1,6.0
10149,6778.0,PINK SWEETHEART BRACELET,9,1329,15,1600,271,1,30.0
10150,6779.0,PURPLE SWEETHEART BRACELET,9,571,16,1700,1129,1,32.0
10151,6780.0,JUMBO BAG PINK POLKADOT,8,110,1,200,90,1,2.0
10152,6781.0,JUMBO BAG RED RETROSPOT,3,984,12,1300,316,1,24.0
10153,6782.0,ASSORTED COLOUR BIRD ORNAMENT,8,241,12,1300,1059,1,24.0
10154,6783.0,PAPER CHAIN KIT 50'S CHRISTMAS ,7,404,17,1800,1396,1,34.0
10155,6784.0,RIBBON REEL CHRISTMAS PRESENT ,2,200,12,1300,1100,1,24.0
10156,6785.0,FIRST AID TIN,2,512,8,900,388,1,16.0
10157,6786.0,MAKE YOUR OWN MONSOON CARD KIT,1,1533,24,2500,967,1,48.0
10158,6787.0,PACK OF 12 HEARTS DESIGN TISSUES ,9,1544,16,1700,156,1,32.0
10159,6788.0,PACK OF 12 RED RETROSPOT TISSUES ,7,1275,15,1600,325,1,30.0
10160,6789.0,SOLDIERS EGG CUP ,2,2010,24,2500,490,1,48.0
10161,6790.0,HEART IVORY TRELLIS SMALL,1,248,3,400,152,1,6.0
10162,6791.0,HEART FILIGREE DOVE  SMALL,10,100,0,100,0,1,0.0
10163,6792.0,HEART FILIGREE DOVE LARGE,4,1120,13,1400,280,1,26.0
10164,6793.0,PACK 3 BOXES BIRD PANNETONE ,6,287,15,1600,1313,1,30.0
10165,6794.0,PACK 3 BOXES CHRISTMAS PANNETONE,5,667,6,700,33,1,12.0
10166,6795.0,SMALL POPCORN HOLDER,6,225,2,300,75,1,4.0
10167,6796.0,PACK OF 60 PINK PAISLEY CAKE CASES,1,314,3,400,86,1,6.0
10168,6797.0,SET OF 6 SOLDIER SKITTLES,8,461,16,1700,1239,1,32.0
10169,6798.0,SWIRLY CIRCULAR RUBBERS IN BAG,6,452,14,1500,1048,1,28.0
10170,6799.0,VINTAGE PAISLEY STATIONERY SET,8,481,21,2200,1719,1,42.0
10171,6800.0,PAPER CHAIN KIT VINTAGE CHRISTMAS,3,354,7,800,446,1,14.0
10172,6801.0,SET/10 BLUE POLKADOT PARTY CANDLES,10,183,7,800,617,1,14.0
10173,6802.0,RIBBON REEL SOCKS AND MITTENS,8,597,10,1100,503,1,20.0
10174,6803.0,65 CAKE CASES VINTAGE CHRISTMAS,6,147,14,1500,1353,1,28.0
10175,6804.0,CHRISTMAS METAL TAGS ASSORTED ,1,100,0,100,0,1,0.0
10176,6805.0,CHRISTMAS TREE T-LIGHT HOLDER,1,568,9,1000,432,1,18.0
10177,6806.0,STAR  T-LIGHT HOLDER ,8,2221,25,2600,379,1,50.0
10178,6807.0,HEART T-LIGHT HOLDER ,5,1632,25,2600,968,1,50.0
10179,6808.0,MINI FUNKY DESIGN TAPES,10,1063,12,1300,237,1,24.0
10180,6809.0,SET OF 6 T-LIGHTS SNOWMEN,10,873,9,1000,127,1,18.0
10181,6810.0,STAR WOODEN CHRISTMAS DECORATION,4,252,13,1400,1148,1,26.0
10182,6811.0,WOODEN HEART CHRISTMAS SCANDINAVIAN,2,623,15,1600,977,1,30.0
10183,6812.0,CHRISTMAS RETROSPOT TREE WOOD,2,877,21,2200,1323,1,42.0
10184,6813.0,SET OF 6 T-LIGHTS SANTA,6,1053,15,1600,547,1,30.0
10185,6814.0,SET/9 CHRISTMAS T-LIGHTS SCENTED ,1,950,9,1000,50,1,18.0
10186,6815.0,BLUE ROSE FABRIC MIRROR,8,100,0,100,0,1,0.0
10187,6816.0,THREE CANVAS LUGGAGE TAGS,1,1069,21,2200,1131,1,42.0
10188,6817.0,RETROSPOT PARTY BAG + STICKER SET,9,101,10,1100,999,1,20.0
10189,6818.0,PLASTERS IN TIN VINTAGE PAISLEY ,4,163,1,200,37,1,2.0
10190,6819.0,RETROSPOT SMALL TUBE MATCHES,2,1210,23,2400,1190,1,46.0
10191,6820.0,HAND WARMER SCOTTY DOG DESIGN,5,198,12,1300,1102,1,24.0
10192,6821.0,3D CHRISTMAS STAMPS STICKERS ,5,280,7,800,520,1,14.0
10193,6822.0,HAND WARMER SCOTTY DOG DESIGN,2,128,1,200,72,1,2.0
10194,6823.0,HAND WARMER SCOTTY DOG DESIGN,9,1686,24,2500,814,1,48.0
10195,6824.0,CLOTHES PEGS RETROSPOT PACK 29,10,138,1,200,62,1,2.0
10196,6825.0,41 FOIL HEART CAKE CASES,3,884,11,1200,316,1,22.0
10197,6826.0,CHRISTMAS METAL TAGS ASSORTED ,8,1196,12,1300,104,1,24.0
10198,6827.0,PACK OF 6 SWEETIE GIFT BOXES,9,1109,19,2000,891,1,38.0
10199,6828.0,PACK OF 72 RETROSPOT CAKE CASES,5,448,20,2100,1652,1,40.0
10200,6829.0,PACK OF 72 RETROSPOT CAKE CASES,1,437,4,500,63,1,8.0
10201,6830.0,PACK OF 6 BIRDY GIFT TAGS,7,186,1,200,14,1,2.0
10202,6831.0,SET/10 RED POLKADOT PARTY CANDLES,10,693,11,1200,507,1,22.0
10203,6832.0,SET/10 PINK POLKADOT PARTY CANDLES,4,162,5,600,438,1,10.0
10204,6833.0,SET OF 3 NOTEBOOKS IN PARCEL,1,1575,16,1700,125,1,32.0
10205,6834.0,STAR  T-LIGHT HOLDER ,9,911,20,2100,1189,1,40.0
10206,6835.0,CINAMMON SET OF 9 T-LIGHTS,10,478,7,800,322,1,14.0
10207,6836.0,ORANGE SCENTED SET/9 T-LIGHTS,8,226,8,900,674,1,16.0
10208,6837.0,RIBBON REEL STRIPES DESIGN ,4,989,16,1700,711,1,32.0
10209,6838.0,SET OF 2 TINS JARDIN DE PROVENCE,10,1554,15,1600,46,1,30.0
10210,6839.0,MAKE YOUR OWN PLAYTIME CARD KIT,1,1068,16,1700,632,1,32.0
10211,6840.0,DINOSAURS  WRITING SET ,2,1364,20,2100,736,1,40.0
10212,6841.0,BALLOONS  WRITING SET ,7,398,17,1800,1402,1,34.0
10213,6842.0,SKULLS WRITING SET ,2,784,22,2300,1516,1,44.0
10214,6843.0,VINTAGE PAISLEY STATIONERY SET,6,243,9,1000,757,1,18.0
10215,6844.0,COSY SLIPPER SHOES SMALL  RED ,3,162,2,300,138,1,4.0
10216,6845.0,DOORMAT BLACK FLOCK ,2,272,22,2300,2028,1,44.0
10217,6846.0,JUMBO  BAG BAROQUE BLACK WHITE,8,146,1,200,54,1,2.0
10218,6847.0,JAM MAKING SET WITH JARS,7,716,7,800,84,1,14.0
10219,6848.0,ORANGE SCENTED SET/9 T-LIGHTS,10,356,5,600,244,1,10.0
10220,6849.0,CINAMMON SET OF 9 T-LIGHTS,4,113,2,300,187,1,4.0
10221,6850.0,HAND WARMER SCOTTY DOG DESIGN,1,180,14,1500,1320,1,28.0
10222,6851.0,CHRISTMAS DECOUPAGE CANDLE,5,1017,17,1800,783,1,34.0
10223,6852.0,HEART T-LIGHT HOLDER ,5,165,1,200,35,1,2.0
10224,6853.0,GROW YOUR OWN BASIL IN ENAMEL MUG,6,1387,15,1600,213,1,30.0
10225,6854.0,OFFICE MUG WARMER POLKADOT,1,1540,25,2600,1060,1,50.0
10226,6855.0,SMALL POPCORN HOLDER,9,492,25,2600,2108,1,50.0
10227,6856.0,JUMBO BAG DOLLY GIRL DESIGN,7,508,17,1800,1292,1,34.0
10228,6857.0,JAM MAKING SET WITH JARS,2,267,15,1600,1333,1,30.0
10229,6858.0,JAM MAKING SET PRINTED,2,284,17,1800,1516,1,34.0
10230,6859.0,SMALL GLASS HEART TRINKET POT,7,420,4,500,80,1,8.0
10231,6860.0,RED WOOLLY HOTTIE WHITE HEART.,6,834,18,1900,1066,1,36.0
10232,6861.0,BLACK RECORD COVER FRAME,6,100,0,100,0,1,0.0
10233,6862.0,"RECORD FRAME 7"" SINGLE SIZE ",6,156,6,700,544,1,12.0
10234,6863.0,41 PENCILS TUBE RED RETROSPOT,1,1949,23,2400,451,1,46.0
10235,6864.0,41 PENCILS TUBE WOODLAND,5,239,22,2300,2061,1,44.0
10236,6865.0,SET OF 6 SOLDIER SKITTLES,9,178,24,2500,2322,1,48.0
10237,6866.0,ROCKING HORSE RED CHRISTMAS ,8,1155,13,1400,245,1,26.0
10238,6867.0,CHRISTMAS GINGHAM HEART,4,134,1,200,66,1,2.0
10239,6868.0,CHRISTMAS GINGHAM STAR,8,354,13,1400,1046,1,26.0
10240,6869.0,HAND WARMER UNION JACK,9,155,1,200,45,1,2.0
10241,6870.0,HAND WARMER RED RETROSPOT,6,632,22,2300,1668,1,44.0
10242,6871.0,REGENCY CAKESTAND 3 TIER,7,579,12,1300,721,1,24.0
10243,6872.0,JUMBO SHOPPER VINTAGE RED PAISLEY,5,127,9,1000,873,1,18.0
10244,6873.0,RIBBON REEL SNOWY VILLAGE,3,2150,24,2500,350,1,48.0
10245,6874.0,VINTAGE UNION JACK BUNTING,3,497,14,1500,1003,1,28.0
10246,6875.0,JAM MAKING SET WITH JARS,8,1431,20,2100,669,1,40.0
10247,6876.0,RIBBON REEL STRIPES DESIGN ,3,336,3,400,64,1,6.0
10248,6877.0,RETRO LONGBOARD IRONING BOARD COVER,4,879,21,2200,1321,1,42.0
10249,6878.0,3D DOG PICTURE PLAYING CARDS,6,1495,23,2400,905,1,46.0
10250,6879.0,RETROSPOT CIGAR BOX MATCHES ,5,711,16,1700,989,1,32.0
10251,6880.0,SET/9 CHRISTMAS T-LIGHTS SCENTED ,8,210,12,1300,1090,1,24.0
10252,6881.0,ROTATING SILVER ANGELS T-LIGHT HLDR,6,234,15,1600,1366,1,30.0
10253,6882.0,ROTATING SILVER ANGELS T-LIGHT HLDR,4,1259,23,2400,1141,1,46.0
10254,6883.0,SAVE THE PLANET COTTON TOTE BAG,9,546,9,1000,454,1,18.0
10255,6884.0,SET OF 20 VINTAGE CHRISTMAS NAPKINS,3,366,3,400,34,1,6.0
10256,6885.0,PAPER BUNTING WHITE LACE,6,571,5,600,29,1,10.0
10257,6886.0,GENTLEMAN SHIRT REPAIR KIT ,1,229,7,800,571,1,14.0
10258,6887.0,CARD I LOVE LONDON ,1,940,9,1000,60,1,18.0
10259,6888.0,PAPER CHAIN KIT VINTAGE CHRISTMAS,1,1388,18,1900,512,1,36.0
10260,6889.0,MIRRORED WALL ART FOXY,2,143,13,1400,1257,1,26.0
10261,6890.0,MIRRORED WALL ART GENTS,2,1238,23,2400,1162,1,46.0
10262,6891.0,AIRLINE BAG VINTAGE JET SET WHITE,10,588,6,700,112,1,12.0
10263,6892.0,JAM MAKING SET PRINTED,8,248,18,1900,1652,1,36.0
10264,6893.0,POTTING SHED SOW 'N' GROW SET,7,388,6,700,312,1,12.0
10265,6894.0,BABUSHKA LIGHTS STRING OF 15,9,596,17,1800,1204,1,34.0
10266,6895.0,REX CASH+CARRY JUMBO SHOPPER,7,113,3,400,287,1,6.0
10267,6896.0,AIRLINE BAG VINTAGE WORLD CHAMPION ,2,170,2,300,130,1,4.0
10268,6897.0,HAND WARMER BIRD DESIGN,5,442,11,1200,758,1,22.0
10269,6898.0,CHRISTMAS CRAFT LITTLE FRIENDS,10,356,6,700,344,1,12.0
10270,6899.0,PINK HEARTS PAPER GARLAND,1,1143,25,2600,1457,1,50.0
10271,6900.0,POTTING SHED SEED ENVELOPES,5,525,5,600,75,1,10.0
10272,6901.0,HI TEC ALPINE HAND WARMER,9,401,19,2000,1599,1,38.0
10273,6902.0,FELTCRAFT CHRISTMAS FAIRY,8,671,11,1200,529,1,22.0
10274,6903.0,HI TEC ALPINE HAND WARMER,5,2010,21,2200,190,1,42.0
10275,6904.0,ROTATING SILVER ANGELS T-LIGHT HLDR,3,1203,15,1600,397,1,30.0
10276,6905.0,8 STRIPEY MICE FELTCRAFT,5,152,4,500,348,1,8.0
10277,6906.0,FELTCRAFT 6 FLOWER FRIENDS,8,487,15,1600,1113,1,30.0
10278,6907.0,CHRISTMAS CRAFT LITTLE FRIENDS,4,552,19,2000,1448,1,38.0
10279,6908.0,VINTAGE UNION JACK CUSHION COVER,1,422,16,1700,1278,1,32.0
10280,6909.0,POLYESTER FILLER PAD 45x45cm,3,150,1,200,50,1,2.0
10281,6910.0,DOLLY GIRL LUNCH BOX,4,2056,20,2100,44,1,40.0
10282,6911.0,PACK OF 12 LONDON TISSUES ,7,1070,12,1300,230,1,24.0
10283,6912.0,CARD DOLLY GIRL ,1,391,8,900,509,1,16.0
10284,6913.0,CARD BILLBOARD FONT,2,192,1,200,8,1,2.0
10285,6914.0,RAINY LADIES BIRTHDAY CARD,6,345,13,1400,1055,1,26.0
10286,6915.0,GREY HEART HOT WATER BOTTLE,2,1167,19,2000,833,1,38.0
10287,6916.0,RED WOOLLY HOTTIE WHITE HEART.,3,1366,15,1600,234,1,30.0
10288,6917.0,RED WHITE SCARF  HOT WATER BOTTLE,8,291,5,600,309,1,10.0
10289,6918.0, SET 2 TEA TOWELS I LOVE LONDON ,1,1313,20,2100,787,1,40.0
10290,6919.0,SET OF 2 TEA TOWELS APPLE AND PEARS,2,1135,18,1900,765,1,36.0
10291,6920.0,SET/2 RED RETROSPOT TEA TOWELS ,5,696,6,700,4,1,12.0
10292,6921.0,LOVE BUILDING BLOCK WORD,7,124,1,200,76,1,2.0
10293,6922.0,HOME BUILDING BLOCK WORD,7,1648,24,2500,852,1,48.0
10294,6923.0,ASSORTED COLOUR BIRD ORNAMENT,4,100,0,100,0,1,0.0
10295,6924.0,LANTERN CREAM GAZEBO ,5,215,4,500,285,1,8.0
10296,6925.0,BLUE BIRDHOUSE DECORATION,3,206,15,1600,1394,1,30.0
10297,6926.0,WHITE HANGING HEART T-LIGHT HOLDER,4,358,6,700,342,1,12.0
10298,6927.0,REGENCY CAKESTAND 3 TIER,3,818,16,1700,882,1,32.0
10299,6928.0,ANTIQUE SILVER TEA GLASS ENGRAVED,5,1671,24,2500,829,1,48.0
10300,6929.0,AGED GLASS SILVER T-LIGHT HOLDER,5,1396,16,1700,304,1,32.0
10301,6930.0,JAM MAKING SET WITH JARS,6,110,3,400,290,1,6.0
10302,6931.0,HAND WARMER OWL DESIGN,8,201,10,1100,899,1,20.0
10303,6932.0,SET OF 2 WOODEN MARKET CRATES,5,409,18,1900,1491,1,36.0
10304,6933.0,SET OF 6 T-LIGHTS TOADSTOOLS,7,175,1,200,25,1,2.0
10305,6934.0,HAND WARMER UNION JACK,9,568,5,600,32,1,10.0
10306,6935.0,HAND WARMER SCOTTY DOG DESIGN,4,783,15,1600,817,1,30.0
10307,6936.0,CLASSIC FRENCH STYLE BASKET NATURAL,5,1948,21,2200,252,1,42.0
10308,6937.0,CRAZY DAISY HEART DECORATION,2,422,9,1000,578,1,18.0
10309,6938.0,GIN + TONIC DIET METAL SIGN,7,1428,15,1600,172,1,30.0
10310,6939.0,IVORY GIANT GARDEN THERMOMETER,4,247,6,700,453,1,12.0
10311,6940.0,CARD HOLDER GINGHAM HEART,1,100,0,100,0,1,0.0
10312,6941.0,SMALL STRIPES CHOCOLATE GIFT BAG ,2,262,3,400,138,1,6.0
10313,6942.0,S/6 WOODEN SKITTLES IN COTTON BAG,10,1158,12,1300,142,1,24.0
10314,6943.0,HAND WARMER RED RETROSPOT,3,1297,14,1500,203,1,28.0
10315,6944.0,HAND WARMER UNION JACK,5,500,21,2200,1700,1,42.0
10316,6945.0,FRENCH WC SIGN BLUE METAL,3,110,1,200,90,1,2.0
10317,6946.0,PINK UNION JACK  LUGGAGE TAG,7,924,10,1100,176,1,20.0
10318,6947.0,"TRAY, BREAKFAST IN BED",6,347,21,2200,1853,1,42.0
10319,6948.0,PIZZA PLATE IN BOX,1,119,4,500,381,1,8.0
10320,6949.0,HEART OF WICKER LARGE,7,100,0,100,0,1,0.0
10321,6950.0,PINK HEART DOTS HOT WATER BOTTLE,3,606,23,2400,1794,1,46.0
10322,6951.0,PLACE SETTING WHITE HEART,2,2404,25,2600,196,1,50.0
10323,6952.0,SET OF 4 NAPKIN CHARMS LEAVES   ,9,1323,22,2300,977,1,44.0
10324,6953.0,SET OF 4 NAPKIN CHARMS STARS   ,5,189,14,1500,1311,1,28.0
10325,6954.0,SET OF 4 NAPKIN CHARMS CUTLERY,8,467,19,2000,1533,1,38.0
10326,6955.0,CARAVAN SQUARE TISSUE BOX,6,858,15,1600,742,1,30.0
10327,6956.0,PLASTERS IN TIN SKULLS,9,611,11,1200,589,1,22.0
10328,6957.0,PLASTERS IN TIN SPACEBOY,7,176,7,800,624,1,14.0
10329,6958.0,BUTTON BOX ,4,425,4,500,75,1,8.0
10330,6959.0,PLASTERS IN TIN VINTAGE PAISLEY ,6,884,14,1500,616,1,28.0
10331,6960.0,17 MESSAGE CARDS WITH ENVELOPES,9,118,1,200,82,1,2.0
10332,6961.0,SMALL RED BABUSHKA NOTEBOOK ,6,751,25,2600,1849,1,50.0
10333,6962.0,CUPCAKE LACE PAPER SET 11,3,796,9,1000,204,1,18.0
10334,6963.0,PACK 3 BOXES CHRISTMAS PANNETONE,10,172,8,900,728,1,16.0
10335,6964.0,HERB MARKER MINT,6,1066,12,1300,234,1,24.0
10336,6965.0,HERB MARKER ROSEMARY,3,1051,18,1900,849,1,36.0
10337,6966.0,HERB MARKER BASIL,2,586,9,1000,414,1,18.0
10338,6967.0,HERB MARKER CHIVES ,6,267,5,600,333,1,10.0
10339,6968.0,HERB MARKER PARSLEY,5,1087,23,2400,1313,1,46.0
10340,6969.0,HERB MARKER THYME,8,276,8,900,624,1,16.0
10341,6970.0,WHITE HANGING HEART T-LIGHT HOLDER,4,1666,16,1700,34,1,32.0
10342,6971.0,METAL MERRY CHRISTMAS WREATH,10,256,12,1300,1044,1,24.0
10343,6972.0,WHITE CHRISTMAS GARLAND STARS TREES,10,112,4,500,388,1,8.0
10344,6973.0,RETROSPOT SMALL TUBE MATCHES,9,778,9,1000,222,1,18.0
10345,6974.0,RETROSPOT GIANT TUBE MATCHES,3,295,8,900,605,1,16.0
10346,6975.0,PLACE SETTING WHITE STAR,7,1243,15,1600,357,1,30.0
10347,6976.0,GROW YOUR OWN BASIL IN ENAMEL MUG,4,187,1,200,13,1,2.0
10348,6977.0,41 FOIL STAR CAKE CASES ,8,481,5,600,119,1,10.0
10349,6978.0,41 FOIL HEART CAKE CASES,4,487,13,1400,913,1,26.0
10350,6979.0,PACK OF 6 SWEETIE GIFT BOXES,9,180,23,2400,2220,1,46.0
10351,6980.0,PACK OF 6 HANDBAG GIFT BOXES,10,100,0,100,0,1,0.0
10352,6981.0,GARLAND WOODEN HAPPY EASTER,3,350,3,400,50,1,6.0
10353,6982.0,CALENDAR PAPER CUT DESIGN,1,853,17,1800,947,1,34.0
10354,6983.0,CALENDAR IN SEASON DESIGN,9,176,2,300,124,1,4.0
10355,6984.0,SMALL POPCORN HOLDER,7,128,2,300,172,1,4.0
10356,6985.0,BLUE PAISLEY TISSUE BOX,8,592,13,1400,808,1,26.0
10357,6986.0,HEART OF WICKER SMALL,5,505,11,1200,695,1,22.0
10358,6987.0,SKULLS SQUARE TISSUE BOX,6,100,0,100,0,1,0.0
10359,6988.0,SKULLS SQUARE TISSUE BOX,9,2143,24,2500,357,1,48.0
10360,6989.0,WHITE HANGING HEART T-LIGHT HOLDER,1,483,4,500,17,1,8.0
10361,6990.0,WHITE METAL LANTERN,3,154,21,2200,2046,1,42.0
10362,6991.0,CREAM CUPID HEARTS COAT HANGER,8,100,0,100,0,1,0.0
10363,6992.0,KNITTED UNION FLAG HOT WATER BOTTLE,9,321,17,1800,1479,1,34.0
10364,6993.0,RED WOOLLY HOTTIE WHITE HEART.,5,100,0,100,0,1,0.0
10365,6994.0,SET 7 BABUSHKA NESTING BOXES,9,646,10,1100,454,1,20.0
10366,6995.0,GLASS STAR FROSTED T-LIGHT HOLDER,10,557,12,1300,743,1,24.0
10367,6996.0,HAND WARMER UNION JACK,2,1582,25,2600,1018,1,50.0
10368,6997.0,HAND WARMER RED POLKA DOT,3,488,4,500,12,1,8.0
10369,6998.0,ASSORTED COLOUR BIRD ORNAMENT,2,2205,24,2500,295,1,48.0
10370,6999.0,POPPY'S PLAYHOUSE BEDROOM ,9,1539,18,1900,361,1,36.0
10371,7000.0,POPPY'S PLAYHOUSE KITCHEN,8,313,3,400,87,1,6.0
10372,7001.0,FELTCRAFT PRINCESS CHARLOTTE DOLL,6,483,8,900,417,1,16.0
10373,7002.0,IVORY KNITTED MUG COSY ,9,682,11,1200,518,1,22.0
10374,7003.0,BOX OF 6 ASSORTED COLOUR TEASPOONS,9,315,3,400,85,1,6.0
10375,7004.0,BOX OF VINTAGE JIGSAW BLOCKS ,4,645,12,1300,655,1,24.0
10376,7005.0,BOX OF VINTAGE ALPHABET BLOCKS,9,618,9,1000,382,1,18.0
10377,7006.0,HOME BUILDING BLOCK WORD,10,232,6,700,468,1,12.0
10378,7007.0,LOVE BUILDING BLOCK WORD,3,1842,24,2500,658,1,48.0
10379,7008.0,RECIPE BOX WITH METAL HEART,7,234,4,500,266,1,8.0
10380,7009.0,DOORMAT NEW ENGLAND,8,842,22,2300,1458,1,44.0
10381,7010.0,JAM MAKING SET WITH JARS,5,212,3,400,188,1,6.0
10382,7011.0,RED COAT RACK PARIS FASHION,7,100,0,100,0,1,0.0
10383,7012.0,YELLOW COAT RACK PARIS FASHION,8,512,6,700,188,1,12.0
10384,7013.0,BLUE COAT RACK PARIS FASHION,2,891,12,1300,409,1,24.0
10385,7014.0,BATH BUILDING BLOCK WORD,9,634,8,900,266,1,16.0
10386,7015.0,ALARM CLOCK BAKELIKE PINK,10,209,5,600,391,1,10.0
10387,7016.0,ALARM CLOCK BAKELIKE RED ,8,1336,20,2100,764,1,40.0
10388,7017.0,ALARM CLOCK BAKELIKE GREEN,10,306,22,2300,1994,1,44.0
10389,7018.0,PANDA AND BUNNIES STICKER SHEET,2,723,24,2500,1777,1,48.0
10390,7019.0,STARS GIFT TAPE ,5,184,5,600,416,1,10.0
10391,7020.0,INFLATABLE POLITICAL GLOBE ,2,976,9,1000,24,1,18.0
10392,7021.0,VINTAGE HEADS AND TAILS CARD GAME ,6,899,12,1300,401,1,24.0
10393,7022.0,SET/2 RED RETROSPOT TEA TOWELS ,9,626,6,700,74,1,12.0
10394,7023.0,ROUND SNACK BOXES SET OF4 WOODLAND ,8,361,14,1500,1139,1,28.0
10395,7024.0,SPACEBOY LUNCH BOX ,5,1299,22,2300,1001,1,44.0
10396,7025.0,LUNCH BOX I LOVE LONDON,4,1476,17,1800,324,1,34.0
10397,7026.0,CIRCUS PARADE LUNCH BOX ,8,559,10,1100,541,1,20.0
10398,7027.0,CHARLOTTE BAG DOLLY GIRL DESIGN,10,645,12,1300,655,1,24.0
10399,7028.0,RED TOADSTOOL LED NIGHT LIGHT,9,259,2,300,41,1,4.0
10400,7029.0, SET 2 TEA TOWELS I LOVE LONDON ,8,976,9,1000,24,1,18.0
10401,7030.0,VINTAGE SEASIDE JIGSAW PUZZLES,1,1147,18,1900,753,1,36.0
10402,7031.0,MINI JIGSAW CIRCUS PARADE ,6,274,18,1900,1626,1,36.0
10403,7032.0,MINI JIGSAW SPACEBOY,4,1259,21,2200,941,1,42.0
10404,7033.0,MINI PAINT SET VINTAGE ,6,321,5,600,279,1,10.0
10405,7034.0,POSTAGE,3,205,14,1500,1295,1,28.0
10406,7035.0,PAPER CHAIN KIT 50'S CHRISTMAS ,4,1382,14,1500,118,1,28.0
10407,7036.0,HAND WARMER RED POLKA DOT,1,537,21,2200,1663,1,42.0
10408,7037.0,HAND WARMER UNION JACK,5,153,4,500,347,1,8.0
10409,7038.0,WHITE HANGING HEART T-LIGHT HOLDER,7,741,25,2600,1859,1,50.0
10410,7039.0,WHITE METAL LANTERN,5,328,3,400,72,1,6.0
10411,7040.0,CREAM CUPID HEARTS COAT HANGER,10,1657,16,1700,43,1,32.0
10412,7041.0,EDWARDIAN PARASOL RED,3,100,0,100,0,1,0.0
10413,7042.0,RETRO COFFEE MUGS ASSORTED,1,450,8,900,450,1,16.0
10414,7043.0,SAVE THE PLANET MUG,9,728,7,800,72,1,14.0
10415,7044.0,VINTAGE BILLBOARD DRINK ME MUG,6,1199,15,1600,401,1,30.0
10416,7045.0,VINTAGE BILLBOARD LOVE/HATE MUG,3,467,11,1200,733,1,22.0
10417,7046.0,WOOD 2 DRAWER CABINET WHITE FINISH,8,326,22,2300,1974,1,44.0
10418,7047.0,WOOD S/3 CABINET ANT WHITE FINISH,1,1251,25,2600,1349,1,50.0
10419,7048.0,WOODEN PICTURE FRAME WHITE FINISH,2,534,6,700,166,1,12.0
10420,7049.0,WOODEN FRAME ANTIQUE WHITE ,8,427,22,2300,1873,1,44.0
10421,7050.0,KNITTED UNION FLAG HOT WATER BOTTLE,2,1299,13,1400,101,1,26.0
10422,7051.0,RED WOOLLY HOTTIE WHITE HEART.,3,918,23,2400,1482,1,46.0
10423,7052.0,SET 7 BABUSHKA NESTING BOXES,9,206,20,2100,1894,1,40.0
10424,7053.0,GLASS STAR FROSTED T-LIGHT HOLDER,10,1422,20,2100,678,1,40.0
10425,7054.0,VICTORIAN SEWING BOX LARGE,4,100,0,100,0,1,0.0
10426,7055.0,WHITE HANGING HEART T-LIGHT HOLDER,1,818,15,1600,782,1,30.0
10427,7056.0,WHITE METAL LANTERN,2,1473,14,1500,27,1,28.0
10428,7057.0,CREAM CUPID HEARTS COAT HANGER,7,253,4,500,247,1,8.0
10429,7058.0,EDWARDIAN PARASOL RED,3,1295,12,1300,5,1,24.0
10430,7059.0,RETRO COFFEE MUGS ASSORTED,6,1791,25,2600,809,1,50.0
10431,7060.0,SAVE THE PLANET MUG,10,2043,21,2200,157,1,42.0
10432,7061.0,VINTAGE BILLBOARD DRINK ME MUG,10,1339,14,1500,161,1,28.0
10433,7062.0,VINTAGE BILLBOARD LOVE/HATE MUG,10,466,16,1700,1234,1,32.0
10434,7063.0,WOOD 2 DRAWER CABINET WHITE FINISH,1,912,16,1700,788,1,32.0
10435,7064.0,WOOD S/3 CABINET ANT WHITE FINISH,3,587,5,600,13,1,10.0
10436,7065.0,WOODEN PICTURE FRAME WHITE FINISH,7,220,2,300,80,1,4.0
10437,7066.0,WOODEN FRAME ANTIQUE WHITE ,1,282,11,1200,918,1,22.0
10438,7067.0,KNITTED UNION FLAG HOT WATER BOTTLE,6,117,2,300,183,1,4.0
10439,7068.0,RED WOOLLY HOTTIE WHITE HEART.,9,662,24,2500,1838,1,48.0
10440,7069.0,SET 7 BABUSHKA NESTING BOXES,10,973,14,1500,527,1,28.0
10441,7070.0,GLASS STAR FROSTED T-LIGHT HOLDER,5,1839,18,1900,61,1,36.0
10442,7071.0,HOT WATER BOTTLE TEA AND SYMPATHY,4,650,6,700,50,1,12.0
10443,7072.0,RED HANGING HEART T-LIGHT HOLDER,8,355,14,1500,1145,1,28.0
10444,7073.0,HAND WARMER RED POLKA DOT,5,1109,11,1200,91,1,22.0
10445,7074.0,HAND WARMER UNION JACK,6,2131,22,2300,169,1,44.0
10446,7075.0,JUMBO BAG PINK POLKADOT,4,454,13,1400,946,1,26.0
10447,7076.0,JUMBO  BAG BAROQUE BLACK WHITE,5,1056,14,1500,444,1,28.0
10448,7077.0,JUMBO BAG CHARLIE AND LOLA TOYS,4,263,7,800,537,1,14.0
10449,7078.0,STRAWBERRY CHARLOTTE BAG,8,274,7,800,526,1,14.0
10450,7079.0,RED 3 PIECE RETROSPOT CUTLERY SET,10,1562,19,2000,438,1,38.0
10451,7080.0,BLUE 3 PIECE POLKADOT CUTLERY SET,4,303,9,1000,697,1,18.0
10452,7081.0,SET/6 RED SPOTTY PAPER PLATES,3,454,23,2400,1946,1,46.0
10453,7082.0,LUNCH BAG RED RETROSPOT,9,2352,23,2400,48,1,46.0
10454,7083.0,STRAWBERRY LUNCH BOX WITH CUTLERY,1,2063,25,2600,537,1,50.0
10455,7084.0,LUNCH BOX WITH CUTLERY RETROSPOT ,6,288,10,1100,812,1,20.0
10456,7085.0,PACK OF 72 RETROSPOT CAKE CASES,9,100,0,100,0,1,0.0
10457,7086.0,PACK OF 60 DINOSAUR CAKE CASES,3,1235,16,1700,465,1,32.0
10458,7087.0,PACK OF 60 PINK PAISLEY CAKE CASES,4,190,2,300,110,1,4.0
10459,7088.0,66 TEATIME FAIRY CAKE CASES,8,100,0,100,0,1,0.0
10460,7089.0,TOMATO CHARLIE+LOLA COASTER SET,2,1353,16,1700,347,1,32.0
10461,7090.0,CHARLIE & LOLA WASTEPAPER BIN FLORA,9,917,20,2100,1183,1,40.0
10462,7091.0,RED CHARLIE+LOLA PERSONAL DOORSIGN,2,2075,21,2200,125,1,42.0
10463,7092.0,JUMBO STORAGE BAG SUKI,9,597,11,1200,603,1,22.0
10464,7093.0,JUMBO BAG PINK VINTAGE PAISLEY,3,283,14,1500,1217,1,28.0
10465,7094.0,JAM MAKING SET PRINTED,5,877,9,1000,123,1,18.0
10466,7095.0,RETROSPOT TEA SET CERAMIC 11 PC ,8,205,12,1300,1095,1,24.0
10467,7096.0,GIRLY PINK TOOL SET,2,813,11,1200,387,1,22.0
10468,7097.0,JUMBO SHOPPER VINTAGE RED PAISLEY,10,345,6,700,355,1,12.0
10469,7098.0,"AIRLINE LOUNGE,METAL SIGN",2,335,10,1100,765,1,20.0
10470,7099.0,WHITE SPOT RED CERAMIC DRAWER KNOB,7,327,13,1400,1073,1,26.0
10471,7100.0,RED DRAWER KNOB ACRYLIC EDWARDIAN,10,171,4,500,329,1,8.0
10472,7101.0,CLEAR DRAWER KNOB ACRYLIC EDWARDIAN,3,1864,25,2600,736,1,50.0
10473,7102.0,PHOTO CLIP LINE,10,1541,16,1700,159,1,32.0
10474,7103.0,FELT EGG COSY CHICKEN,8,135,6,700,565,1,12.0
10475,7104.0,PIGGY BANK RETROSPOT ,1,100,0,100,0,1,0.0
10476,7105.0,SKULL SHOULDER BAG,9,187,1,200,13,1,2.0
10477,7106.0,YOU'RE CONFUSING ME METAL SIGN ,8,980,15,1600,620,1,30.0
10478,7107.0,COOK WITH WINE METAL SIGN ,1,1411,20,2100,689,1,40.0
10479,7108.0,GIN + TONIC DIET METAL SIGN,10,455,11,1200,745,1,22.0
10480,7109.0,YELLOW BREAKFAST CUP AND SAUCER,5,123,1,200,77,1,2.0
10481,7110.0,PINK BREAKFAST CUP AND SAUCER ,8,375,15,1600,1225,1,30.0
10482,7111.0,PAPER CHAIN KIT 50'S CHRISTMAS ,1,920,19,2000,1080,1,38.0
10483,7112.0,PAPER CHAIN KIT RETROSPOT,3,143,2,300,157,1,4.0
10484,7113.0,SMALL HEART FLOWERS HOOK ,3,980,10,1100,120,1,20.0
10485,7114.0,PHOTO CLIP LINE,8,489,8,900,411,1,16.0
10486,7115.0,TEA TIME DES TEA COSY,5,186,1,200,14,1,2.0
10487,7116.0,FELT EGG COSY WHITE RABBIT ,8,1395,13,1400,5,1,26.0
10488,7117.0,ZINC WILLIE WINKIE  CANDLE STICK,1,1221,24,2500,1279,1,48.0
10489,7118.0,CERAMIC CHERRY CAKE MONEY BANK,6,100,0,100,0,1,0.0
10490,7119.0,RETROSPOT LARGE MILK JUG,9,100,0,100,0,1,0.0
10491,7120.0,SET OF 6 FUNKY BEAKERS,8,100,0,100,0,1,0.0
10492,7121.0,EDWARDIAN PARASOL BLACK,10,570,9,1000,430,1,18.0
10493,7122.0,EDWARDIAN PARASOL NATURAL,3,352,7,800,448,1,14.0
10494,7123.0,CERAMIC STRAWBERRY CAKE MONEY BANK,5,936,20,2100,1164,1,40.0
10495,7124.0,BLUE OWL SOFT TOY,8,1086,15,1600,514,1,30.0
10496,7125.0,BALLOON ART MAKE YOUR OWN FLOWERS,5,214,16,1700,1486,1,32.0
10497,7126.0,RED TOADSTOOL LED NIGHT LIGHT,7,2491,25,2600,109,1,50.0
10498,7127.0,GLASS CLOCHE SMALL,3,1179,21,2200,1021,1,42.0
10499,7128.0,GUMBALL MONOCHROME COAT RACK,7,452,8,900,448,1,16.0
10500,7129.0,DOORMAT FANCY FONT HOME SWEET HOME,8,1712,25,2600,888,1,50.0
10501,7130.0,Discount,3,1899,23,2400,501,1,46.0
10502,7131.0,INFLATABLE POLITICAL GLOBE ,5,185,2,300,115,1,4.0
10503,7132.0,VINTAGE SNAKES & LADDERS,8,474,5,600,126,1,10.0
10504,7133.0,CHOCOLATE CALCULATOR,10,1413,21,2200,787,1,42.0
10505,7134.0,JUMBO SHOPPER VINTAGE RED PAISLEY,9,1137,13,1400,263,1,26.0
10506,7135.0,RECYCLING BAG RETROSPOT ,1,2265,24,2500,235,1,48.0
10507,7136.0,TOY TIDY PINK POLKADOT,1,1797,18,1900,103,1,36.0
10508,7137.0,ANTIQUE GLASS DRESSING TABLE POT,7,198,1,200,2,1,2.0
10509,7138.0,ALARM CLOCK BAKELIKE GREEN,7,1889,24,2500,611,1,48.0
10510,7139.0,IVORY GIANT GARDEN THERMOMETER,3,115,4,500,385,1,8.0
10511,7140.0,9 TIER CAKE TIN GREEN AND CREAM,10,801,10,1100,299,1,20.0
10512,7141.0,9 TIER CAKE TIN RED AND CREAM,2,100,0,100,0,1,0.0
10513,7142.0,SET 3 WICKER OVAL BASKETS W LIDS,7,555,10,1100,545,1,20.0
10514,7143.0,SET OF 3 COLOURED  FLYING DUCKS,2,207,11,1200,993,1,22.0
10515,7144.0,WOOD BLACK BOARD ANT WHITE FINISH,3,367,10,1100,733,1,20.0
10516,7145.0,COLOUR GLASS T-LIGHT HOLDER HANGING,9,323,8,900,577,1,16.0
10517,7146.0,HANGING METAL HEART LANTERN,9,1647,25,2600,953,1,50.0
10518,7147.0,HANGING MEDINA LANTERN SMALL,4,302,6,700,398,1,12.0
10519,7148.0,NATURAL SLATE HEART CHALKBOARD ,7,385,3,400,15,1,6.0
10520,7149.0,HEART OF WICKER SMALL,6,2243,23,2400,157,1,46.0
10521,7150.0,HEART OF WICKER LARGE,8,1565,19,2000,435,1,38.0
10522,7151.0,WHITE LOVEBIRD LANTERN,9,639,11,1200,561,1,22.0
10523,7152.0,CLASSIC METAL BIRDCAGE PLANT HOLDER,9,140,7,800,660,1,14.0
10524,7153.0,CREAM HEART CARD HOLDER,5,158,1,200,42,1,2.0
10525,7154.0,ENAMEL FLOWER JUG CREAM,1,382,13,1400,1018,1,26.0
10526,7155.0,ENAMEL FIRE BUCKET CREAM,8,603,9,1000,397,1,18.0
10527,7156.0,ENAMEL BREAD BIN CREAM,4,1542,17,1800,258,1,34.0
10528,7157.0,SET 3 WICKER OVAL BASKETS W LIDS,9,292,6,700,408,1,12.0
10529,7158.0,JAM MAKING SET PRINTED,1,1098,10,1100,2,1,20.0
10530,7159.0,JAM MAKING SET WITH JARS,4,100,0,100,0,1,0.0
10531,7160.0,JUMBO BAG DOLLY GIRL DESIGN,7,182,15,1600,1418,1,30.0
10532,7161.0,TRADITIONAL CHRISTMAS RIBBONS,3,113,5,600,487,1,10.0
10533,7162.0,ORGANISER WOOD ANTIQUE WHITE ,6,726,9,1000,274,1,18.0
10534,7163.0,LUNCH BAG DOLLY GIRL DESIGN,3,353,3,400,47,1,6.0
10535,7164.0,WHITE WIRE EGG HOLDER,8,391,11,1200,809,1,22.0
10536,7165.0,JUMBO  BAG BAROQUE BLACK WHITE,7,165,2,300,135,1,4.0
10537,7166.0,JUMBO BAG RED RETROSPOT,4,810,21,2200,1390,1,42.0
10538,7167.0,CHILLI LIGHTS,1,366,16,1700,1334,1,32.0
10539,7168.0,LIGHT GARLAND BUTTERFILES PINK,4,188,1,200,12,1,2.0
10540,7169.0,WOODEN OWLS LIGHT GARLAND ,6,423,10,1100,677,1,20.0
10541,7170.0,FAIRY TALE COTTAGE NIGHTLIGHT,2,1823,19,2000,177,1,38.0
10542,7171.0,RED TOADSTOOL LED NIGHT LIGHT,1,526,5,600,74,1,10.0
10543,7172.0,HOME BUILDING BLOCK WORD,1,2164,21,2200,36,1,42.0
10544,7173.0,LOVE BUILDING BLOCK WORD,4,622,21,2200,1578,1,42.0
10545,7174.0,DOORMAT FANCY FONT HOME SWEET HOME,1,434,7,800,366,1,14.0
10546,7175.0,HOME SMALL WOOD LETTERS,9,125,10,1100,975,1,20.0
10547,7176.0,GINGHAM HEART  DOORSTOP RED,3,462,21,2200,1738,1,42.0
10548,7177.0,FIVE HEART HANGING DECORATION,8,571,23,2400,1829,1,46.0
10549,7178.0,HANGING METAL HEART LANTERN,2,367,4,500,133,1,8.0
10550,7179.0,ASSORTED BOTTLE TOP  MAGNETS ,1,1313,14,1500,187,1,28.0
10551,7180.0,FRIDGE MAGNETS US DINER ASSORTED,1,725,22,2300,1575,1,44.0
10552,7181.0,HOMEMADE JAM SCENTED CANDLES,3,295,4,500,205,1,8.0
10553,7182.0,FRIDGE MAGNETS LES ENFANTS ASSORTED,7,635,16,1700,1065,1,32.0
10554,7183.0,ROSE CARAVAN DOORSTOP,5,474,16,1700,1226,1,32.0
10555,7184.0,HEART OF WICKER SMALL,4,211,7,800,589,1,14.0
10556,7185.0,11 HOOK HANGER MAGIC TOADSTOOL,3,375,9,1000,625,1,18.0
10557,7186.0,CHRISTMAS LIGHTS 10 REINDEER,3,268,9,1000,732,1,18.0
10558,7187.0,VINTAGE UNION JACK CUSHION COVER,2,317,12,1300,983,1,24.0
10559,7188.0,VINTAGE HEADS AND TAILS CARD GAME ,9,139,1,200,61,1,2.0
10560,7189.0,SET OF 3 COLOURED  FLYING DUCKS,5,261,14,1500,1239,1,28.0
10561,7190.0,SET OF 3 GOLD FLYING DUCKS,9,100,0,100,0,1,0.0
10562,7191.0,RED RETROSPOT UMBRELLA,9,678,8,900,222,1,16.0
10563,7192.0,BLACK/BLUE POLKADOT UMBRELLA,8,326,3,400,74,1,6.0
10564,7193.0,RED DINER WALL CLOCK,9,447,7,800,353,1,14.0
10565,7194.0,ALARM CLOCK BAKELIKE GREEN,10,1917,21,2200,283,1,42.0
10566,7195.0,ALARM CLOCK BAKELIKE RED ,9,330,3,400,70,1,6.0
10567,7196.0,BLUE DINER WALL CLOCK,1,257,3,400,143,1,6.0
10568,7197.0,IVORY DINER WALL CLOCK,8,294,13,1400,1106,1,26.0
10569,7198.0,LARGE HEART MEASURING SPOONS,9,739,16,1700,961,1,32.0
10570,7199.0,SMALL HEART MEASURING SPOONS,8,617,10,1100,483,1,20.0
10571,7200.0,CHRISTMAS LIGHTS 10 REINDEER,3,1527,16,1700,173,1,32.0
10572,7201.0,JAM MAKING SET WITH JARS,1,1396,16,1700,304,1,32.0
10573,7202.0,JAM MAKING SET PRINTED,9,701,12,1300,599,1,24.0
10574,7203.0,JAM JAR WITH PINK LID,10,192,2,300,108,1,4.0
10575,7204.0,JAM JAR WITH GREEN LID,3,100,0,100,0,1,0.0
10576,7205.0,ROSE COTTAGE KEEPSAKE BOX ,2,1225,25,2600,1375,1,50.0
10577,7206.0,HANGING HEART ZINC T-LIGHT HOLDER,5,721,7,800,79,1,14.0
10578,7207.0,PAPER CHAIN KIT VINTAGE CHRISTMAS,8,202,12,1300,1098,1,24.0
10579,7208.0,DISCO BALL CHRISTMAS DECORATION,5,1057,11,1200,143,1,22.0
10580,7209.0,WHITE HANGING HEART T-LIGHT HOLDER,9,161,13,1400,1239,1,26.0
10581,7210.0,SMALL POPCORN HOLDER,2,1166,22,2300,1134,1,44.0
10582,7211.0,LARGE POPCORN HOLDER ,1,1296,12,1300,4,1,24.0
10583,7212.0,RETROSPOT LARGE MILK JUG,6,525,23,2400,1875,1,46.0
10584,7213.0,SET/20 RED RETROSPOT PAPER NAPKINS ,3,590,19,2000,1410,1,38.0
10585,7214.0,SET/6 RED SPOTTY PAPER PLATES,4,1152,13,1400,248,1,26.0
10586,7215.0,SET/6 RED SPOTTY PAPER CUPS,4,1386,25,2600,1214,1,50.0
10587,7216.0,POLKADOT RAIN HAT ,5,606,7,800,194,1,14.0
10588,7217.0,DELUXE SEWING KIT ,6,1286,12,1300,14,1,24.0
10589,7218.0,RETROSPOT HEART HOT WATER BOTTLE,7,100,0,100,0,1,0.0
10590,7219.0,KNITTED UNION FLAG HOT WATER BOTTLE,4,1155,21,2200,1045,1,42.0
10591,7220.0,ENGLISH ROSE HOT WATER BOTTLE,3,413,17,1800,1387,1,34.0
10592,7221.0,PHOTO CUBE,2,481,4,500,19,1,8.0
10593,7222.0,HOMEMADE JAM SCENTED CANDLES,2,1973,20,2100,127,1,40.0
10594,7223.0,JUMBO BAG RED RETROSPOT,4,2220,22,2300,80,1,44.0
10595,7224.0,PLASTERS IN TIN CIRCUS PARADE ,3,114,3,400,286,1,6.0
10596,7225.0,PACK OF 12 PINK PAISLEY TISSUES ,2,2055,20,2100,45,1,40.0
10597,7226.0,PACK OF 12 BLUE PAISLEY TISSUES ,8,655,7,800,145,1,14.0
10598,7227.0,PACK OF 12 RED RETROSPOT TISSUES ,9,100,5,600,500,1,10.0
10599,7228.0,CHICK GREY HOT WATER BOTTLE,8,329,9,1000,671,1,18.0
10600,7229.0,PLASTERS IN TIN VINTAGE PAISLEY ,5,1952,19,2000,48,1,38.0
10601,7230.0,PLASTERS IN TIN SKULLS,7,219,21,2200,1981,1,42.0
10602,7231.0,9 STRIPEY MICE FELTCRAFT,7,1614,21,2200,586,1,42.0
10603,7232.0,SET OF 6 SOLDIER SKITTLES,7,150,1,200,50,1,2.0
10604,7233.0,TRADITIONAL WOODEN SKIPPING ROPE,10,418,8,900,482,1,16.0
10605,7234.0,WOODEN BOX OF DOMINOES,4,1553,15,1600,47,1,30.0
10606,7235.0,RUSTIC  SEVENTEEN DRAWER SIDEBOARD,9,1078,15,1600,522,1,30.0
10607,7236.0,PARTY CONES CARNIVAL ASSORTED,8,907,21,2200,1293,1,42.0
10608,7237.0,PARTY CONES CANDY ASSORTED,9,556,11,1200,644,1,22.0
10609,7238.0,PICNIC BASKET WICKER SMALL,2,694,16,1700,1006,1,32.0
10610,7239.0,ASSORTED COLOUR BIRD ORNAMENT,7,489,4,500,11,1,8.0
10611,7240.0,STAR DECORATION PAINTED ZINC ,1,1934,24,2500,566,1,48.0
10612,7241.0,RETROSPOT LAMP,3,1659,25,2600,941,1,50.0
10613,7242.0,"FANCY FONT BIRTHDAY CARD, ",8,484,6,700,216,1,12.0
10614,7243.0,HAND WARMER UNION JACK,4,1427,17,1800,373,1,34.0
10615,7244.0,HAND WARMER SCOTTY DOG DESIGN,4,409,12,1300,891,1,24.0
10616,7245.0,HAND WARMER OWL DESIGN,3,1527,20,2100,573,1,40.0
10617,7246.0,HAND WARMER RED RETROSPOT,7,116,1,200,84,1,2.0
10618,7247.0,RETROSPOT HEART HOT WATER BOTTLE,3,626,24,2500,1874,1,48.0
10619,7248.0,DOG BOWL CHASING BALL DESIGN,7,282,5,600,318,1,10.0
10620,7249.0,CLOTHES PEGS RETROSPOT PACK 30,6,438,15,1600,1162,1,30.0
10621,7250.0,HAND OVER THE CHOCOLATE   SIGN ,1,810,20,2100,1290,1,40.0
10622,7251.0,WHITE HANGING HEART T-LIGHT HOLDER,4,1592,17,1800,208,1,34.0
10623,7252.0,TRAVEL SEWING KIT,10,383,22,2300,1917,1,44.0
10624,7253.0,BLACK HEART CARD HOLDER,8,100,0,100,0,1,0.0
10625,7254.0,ASSORTED COLOUR BIRD ORNAMENT,9,2303,25,2600,297,1,50.0
10626,7255.0,PACK OF 60 PINK PAISLEY CAKE CASES,2,986,9,1000,14,1,18.0
10627,7256.0,66 TEATIME FAIRY CAKE CASES,8,1306,24,2500,1194,1,48.0
10628,7257.0,PACK OF 72 RETROSPOT CAKE CASES,5,466,5,600,134,1,10.0
10629,7258.0,CHICK GREY HOT WATER BOTTLE,6,1930,19,2000,70,1,38.0
10630,7259.0,SMALL GLASS HEART TRINKET POT,2,132,2,300,168,1,4.0
10631,7260.0,ALARM CLOCK BAKELIKE IVORY,5,677,10,1100,423,1,20.0
10632,7261.0,ALARM CLOCK BAKELIKE RED ,4,1999,25,2600,601,1,50.0
10633,7262.0,ALARM CLOCK BAKELIKE ORANGE,7,484,6,700,216,1,12.0
10634,7263.0,ALARM CLOCK BAKELIKE GREEN,2,260,5,600,340,1,10.0
10635,7264.0,HOT WATER BOTTLE TEA AND SYMPATHY,7,546,19,2000,1454,1,38.0
10636,7265.0,HAND WARMER BIRD DESIGN,10,761,24,2500,1739,1,48.0
10637,7266.0,HAND WARMER SCOTTY DOG DESIGN,6,426,4,500,74,1,8.0
10638,7267.0,WHITE HANGING HEART T-LIGHT HOLDER,1,276,12,1300,1024,1,24.0
10639,7268.0,WHITE METAL LANTERN,2,681,21,2200,1519,1,42.0
10640,7269.0,CREAM CUPID HEARTS COAT HANGER,1,241,14,1500,1259,1,28.0
10641,7270.0,EDWARDIAN PARASOL BLACK,2,1453,22,2300,847,1,44.0
10642,7271.0,EDWARDIAN PARASOL RED,7,395,17,1800,1405,1,34.0
10643,7272.0,RETRO COFFEE MUGS ASSORTED,4,832,16,1700,868,1,32.0
10644,7273.0,SAVE THE PLANET MUG,6,371,5,600,229,1,10.0
10645,7274.0,VINTAGE BILLBOARD DRINK ME MUG,6,101,22,2300,2199,1,44.0
10646,7275.0,VINTAGE BILLBOARD LOVE/HATE MUG,1,670,7,800,130,1,14.0
10647,7276.0,WOOD 2 DRAWER CABINET WHITE FINISH,10,1487,14,1500,13,1,28.0
10648,7277.0,WOOD S/3 CABINET ANT WHITE FINISH,9,619,21,2200,1581,1,42.0
10649,7278.0,WOODEN PICTURE FRAME WHITE FINISH,9,887,9,1000,113,1,18.0
10650,7279.0,WOODEN FRAME ANTIQUE WHITE ,1,964,20,2100,1136,1,40.0
10651,7280.0,KNITTED UNION FLAG HOT WATER BOTTLE,2,100,0,100,0,1,0.0
10652,7281.0,RED WOOLLY HOTTIE WHITE HEART.,7,102,1,200,98,1,2.0
10653,7282.0,SET 7 BABUSHKA NESTING BOXES,4,1650,17,1800,150,1,34.0
10654,7283.0,IVORY EMBROIDERED QUILT ,9,1687,18,1900,213,1,36.0
10655,7284.0,GLASS STAR FROSTED T-LIGHT HOLDER,4,931,13,1400,469,1,26.0
10656,7285.0,SET OF 3 BLACK FLYING DUCKS,8,400,8,900,500,1,16.0
10657,7286.0,SET OF 3 COLOURED  FLYING DUCKS,7,389,11,1200,811,1,22.0
10658,7287.0,PACK OF 12 RED RETROSPOT TISSUES ,4,100,0,100,0,1,0.0
10659,7288.0,RED RETROSPOT MUG,10,775,7,800,25,1,14.0
10660,7289.0,BABUSHKA LIGHTS STRING OF 16,3,317,3,400,83,1,6.0
10661,7290.0,PIGGY BANK RETROSPOT ,9,352,15,1600,1248,1,30.0
10662,7291.0,SET 7 BABUSHKA NESTING BOXES,5,873,11,1200,327,1,22.0
10663,7292.0,DOORMAT FAIRY CAKE,8,2424,24,2500,76,1,48.0
10664,7293.0,HAND WARMER RED RETROSPOT,3,394,3,400,6,1,6.0
10665,7294.0,HAND WARMER SCOTTY DOG DESIGN,1,821,17,1800,979,1,34.0
10666,7295.0,HAND WARMER OWL DESIGN,3,235,21,2200,1965,1,42.0
10667,7296.0,STRAWBERRY CERAMIC TRINKET BOX,10,1861,18,1900,39,1,36.0
10668,7297.0,PINK DOUGHNUT TRINKET POT ,3,151,5,600,449,1,10.0
10669,7298.0,SILK PURSE BABUSHKA PINK,3,1020,18,1900,880,1,36.0
10670,7299.0,HOT WATER BOTTLE TEA AND SYMPATHY,4,2143,24,2500,357,1,48.0
10671,7300.0,HOT WATER BOTTLE I AM SO POORLY,4,722,9,1000,278,1,18.0
10672,7301.0,CHOCOLATE HOT WATER BOTTLE,1,1924,22,2300,376,1,44.0
10673,7302.0,WHITE SKULL HOT WATER BOTTLE ,9,196,6,700,504,1,12.0
10674,7303.0,SCOTTIE DOG HOT WATER BOTTLE,2,1061,13,1400,339,1,26.0
10675,7304.0,HAND WARMER RED POLKA DOT,8,267,2,300,33,1,4.0
10676,7305.0,HAND WARMER UNION JACK,7,942,10,1100,158,1,20.0
10677,7306.0,HOMEMADE JAM SCENTED CANDLES,8,1363,14,1500,137,1,28.0
10678,7307.0,BIRD HOUSE HOT WATER BOTTLE,5,167,24,2500,2333,1,48.0
10679,7308.0,BOUDOIR SQUARE TISSUE BOX,2,1225,19,2000,775,1,38.0
10680,7309.0,SKULLS SQUARE TISSUE BOX,9,863,16,1700,837,1,32.0
10681,7310.0,PHOTO FRAME CORNICE,4,133,16,1700,1567,1,32.0
10682,7311.0,SILK PURSE BABUSHKA RED,7,155,2,300,145,1,4.0
10683,7312.0,PICTURE DOMINOES,2,182,8,900,718,1,16.0
10684,7313.0,S/6 SEW ON CROCHET FLOWERS,10,1480,16,1700,220,1,32.0
10685,7314.0,SCANDINAVIAN REDS RIBBONS,7,1897,19,2000,103,1,38.0
10686,7315.0,BALLOONS  WRITING SET ,8,193,5,600,407,1,10.0
10687,7316.0,JAM MAKING SET PRINTED,7,503,16,1700,1197,1,32.0
10688,7317.0,LAVENDER INCENSE IN TIN,6,320,5,600,280,1,10.0
10689,7318.0,TV DINNER TRAY VINTAGE PAISLEY,7,156,2,300,144,1,4.0
10690,7319.0,SET OF 4 ENGLISH ROSE PLACEMATS,4,1082,14,1500,418,1,28.0
10691,7320.0,SET OF 4 ENGLISH ROSE COASTERS,1,1277,14,1500,223,1,28.0
10692,7321.0,TRIPLE PHOTO FRAME CORNICE ,2,1642,21,2200,558,1,42.0
10693,7322.0,FAMILY PHOTO FRAME CORNICE,7,1351,15,1600,249,1,30.0
10694,7323.0,MIRRORED DISCO BALL ,6,794,15,1600,806,1,30.0
10695,7324.0,DISCO BALL ROTATOR BATTERY OPERATED,5,148,1,200,52,1,2.0
10696,7325.0,SILVER LOOKING MIRROR,10,933,24,2500,1567,1,48.0
10697,7326.0,LADIES & GENTLEMEN METAL SIGN,8,172,12,1300,1128,1,24.0
10698,7327.0,METAL SIGN HER DINNER IS SERVED ,4,367,5,600,233,1,10.0
10699,7328.0,YOU'RE CONFUSING ME METAL SIGN ,4,829,12,1300,471,1,24.0
10700,7329.0,DOORMAT TOPIARY,1,182,11,1200,1018,1,22.0
10701,7330.0,BATHROOM METAL SIGN,8,2052,20,2100,48,1,40.0
10702,7331.0,KITCHEN METAL SIGN,3,674,7,800,126,1,14.0
10703,7332.0,TOILET METAL SIGN,6,267,12,1300,1033,1,24.0
10704,7333.0,METAL SIGN TAKE IT OR LEAVE IT ,10,123,3,400,277,1,6.0
10705,7334.0,I'M ON HOLIDAY METAL SIGN,1,133,25,2600,2467,1,50.0
10706,7335.0,GROW YOUR OWN BASIL IN ENAMEL MUG,10,1625,23,2400,775,1,46.0
10707,7336.0,SET/10 PINK POLKADOT PARTY CANDLES,1,175,19,2000,1825,1,38.0
10708,7337.0,SET 20 NAPKINS FAIRY CAKES DESIGN ,3,1376,19,2000,624,1,38.0
10709,7338.0,66 TEATIME FAIRY CAKE CASES,2,491,14,1500,1009,1,28.0
10710,7339.0,SET OF 6 T-LIGHTS SNOWMEN,9,229,2,300,71,1,4.0
10711,7340.0,SET OF 6 T-LIGHTS SANTA,8,147,2,300,153,1,4.0
10712,7341.0,SET OF 9 HEART SHAPED BALLOONS,7,326,7,800,474,1,14.0
10713,7342.0,SANDWICH BATH SPONGE,8,100,0,100,0,1,0.0
10714,7343.0,APPLE BATH SPONGE,8,182,7,800,618,1,14.0
10715,7344.0,STRAWBERRY BATH SPONGE ,9,100,0,100,0,1,0.0
10716,7345.0,BLACK PIRATE TREASURE CHEST,4,118,1,200,82,1,2.0
10717,7346.0,STAR PORTABLE TABLE LIGHT ,8,160,19,2000,1840,1,38.0
10718,7347.0,SNOWFLAKE PORTABLE TABLE LIGHT ,9,771,11,1200,429,1,22.0
10719,7348.0,PINK OVAL JEWELLED MIRROR,10,923,10,1100,177,1,20.0
10720,7349.0,RETROSPOT CIGAR BOX MATCHES ,10,100,0,100,0,1,0.0
10721,7350.0,COSY HOUR GIANT TUBE MATCHES,2,496,7,800,304,1,14.0
10722,7351.0,JAZZ HEARTS PURSE NOTEBOOK,6,139,14,1500,1361,1,28.0
10723,7352.0,LUNCH BAG DOLLY GIRL DESIGN,4,1089,13,1400,311,1,26.0
10724,7353.0,WHITE HANGING HEART T-LIGHT HOLDER,2,196,10,1100,904,1,20.0
10725,7354.0,CANDLEHOLDER PINK HANGING HEART,10,350,5,600,250,1,10.0
10726,7355.0,WOOD 2 DRAWER CABINET WHITE FINISH,7,148,1,200,52,1,2.0
10727,7356.0,ASSORTED COLOUR MINI CASES,6,110,5,600,490,1,10.0
10728,7357.0,LUNCH BAG RED RETROSPOT,3,978,23,2400,1422,1,46.0
10729,7358.0,LUNCH BAG SPACEBOY DESIGN ,6,1148,18,1900,752,1,36.0
10730,7359.0,LUNCH BAG WOODLAND,6,459,4,500,41,1,8.0
10731,7360.0,LUNCH BAG PINK POLKADOT,10,775,11,1200,425,1,22.0
10732,7361.0,GUMBALL COAT RACK,1,100,0,100,0,1,0.0
10733,7362.0,BLUE NEW BAROQUE CANDLESTICK CANDLE,2,285,3,400,115,1,6.0
10734,7363.0,PINK NEW BAROQUECANDLESTICK CANDLE,6,169,1,200,31,1,2.0
10735,7364.0,FAIRY CAKE FLANNEL ASSORTED COLOUR,9,468,8,900,432,1,16.0
10736,7365.0,BREAD BIN DINER STYLE PINK,5,1162,12,1300,138,1,24.0
10737,7366.0,JUMBO BAG CHARLIE AND LOLA TOYS,4,406,8,900,494,1,16.0
10738,7367.0,TEA TIME TABLE CLOTH,8,563,23,2400,1837,1,46.0
10739,7368.0,ENGLISH ROSE HOT WATER BOTTLE,3,1040,10,1100,60,1,20.0
10740,7369.0,ENAMEL FIRE BUCKET CREAM,5,253,4,500,247,1,8.0
10741,7370.0,PICNIC BASKET WICKER SMALL,2,513,14,1500,987,1,28.0
10742,7371.0,PAPER CHAIN KIT 50'S CHRISTMAS ,2,932,23,2400,1468,1,46.0
10743,7372.0,PAPER CHAIN KIT VINTAGE CHRISTMAS,5,148,1,200,52,1,2.0
10744,7373.0,HOT WATER BOTTLE BABUSHKA ,2,1952,21,2200,248,1,42.0
10745,7374.0,HAND WARMER BIRD DESIGN,2,1272,21,2200,928,1,42.0
10746,7375.0,POSTAGE,1,599,5,600,1,1,10.0
10747,7376.0,HEART IVORY TRELLIS SMALL,4,190,8,900,710,1,16.0
10748,7377.0,CLEAR DRAWER KNOB ACRYLIC EDWARDIAN,6,329,23,2400,2071,1,46.0
10749,7378.0,PINK DRAWER KNOB ACRYLIC EDWARDIAN,4,1420,19,2000,580,1,38.0
10750,7379.0,GREEN DRAWER KNOB ACRYLIC EDWARDIAN,1,172,8,900,728,1,16.0
10751,7380.0,BLUE DRAWER KNOB ACRYLIC EDWARDIAN,6,842,11,1200,358,1,22.0
10752,7381.0,HEART OF WICKER SMALL,3,100,0,100,0,1,0.0
10753,7382.0,SMALL POPCORN HOLDER,4,775,17,1800,1025,1,34.0
10754,7383.0,SET 6 FOOTBALL CELEBRATION CANDLES,2,148,11,1200,1052,1,22.0
10755,7384.0,SET OF 6 GIRLS CELEBRATION CANDLES,3,1264,15,1600,336,1,30.0
10756,7385.0,ROMANTIC PINKS RIBBONS ,4,186,4,500,314,1,8.0
10757,7386.0,BRIGHT BLUES RIBBONS ,4,339,3,400,61,1,6.0
10758,7387.0,SCANDINAVIAN REDS RIBBONS,7,487,25,2600,2113,1,50.0
10759,7388.0,CHOCOLATE BOX RIBBONS ,7,1178,16,1700,522,1,32.0
10760,7389.0,PARTY INVITES FOOTBALL,9,514,23,2400,1886,1,46.0
10761,7390.0,PARTY INVITES JAZZ HEARTS,3,1023,15,1600,577,1,30.0
10762,7391.0,PARTY INVITES SPACEMAN,4,173,2,300,127,1,4.0
10763,7392.0,SET OF 3 BUTTERFLY COOKIE CUTTERS,4,100,0,100,0,1,0.0
10764,7393.0,SET OF 3 HEART COOKIE CUTTERS,8,467,11,1200,733,1,22.0
10765,7394.0,9 PIECE SPACEBOY COOKIE CUTTER SET,8,134,6,700,566,1,12.0
10766,7395.0,PACK OF 72 SKULL CAKE CASES,9,866,8,900,34,1,16.0
10767,7396.0,PACK OF 60 SPACEBOY CAKE CASES,4,230,11,1200,970,1,22.0
10768,7397.0,PACK OF 72 RETROSPOT CAKE CASES,4,1422,15,1600,178,1,30.0
10769,7398.0,78 SWEETHEART FAIRY CAKE CASES,9,642,13,1400,758,1,26.0
10770,7399.0,PACK OF 60 DINOSAUR CAKE CASES,4,1275,22,2300,1025,1,44.0
10771,7400.0,LUNCH BAG SUKI  DESIGN ,10,451,5,600,149,1,10.0
10772,7401.0,LUNCH BAG CARS BLUE,8,100,0,100,0,1,0.0
10773,7402.0,LUNCH BAG  BLACK SKULL.,3,253,3,400,147,1,6.0
10774,7403.0,HEART IVORY TRELLIS LARGE,5,100,0,100,0,1,0.0
10775,7404.0,SET/5 RED RETROSPOT LID GLASS BOWLS,3,2094,23,2400,306,1,46.0
10776,7405.0,WHITE HANGING HEART T-LIGHT HOLDER,8,1391,17,1800,409,1,34.0
10777,7406.0,WHITE METAL LANTERN,1,209,2,300,91,1,4.0
10778,7407.0,CREAM CUPID HEARTS COAT HANGER,6,249,3,400,151,1,6.0
10779,7408.0,EDWARDIAN PARASOL RED,1,686,13,1400,714,1,26.0
10780,7409.0,RETRO COFFEE MUGS ASSORTED,9,430,5,600,170,1,10.0
10781,7410.0,SAVE THE PLANET MUG,10,321,18,1900,1579,1,36.0
10782,7411.0,VINTAGE BILLBOARD DRINK ME MUG,5,151,3,400,249,1,6.0
10783,7412.0,VINTAGE BILLBOARD LOVE/HATE MUG,1,892,8,900,8,1,16.0
10784,7413.0,WOOD 2 DRAWER CABINET WHITE FINISH,6,394,4,500,106,1,8.0
10785,7414.0,WOOD S/3 CABINET ANT WHITE FINISH,5,2173,21,2200,27,1,42.0
10786,7415.0,WOODEN PICTURE FRAME WHITE FINISH,8,321,17,1800,1479,1,34.0
10787,7416.0,WOODEN FRAME ANTIQUE WHITE ,1,417,10,1100,683,1,20.0
10788,7417.0,KNITTED UNION FLAG HOT WATER BOTTLE,7,307,3,400,93,1,6.0
10789,7418.0,RED WOOLLY HOTTIE WHITE HEART.,1,144,7,800,656,1,14.0
10790,7419.0,SET 7 BABUSHKA NESTING BOXES,7,102,12,1300,1198,1,24.0
10791,7420.0,IVORY EMBROIDERED QUILT ,5,158,1,200,42,1,2.0
10792,7421.0,GLASS STAR FROSTED T-LIGHT HOLDER,4,174,13,1400,1226,1,26.0
10793,7422.0,HAND WARMER RED POLKA DOT,7,172,1,200,28,1,2.0
10794,7423.0,HAND WARMER UNION JACK,3,200,13,1400,1200,1,26.0
10795,7424.0,MAGIC DRAWING SLATE DINOSAUR,6,122,21,2200,2078,1,42.0
10796,7425.0,MAGIC DRAWING SLATE BAKE A CAKE ,7,1334,16,1700,366,1,32.0
10797,7426.0,18 PENCILS TALL TUBE SKULLS,1,100,0,100,0,1,0.0
10798,7427.0,CHOCOLATE CALCULATOR,7,1456,23,2400,944,1,46.0
10799,7428.0,RED  HARMONICA IN BOX ,5,1397,21,2200,803,1,42.0
10800,7429.0,BLUE HARMONICA IN BOX ,6,160,7,800,640,1,14.0
10801,7430.0,SKULLS  WATER TRANSFER TATTOOS ,8,1697,21,2200,503,1,42.0
10802,7431.0,PACK 3 BOXES BIRD PANNETONE ,10,454,16,1700,1246,1,32.0
10803,7432.0,HOT WATER BOTTLE TEA AND SYMPATHY,5,125,2,300,175,1,4.0
10804,7433.0,RED WOOLLY HOTTIE WHITE HEART.,6,435,13,1400,965,1,26.0
10805,7434.0,WHITE SKULL HOT WATER BOTTLE ,1,565,16,1700,1135,1,32.0
10806,7435.0,9 PIECE SPACEBOY COOKIE CUTTER SET,1,725,13,1400,675,1,26.0
10807,7436.0,SET OF 20 KIDS COOKIE CUTTERS,1,1889,24,2500,611,1,48.0
10808,7437.0,16 COLOUR SPACEBOY PEN,9,828,13,1400,572,1,26.0
10809,7438.0,VICTORIAN GLASS HANGING T-LIGHT,9,228,9,1000,772,1,18.0
10810,7439.0,SINGLE HEART ZINC T-LIGHT HOLDER,10,905,14,1500,595,1,28.0
10811,7440.0,RED HANGING HEART T-LIGHT HOLDER,3,1147,23,2400,1253,1,46.0
10812,7441.0,HANGING METAL STAR LANTERN,4,189,21,2200,2011,1,42.0
10813,7442.0,SILVER HANGING T-LIGHT HOLDER,7,966,12,1300,334,1,24.0
10814,7443.0,DOORMAT RED RETROSPOT,3,1919,23,2400,481,1,46.0
10815,7444.0,DOORMAT HEARTS,1,1091,13,1400,309,1,26.0
10816,7445.0,NATURAL SLATE RECTANGLE CHALKBOARD,8,898,19,2000,1102,1,38.0
10817,7446.0,LOVEBIRD HANGING DECORATION WHITE ,3,533,6,700,167,1,12.0
10818,7447.0,ASSORTED COLOUR BIRD ORNAMENT,2,1219,14,1500,281,1,28.0
10819,7448.0,HOME BUILDING BLOCK WORD,3,843,25,2600,1757,1,50.0
10820,7449.0,LOVE BUILDING BLOCK WORD,6,517,15,1600,1083,1,30.0
10821,7450.0,PHOTO FRAME CORNICE,7,831,19,2000,1169,1,38.0
10822,7451.0,PENS ASSORTED FUNNY FACE,10,296,2,300,4,1,4.0
10823,7452.0,CARD CIRCUS PARADE,9,100,0,100,0,1,0.0
10824,7453.0,WRAP COWBOYS  ,1,1789,25,2600,811,1,50.0
10825,7454.0,AIRLINE BAG VINTAGE TOKYO 84,3,272,2,300,28,1,4.0
10826,7455.0,RED RETROSPOT UMBRELLA,10,237,4,500,263,1,8.0
10827,7456.0,BLACK/BLUE POLKADOT UMBRELLA,5,591,5,600,9,1,10.0
10828,7457.0,RED 3 PIECE RETROSPOT CUTLERY SET,8,475,13,1400,925,1,26.0
10829,7458.0,PACK OF 72 RETROSPOT CAKE CASES,4,1142,17,1800,658,1,34.0
10830,7459.0,SET OF 72 RETROSPOT PAPER  DOILIES,9,840,21,2200,1360,1,42.0
10831,7460.0,BLUE COAT RACK PARIS FASHION,6,274,17,1800,1526,1,34.0
10832,7461.0,PLASTERS IN TIN SKULLS,8,229,9,1000,771,1,18.0
10833,7462.0,SLEEPING CAT ERASERS,8,399,10,1100,701,1,20.0
10834,7463.0,CARD BIRTHDAY COWBOY,4,345,9,1000,655,1,18.0
10835,7464.0,PACK 3 BOXES CHRISTMAS PANNETONE,1,732,18,1900,1168,1,36.0
10836,7465.0,ROTATING SILVER ANGELS T-LIGHT HLDR,10,1637,18,1900,263,1,36.0
10837,7466.0,COSY HOUR GIANT TUBE MATCHES,7,347,23,2400,2053,1,46.0
10838,7467.0,RIBBON REEL MAKING SNOWMEN ,3,218,4,500,282,1,8.0
10839,7468.0,MINI PAINT SET VINTAGE ,9,727,20,2100,1373,1,40.0
10840,7469.0,10 TRADITIONAL SPINNING TOPS,7,1479,19,2000,521,1,38.0
10841,7470.0,SET OF 6 SOLDIER SKITTLES,10,1021,14,1500,479,1,28.0
10842,7471.0,BAG 500g SWIRLY MARBLES,10,1498,16,1700,202,1,32.0
10843,7472.0,11 STRAND GLASS NECKLACE CRYSTAL,2,2331,24,2500,169,1,48.0
10844,7473.0,WHITE SKULL HOT WATER BOTTLE ,4,1739,25,2600,861,1,50.0
10845,7474.0,SCOTTIE DOG HOT WATER BOTTLE,1,1124,19,2000,876,1,38.0
10846,7475.0,SQUARECUSHION COVER PINK UNION FLAG,7,100,0,100,0,1,0.0
10847,7476.0,SPACEBOY CHILDRENS EGG CUP,3,382,3,400,18,1,6.0
10848,7477.0,CHILDREN'S SPACEBOY MUG,8,419,15,1600,1181,1,30.0
10849,7478.0,HAND WARMER SCOTTY DOG DESIGN,2,521,6,700,179,1,12.0
10850,7479.0,FELTCRAFT CUSHION OWL,5,243,3,400,157,1,6.0
10851,7480.0,BLACK CANDELABRA T-LIGHT HOLDER,6,160,3,400,240,1,6.0
10852,7481.0,TOY TIDY DOLLY GIRL DESIGN,1,533,7,800,267,1,14.0
10853,7482.0,SET 12 LAVENDER  BOTANICAL T-LIGHTS,9,112,12,1300,1188,1,24.0
10854,7483.0,UNION JACK FLAG LUGGAGE TAG,10,1226,15,1600,374,1,30.0
10855,7484.0,RED HEART LUGGAGE TAG,2,1571,20,2100,529,1,40.0
10856,7485.0,RED GLASS TASSLE BAG CHARM,6,775,10,1100,325,1,20.0
10857,7486.0,CLEAR ACRYLIC FACETED BANGLE,7,542,6,700,158,1,12.0
10858,7487.0,11 STRAND GLASS NECKLACE CRYSTAL,4,339,11,1200,861,1,22.0
10859,7488.0,DOORMAT UNION JACK GUNS AND ROSES,4,819,12,1300,481,1,24.0
10860,7489.0,VANILLA SCENT CANDLE JEWELLED BOX,10,1947,21,2200,253,1,42.0
10861,7490.0,FULL ENGLISH BREAKFAST PLATE,3,864,20,2100,1236,1,40.0
10862,7491.0,BLACK CANDELABRA T-LIGHT HOLDER,7,483,21,2200,1717,1,42.0
10863,7492.0,MAGIC DRAWING SLATE CIRCUS PARADE  ,7,292,2,300,8,1,4.0
10864,7493.0,CHRISTMAS HANGING HEART WITH BELL,1,804,12,1300,496,1,24.0
10865,7494.0,CAKE STAND VICTORIAN FILIGREE MED,1,629,9,1000,371,1,18.0
10866,7495.0,PAISLEY PATTERN  STICKERS,9,621,23,2400,1779,1,46.0
10867,7496.0,FLOWERS  STICKERS,1,231,11,1200,969,1,22.0
10868,7497.0,PINK NEW BAROQUECANDLESTICK CANDLE,8,406,6,700,294,1,12.0
10869,7498.0,BLUE NEW BAROQUE CANDLESTICK CANDLE,5,1775,20,2100,325,1,40.0
10870,7499.0,JUMBO STORAGE BAG SUKI,7,397,13,1400,1003,1,26.0
10871,7500.0,BLACK LOVE BIRD CANDLE,1,568,13,1400,832,1,26.0
10872,7501.0,PARTY TIME PENCIL ERASERS,1,279,9,1000,721,1,18.0
10873,7502.0,DISCO BALL CHRISTMAS DECORATION,3,835,10,1100,265,1,20.0
10874,7503.0,PINK B'FLY C/COVER W BOBBLES,6,106,11,1200,1094,1,22.0
10875,7504.0,PINK UNION JACK  LUGGAGE TAG,4,1087,19,2000,913,1,38.0
10876,7505.0,12 RIBBONS ELEGANT CHRISTMAS ,4,846,25,2600,1754,1,50.0
10877,7506.0,UNION JACK FLAG LUGGAGE TAG,3,803,23,2400,1597,1,46.0
10878,7507.0,AGED GLASS SILVER T-LIGHT HOLDER,5,329,10,1100,771,1,20.0
10879,7508.0,BOOM BOX SPEAKER GIRLS,5,366,3,400,34,1,6.0
10880,7509.0,12 RIBBONS SHIMMERING PINKS ,1,521,6,700,179,1,12.0
10881,7510.0, SET 2 TEA TOWELS I LOVE LONDON ,1,438,4,500,62,1,8.0
10882,7511.0,JUMBO BAG OWLS,5,409,12,1300,891,1,24.0
10883,7512.0,SANDWICH BATH SPONGE,9,2365,25,2600,235,1,50.0
10884,7513.0,OWL DOORSTOP,3,396,5,600,204,1,10.0
10885,7514.0,11 STRAND GLASS NECKLACE CRYSTAL,8,277,13,1400,1123,1,26.0
10886,7515.0,HAND WARMER UNION JACK,2,238,3,400,162,1,6.0
10887,7516.0,HAND WARMER SCOTTY DOG DESIGN,1,2151,21,2200,49,1,42.0
10888,7517.0,LARGE POPCORN HOLDER ,1,500,21,2200,1700,1,42.0
10889,7518.0,PAINTED METAL STAR WITH HOLLY BELLS,2,688,23,2400,1712,1,46.0
10890,7519.0,PAINTED METAL HEART WITH HOLLY BELL,7,642,7,800,158,1,14.0
10891,7520.0,ANGEL DECORATION STARS ON DRESS,5,153,7,800,647,1,14.0
10892,7521.0,SMALL POPCORN HOLDER,8,1549,24,2500,951,1,48.0
10893,7522.0,JUMBO BAG RED RETROSPOT,9,723,15,1600,877,1,30.0
10894,7523.0,JUMBO BAG STRAWBERRY,4,143,15,1600,1457,1,30.0
10895,7524.0,STRAWBERRY SHOPPER BAG,4,172,15,1600,1428,1,30.0
10896,7525.0,STRAWBERRY CHARLOTTE BAG,10,140,3,400,260,1,6.0
10897,7526.0, SET 2 TEA TOWELS I LOVE LONDON ,6,166,4,500,334,1,8.0
10898,7527.0,PACK OF 12 RED RETROSPOT TISSUES ,3,333,7,800,467,1,14.0
10899,7528.0,SCOTTIE DOG HOT WATER BOTTLE,3,131,2,300,169,1,4.0
10900,7529.0,CHOCOLATE HOT WATER BOTTLE,4,1249,15,1600,351,1,30.0
10901,7530.0,LUNCH BAG CARS BLUE,6,467,6,700,233,1,12.0
10902,7531.0,LUNCH BAG SPACEBOY DESIGN ,6,2244,24,2500,256,1,48.0
10903,7532.0,ROUND SNACK BOXES SET OF4 WOODLAND ,10,377,14,1500,1123,1,28.0
10904,7533.0,LUNCH BAG DOLLY GIRL DESIGN,8,446,22,2300,1854,1,44.0
10905,7534.0,LUNCH BAG SUKI  DESIGN ,7,1452,21,2200,748,1,42.0
10906,7535.0,LUNCH BAG  BLACK SKULL.,1,100,0,100,0,1,0.0
10907,7536.0,ROUND SNACK BOXES SET OF 4 FRUITS ,3,356,10,1100,744,1,20.0
10908,7537.0,ROUND SNACK BOXES SET OF 4 SKULLS,3,175,8,900,725,1,16.0
10909,7538.0,DOLLY GIRL LUNCH BOX,9,198,17,1800,1602,1,34.0
10910,7539.0,SPACEBOY LUNCH BOX ,2,154,16,1700,1546,1,32.0
10911,7540.0,GREEN POLKADOT PLATE ,10,870,13,1400,530,1,26.0
10912,7541.0,BLUE POLKADOT PLATE ,9,119,2,300,181,1,4.0
10913,7542.0,RED RETROSPOT PLATE ,7,800,11,1200,400,1,22.0
10914,7543.0,PINK  POLKADOT PLATE ,1,2151,25,2600,449,1,50.0
10915,7544.0,ROUND SNACK BOXES SET OF 4 SKULLS,8,327,4,500,173,1,8.0
10916,7545.0,FELTCRAFT DOLL MOLLY,4,1420,19,2000,580,1,38.0
10917,7546.0,FELTCRAFT CHRISTMAS FAIRY,7,186,1,200,14,1,2.0
10918,7547.0,TRAVEL SEWING KIT,1,397,3,400,3,1,6.0
10919,7548.0,SET OF 3 NOTEBOOKS IN PARCEL,4,2287,25,2600,313,1,50.0
10920,7549.0,RED RETROSPOT TAPE,1,556,7,800,244,1,14.0
10921,7550.0,COSY SLIPPER SHOES SMALL  RED ,6,177,2,300,123,1,4.0
10922,7551.0,12 RIBBONS RUSTIC CHARM,10,1603,19,2000,397,1,38.0
10923,7552.0,SCANDINAVIAN REDS RIBBONS,4,1070,25,2600,1530,1,50.0
10924,7553.0,JAM MAKING SET PRINTED,8,1025,11,1200,175,1,22.0
10925,7554.0,18 DAISY PEGS IN WOOD BOX,7,100,0,100,0,1,0.0
10926,7555.0,HOT WATER BOTTLE BABUSHKA ,2,222,2,300,78,1,4.0
10927,7556.0,FELTCRAFT PRINCESS CHARLOTTE DOLL,1,1210,18,1900,690,1,36.0
10928,7557.0,FELTCRAFT CHRISTMAS FAIRY,8,378,7,800,422,1,14.0
10929,7558.0,FELTCRAFT PRINCESS CHARLOTTE DOLL,9,273,9,1000,727,1,18.0
10930,7559.0,12 RIBBONS RUSTIC CHARM,10,1910,20,2100,190,1,40.0
10931,7560.0,COSY SLIPPER SHOES SMALL  RED ,5,1685,19,2000,315,1,38.0
10932,7561.0,SCANDINAVIAN REDS RIBBONS,10,1273,13,1400,127,1,26.0
10933,7562.0,11 HOOK HANGER RED MAGIC TOADSTOOL,2,363,21,2200,1837,1,42.0
10934,7563.0,CHRISTMAS CRAFT TREE TOP ANGEL,9,179,4,500,321,1,8.0
10935,7564.0,CHRISTMAS CRAFT LITTLE FRIENDS,2,729,7,800,71,1,14.0
10936,7565.0,11 HOOK HANGER RED MAGIC TOADSTOOL,1,456,4,500,44,1,8.0
10937,7566.0,12 RIBBONS RUSTIC CHARM,6,486,11,1200,714,1,22.0
10938,7567.0,18 DAISY PEGS IN WOOD BOX,3,100,0,100,0,1,0.0
10939,7568.0,SET OF 3 NOTEBOOKS IN PARCEL,4,390,13,1400,1010,1,26.0
10940,7569.0,11 HOOK HANGER MAGIC TOADSTOOL,9,946,11,1200,254,1,22.0
10941,7570.0,SCANDINAVIAN REDS RIBBONS,10,480,14,1500,1020,1,28.0
10942,7571.0,RED TOADSTOOL LED NIGHT LIGHT,10,181,13,1400,1219,1,26.0
10943,7572.0,11 HOOK HANGER RED MAGIC TOADSTOOL,1,100,0,100,0,1,0.0
10944,7573.0,COSY SLIPPER SHOES SMALL GREEN,5,538,20,2100,1562,1,40.0
10945,7574.0,COSY SLIPPER SHOES SMALL  RED ,2,513,8,900,387,1,16.0
10946,7575.0,FELTCRAFT DOLL ROSIE,6,153,13,1400,1247,1,26.0
10947,7576.0,FELTCRAFT DOLL MOLLY,4,834,10,1100,266,1,20.0
10948,7577.0,FELTCRAFT DOLL EMILY,5,1589,16,1700,111,1,32.0
10949,7578.0,FELTCRAFT PRINCESS CHARLOTTE DOLL,2,882,8,900,18,1,16.0
10950,7579.0,FELTCRAFT PRINCESS OLIVIA DOLL,7,146,2,300,154,1,4.0
10951,7580.0,REX CASH+CARRY JUMBO SHOPPER,2,317,3,400,83,1,6.0
10952,7581.0,FELTCRAFT DOLL MOLLY,2,1860,19,2000,140,1,38.0
10953,7582.0,FELTCRAFT CUSHION OWL,5,172,4,500,328,1,8.0
10954,7583.0,CHRISTMAS CRAFT TREE TOP ANGEL,1,404,7,800,396,1,14.0
10955,7584.0,CHRISTMAS CRAFT LITTLE FRIENDS,7,100,0,100,0,1,0.0
10956,7585.0,FELTCRAFT CUSHION RABBIT,2,1244,18,1900,656,1,36.0
10957,7586.0,FELTCRAFT CUSHION BUTTERFLY,7,776,11,1200,424,1,22.0
10958,7587.0,18 DAISY PEGS IN WOOD BOX,10,176,1,200,24,1,2.0
10959,7588.0,PAPER CHAIN KIT 50'S CHRISTMAS ,3,2376,24,2500,124,1,48.0
10960,7589.0,FELTCRAFT CUSHION BUTTERFLY,1,123,6,700,577,1,12.0
10961,7590.0,18 DAISY PEGS IN WOOD BOX,1,1089,21,2200,1111,1,42.0
10962,7591.0,ROSE COTTAGE KEEPSAKE BOX ,2,1285,17,1800,515,1,34.0
10963,7592.0,TOTE BAG I LOVE LONDON,5,292,7,800,508,1,14.0
10964,7593.0,18 DAISY PEGS IN WOOD BOX,10,1137,22,2300,1163,1,44.0
10965,7594.0,TOTE BAG I LOVE LONDON,9,1695,23,2400,705,1,46.0
10966,7595.0,FOLDING UMBRELLA PINKWHITE POLKADOT,1,249,7,800,551,1,14.0
10967,7596.0,FOLDING UMBRELLA CREAM POLKADOT,4,846,9,1000,154,1,18.0
10968,7597.0,FOLDING UMBRELLA WHITE/RED POLKADOT,5,1075,13,1400,325,1,26.0
10969,7598.0,SET 10 LIGHTS NIGHT OWL,7,101,21,2200,2099,1,42.0
10970,7599.0,SMALL POPCORN HOLDER,1,585,7,800,215,1,14.0
10971,7600.0, SET 2 TEA TOWELS I LOVE LONDON ,5,352,10,1100,748,1,20.0
10972,7601.0,FOLDING UMBRELLA RED/WHITE POLKADOT,9,915,17,1800,885,1,34.0
10973,7602.0,BABUSHKA LIGHTS STRING OF 16,6,1186,18,1900,714,1,36.0
10974,7603.0,LUNCH BAG RED RETROSPOT,6,1656,23,2400,744,1,46.0
10975,7604.0,S/4 VALENTINE DECOUPAGE HEART BOX,2,263,4,500,237,1,8.0
10976,7605.0,FOLDING UMBRELLA CREAM POLKADOT,6,1686,17,1800,114,1,34.0
10977,7606.0, SET 2 TEA TOWELS I LOVE LONDON ,7,563,5,600,37,1,10.0
10978,7607.0,FOLDING UMBRELLA RED/WHITE POLKADOT,6,334,4,500,166,1,8.0
10979,7608.0,SOLDIERS EGG CUP ,7,1028,15,1600,572,1,30.0
10980,7609.0,S/4 VALENTINE DECOUPAGE HEART BOX,2,131,3,400,269,1,6.0
10981,7610.0,RED RETROSPOT MINI CASES,9,250,15,1600,1350,1,30.0
10982,7611.0,,1,670,19,2000,1330,1,38.0
10983,7612.0,66 CAKE CASES VINTAGE CHRISTMAS,7,318,3,400,82,1,6.0
10984,7613.0,PAPER CHAIN KIT VINTAGE CHRISTMAS,2,283,2,300,17,1,4.0
10985,7614.0,RIBBON REEL CHRISTMAS SOCK BAUBLE,6,220,3,400,180,1,6.0
10986,7615.0,RIBBON REEL SNOWY VILLAGE,10,1131,22,2300,1169,1,44.0
10987,7616.0,RIBBON REEL MAKING SNOWMEN ,2,958,10,1100,142,1,20.0
10988,7617.0,SET OF 20 VINTAGE CHRISTMAS NAPKINS,3,100,0,100,0,1,0.0
10989,7618.0,TURQUOISE CHRISTMAS TREE ,3,201,2,300,99,1,4.0
10990,7619.0,RED STAR CARD HOLDER,8,1409,22,2300,891,1,44.0
10991,7620.0,WICKER WREATH SMALL,4,294,3,400,106,1,6.0
10992,7621.0,HEART OF WICKER LARGE,7,367,9,1000,633,1,18.0
10993,7622.0,ADVENT CALENDAR GINGHAM SACK,10,518,9,1000,482,1,18.0
10994,7623.0,HEART OF WICKER SMALL,2,663,15,1600,937,1,30.0
10995,7624.0,FELTCRAFT BUTTERFLY HEARTS,10,286,3,400,114,1,6.0
10996,7625.0,PARTY CONE CHRISTMAS DECORATION ,5,174,1,200,26,1,2.0
10997,7626.0,VINTAGE HEADS AND TAILS CARD GAME ,7,571,16,1700,1129,1,32.0
10998,7627.0,WICKER STAR ,7,164,15,1600,1436,1,30.0
10999,7628.0,VINTAGE SNAP CARDS,7,627,24,2500,1873,1,48.0
11000,7629.0,FELTCRAFT 6 FLOWER FRIENDS,9,1350,22,2300,950,1,44.0
11001,7630.0, SET 2 TEA TOWELS I LOVE LONDON ,6,1109,11,1200,91,1,22.0
11002,7631.0,JAM MAKING SET PRINTED,5,242,20,2100,1858,1,40.0
11003,7632.0,BIRD DECORATION RED RETROSPOT,1,372,7,800,428,1,14.0
11004,7633.0,CHRISTMAS GINGHAM TREE,1,1089,21,2200,1111,1,42.0
11005,7634.0,CHRISTMAS GINGHAM STAR,3,222,12,1300,1078,1,24.0
11006,7635.0,CHRISTMAS GINGHAM HEART,3,1812,18,1900,88,1,36.0
11007,7636.0,PACK OF 12 PINK POLKADOT TISSUES,9,100,0,100,0,1,0.0
11008,7637.0,FELTCRAFT PRINCESS LOLA DOLL,2,945,12,1300,355,1,24.0
11009,7638.0,PACK OF 12 LONDON TISSUES ,5,256,5,600,344,1,10.0
11010,7639.0,PURPLE DRAWERKNOB ACRYLIC EDWARDIAN,3,390,10,1100,710,1,20.0
11011,7640.0,CHILDREN'S APRON DOLLY GIRL ,10,197,12,1300,1103,1,24.0
11012,7641.0,CHILDRENS APRON SPACEBOY DESIGN,9,518,16,1700,1182,1,32.0
11013,7642.0,CHRISTMAS LIGHTS 10 SANTAS ,4,1886,19,2000,114,1,38.0
11014,7643.0,CHRISTMAS LIGHTS 10 REINDEER,6,1339,23,2400,1061,1,46.0
11015,7644.0,PAPER CHAIN KIT 50'S CHRISTMAS ,9,904,16,1700,796,1,32.0
11016,7645.0,FELTCRAFT CHRISTMAS FAIRY,10,668,12,1300,632,1,24.0
11017,7646.0,PACK OF 72 RETROSPOT CAKE CASES,7,1061,19,2000,939,1,38.0
11018,7647.0,PACK OF 60 MUSHROOM CAKE CASES,8,154,10,1100,946,1,20.0
11019,7648.0,66 CAKE CASES DOLLY GIRL DESIGN,8,771,17,1800,1029,1,34.0
11020,7649.0,PACK OF 60 PINK PAISLEY CAKE CASES,6,114,9,1000,886,1,18.0
11021,7650.0,HAND WARMER BABUSHKA DESIGN,7,1454,25,2600,1146,1,50.0
11022,7651.0,HAND WARMER BIRD DESIGN,8,870,23,2400,1530,1,46.0
11023,7652.0,HAND WARMER OWL DESIGN,10,635,18,1900,1265,1,36.0
11024,7653.0,HAND WARMER RED RETROSPOT,6,609,19,2000,1391,1,38.0
11025,7654.0,SET 12 RETRO WHITE CHALK STICKS,9,675,6,700,25,1,12.0
11026,7655.0,FELTCRAFT HAIRBAND RED AND BLUE,2,1175,11,1200,25,1,22.0
11027,7656.0,FELTCRAFT HAIRBAND PINK AND PURPLE,10,1650,20,2100,450,1,40.0
11028,7657.0,FELTCRAFT HAIRBANDS PINK AND WHITE ,4,224,4,500,276,1,8.0
11029,7658.0,TV DINNER TRAY DOLLY GIRL,3,363,12,1300,937,1,24.0
11030,7659.0,PLASTERS IN TIN VINTAGE PAISLEY ,3,350,24,2500,2150,1,48.0
11031,7660.0,PLASTERS IN TIN SPACEBOY,3,1736,18,1900,164,1,36.0
11032,7661.0,PLASTERS IN TIN WOODLAND ANIMALS,2,118,1,200,82,1,2.0
11033,7662.0,MAGIC DRAWING SLATE SPACEBOY ,7,158,2,300,142,1,4.0
11034,7663.0,MAGIC DRAWING SLATE CIRCUS PARADE  ,7,229,4,500,271,1,8.0
11035,7664.0,MAGIC DRAWING SLATE GO TO THE FAIR ,10,396,3,400,4,1,6.0
11036,7665.0,MAGIC DRAWING SLATE DOLLY GIRL ,1,494,11,1200,706,1,22.0
11037,7666.0,CHARLIE + LOLA RED HOT WATER BOTTLE,3,2379,25,2600,221,1,50.0
11038,7667.0,HOT WATER BOTTLE BABUSHKA ,9,217,10,1100,883,1,20.0
11039,7668.0,URBAN BLACK RIBBONS ,5,896,24,2500,1604,1,48.0
11040,7669.0,FELTCRAFT PRINCESS CHARLOTTE DOLL,9,122,2,300,178,1,4.0
11041,7670.0,SET OF 6 T-LIGHTS TOADSTOOLS,6,128,7,800,672,1,14.0
11042,7671.0,ROTATING LEAVES T-LIGHT HOLDER,3,1242,17,1800,558,1,34.0
11043,7672.0,RED  HARMONICA IN BOX ,7,1510,21,2200,690,1,42.0
11044,7673.0,CUPCAKE LACE PAPER SET 12,5,1254,14,1500,246,1,28.0
11045,7674.0,FAMILY PHOTO FRAME CORNICE,5,457,13,1400,943,1,26.0
11046,7675.0,TRIPLE PHOTO FRAME CORNICE ,4,1289,17,1800,511,1,34.0
11047,7676.0,WOODEN FRAME ANTIQUE WHITE ,1,1206,14,1500,294,1,28.0
11048,7677.0,WOODEN BOX OF DOMINOES,6,965,14,1500,535,1,28.0
11049,7678.0,TRADITIONAL WOODEN CATCH CUP GAME ,5,389,19,2000,1611,1,38.0
11050,7679.0,TRADITIONAL WOODEN SKIPPING ROPE,10,704,7,800,96,1,14.0
11051,7680.0,S/6 WOODEN SKITTLES IN COTTON BAG,2,309,5,600,291,1,10.0
11052,7681.0,RED METAL BEACH SPADE ,9,1793,20,2100,307,1,40.0
11053,7682.0,BOYS VINTAGE TIN SEASIDE BUCKET,7,198,3,400,202,1,6.0
11054,7683.0,GIRLS VINTAGE TIN SEASIDE BUCKET,9,251,14,1500,1249,1,28.0
11055,7684.0,GREY HEART HOT WATER BOTTLE,9,1027,10,1100,73,1,20.0
11056,7685.0,SCOTTIE DOG HOT WATER BOTTLE,7,1163,15,1600,437,1,30.0
11057,7686.0,BIRD HOUSE HOT WATER BOTTLE,3,497,20,2100,1603,1,40.0
11058,7687.0,KINGS CHOICE TEA CADDY ,6,115,17,1800,1685,1,34.0
11059,7688.0,KINGS CHOICE BISCUIT TIN,5,1059,10,1100,41,1,20.0
11060,7689.0,METAL SIGN EMPIRE TEA,3,410,15,1600,1190,1,30.0
11061,7690.0,HOMEMADE JAM SCENTED CANDLES,1,471,15,1600,1129,1,30.0
11062,7691.0,SET OF 6 SOLDIER SKITTLES,3,787,21,2200,1413,1,42.0
11063,7692.0,FAWN BLUE HOT WATER BOTTLE,6,897,20,2100,1203,1,40.0
11064,7693.0,HAND WARMER RED RETROSPOT,7,490,6,700,210,1,12.0
11065,7694.0,HOT WATER BOTTLE BABUSHKA ,4,486,18,1900,1414,1,36.0
11066,7695.0,WHITE SKULL HOT WATER BOTTLE ,4,850,21,2200,1350,1,42.0
11067,7696.0,RETROSPOT HEART HOT WATER BOTTLE,9,459,8,900,441,1,16.0
11068,7697.0,RED WOOLLY HOTTIE WHITE HEART.,4,421,4,500,79,1,8.0
11069,7698.0,SCOTTIE DOG HOT WATER BOTTLE,1,455,23,2400,1945,1,46.0
11070,7699.0,GREY HEART HOT WATER BOTTLE,3,1068,21,2200,1132,1,42.0
11071,7700.0,HOT WATER BOTTLE BABUSHKA ,4,880,15,1600,720,1,30.0
11072,7701.0,PACK OF 6 BIRDY GIFT TAGS,2,1489,23,2400,911,1,46.0
11073,7702.0,CHILLI LIGHTS,9,913,16,1700,787,1,32.0
11074,7703.0,PIGGY BANK RETROSPOT ,6,2035,20,2100,65,1,40.0
11075,7704.0,CERAMIC STRAWBERRY MONEY BOX,8,702,9,1000,298,1,18.0
11076,7705.0,CERAMIC STRAWBERRY CAKE MONEY BANK,7,381,22,2300,1919,1,44.0
11077,7706.0,CERAMIC CHERRY CAKE MONEY BANK,2,804,9,1000,196,1,18.0
11078,7707.0,CERAMIC HEART FAIRY CAKE MONEY BANK,7,1018,15,1600,582,1,30.0
11079,7708.0,CERAMIC PIRATE CHEST MONEY BANK,5,124,14,1500,1376,1,28.0
11080,7709.0,DOORSTOP RETROSPOT HEART,1,190,4,500,310,1,8.0
11081,7710.0,GINGHAM HEART  DOORSTOP RED,1,684,10,1100,416,1,20.0
11082,7711.0,RETROSPOT BABUSHKA DOORSTOP,8,1721,25,2600,879,1,50.0
11083,7712.0,SILK PURSE BABUSHKA RED,2,1093,12,1300,207,1,24.0
11084,7713.0,SILK PURSE BABUSHKA PINK,3,1304,13,1400,96,1,26.0
11085,7714.0,FAMILY PHOTO FRAME CORNICE,9,887,24,2500,1613,1,48.0
11086,7715.0,SWEETHEART WIRE WALL TIDY,10,1871,18,1900,29,1,36.0
11087,7716.0,JAM MAKING SET PRINTED,4,322,17,1800,1478,1,34.0
11088,7717.0,RED RETROSPOT OVEN GLOVE ,10,730,16,1700,970,1,32.0
11089,7718.0,CREAM HEART CARD HOLDER,1,324,5,600,276,1,10.0
11090,7719.0,NAMASTE SWAGAT INCENSE,3,1793,18,1900,107,1,36.0
11091,7720.0,CERAMIC STRAWBERRY DESIGN MUG,6,670,21,2200,1530,1,42.0
11092,7721.0,BLACK HEART CARD HOLDER,4,879,24,2500,1621,1,48.0
11093,7722.0,CLASSICAL ROSE SMALL VASE,3,156,1,200,44,1,2.0
11094,7723.0,HYACINTH BULB T-LIGHT CANDLES,1,263,21,2200,1937,1,42.0
11095,7724.0,CHRISTMAS CRAFT WHITE FAIRY ,1,555,11,1200,645,1,22.0
11096,7725.0,CHRISTMAS CRAFT LITTLE FRIENDS,8,1276,13,1400,124,1,26.0
11097,7726.0,COSY HOUR CIGAR BOX MATCHES ,5,544,11,1200,656,1,22.0
11098,7727.0,RED TEA TOWEL CLASSIC DESIGN,2,205,11,1200,995,1,22.0
11099,7728.0,HEART FILIGREE DOVE  SMALL,1,634,24,2500,1866,1,48.0
11100,7729.0,RETROSPOT CHILDRENS APRON,2,886,16,1700,814,1,32.0
11101,7730.0,COLOURING PENCILS BROWN TUBE,5,520,18,1900,1380,1,36.0
11102,7731.0,10 IVORY DINNER CANDLES SILVER FLOCK,4,270,4,500,230,1,8.0
11103,7732.0,HEART FILIGREE DOVE  SMALL,4,345,15,1600,1255,1,30.0
11104,7733.0,ZINC METAL HEART DECORATION,7,143,1,200,57,1,2.0
11105,7734.0,GREEN FERN NOTEBOOK,10,687,12,1300,613,1,24.0
11106,7735.0,BLUE PAISLEY NOTEBOOK,6,173,5,600,427,1,10.0
11107,7736.0,CHRYSANTHEMUM NOTEBOOK,4,488,12,1300,812,1,24.0
11108,7737.0,LARGE CHINESE STYLE SCISSOR,10,1751,23,2400,649,1,46.0
11109,7738.0,SMALL CHINESE STYLE SCISSOR,6,138,4,500,362,1,8.0
11110,7739.0,S/6 WOODEN SKITTLES IN COTTON BAG,5,996,21,2200,1204,1,42.0
11111,7740.0,TRADITIONAL WOODEN SKIPPING ROPE,1,127,3,400,273,1,6.0
11112,7741.0,SET OF 6 SOLDIER SKITTLES,8,100,0,100,0,1,0.0
11113,7742.0,10 TRADITIONAL SPINNING TOPS,3,1461,17,1800,339,1,34.0
11114,7743.0,ROTATING SILVER ANGELS T-LIGHT HLDR,1,786,11,1200,414,1,22.0
11115,7744.0,BLACK LOVE BIRD CANDLE,4,100,0,100,0,1,0.0
11116,7745.0,RETROSPOT CHILDRENS APRON,9,588,6,700,112,1,12.0
11117,7746.0,HANGING GLASS ETCHED TEALIGHT,9,535,10,1100,565,1,20.0
11118,7747.0,HANGING GLASS ETCHED TEALIGHT,8,385,17,1800,1415,1,34.0
11119,7748.0,BLUE NEW BAROQUE CANDLESTICK CANDLE,3,995,23,2400,1405,1,46.0
11120,7749.0,COOKING SET RETROSPOT,7,1034,16,1700,666,1,32.0
11121,7750.0,KINGS CHOICE GIANT TUBE MATCHES,5,273,8,900,627,1,16.0
11122,7751.0,COSY HOUR GIANT TUBE MATCHES,1,1093,10,1100,7,1,20.0
11123,7752.0,PLACE SETTING WHITE STAR,3,1144,22,2300,1156,1,44.0
11124,7753.0,HYACINTH BULB T-LIGHT CANDLES,3,235,4,500,265,1,8.0
11125,7754.0,S/15 SILVER GLASS BAUBLES IN BAG,1,107,6,700,593,1,12.0
11126,7755.0,FRENCH WC SIGN BLUE METAL,9,228,5,600,372,1,10.0
11127,7756.0,KINGS CHOICE GIANT TUBE MATCHES,2,278,17,1800,1522,1,34.0
11128,7757.0,78 SWEETHEART FAIRY CAKE CASES,4,1144,21,2200,1056,1,42.0
11129,7758.0,ASSORTED COLOUR BIRD ORNAMENT,2,1345,25,2600,1255,1,50.0
11130,7759.0,FAIRY SOAP SOAP HOLDER,2,135,4,500,365,1,8.0
11131,7760.0,GREEN GIANT GARDEN THERMOMETER,4,2124,23,2400,276,1,46.0
11132,7761.0,IVORY GIANT GARDEN THERMOMETER,5,100,0,100,0,1,0.0
11133,7762.0,BLUE GIANT GARDEN THERMOMETER,10,277,2,300,23,1,4.0
11134,7763.0,PACK OF 60 PINK PAISLEY CAKE CASES,2,486,5,600,114,1,10.0
11135,7764.0,RETROSPOT HEART HOT WATER BOTTLE,7,125,1,200,75,1,2.0
11136,7765.0,CHICK GREY HOT WATER BOTTLE,1,1397,14,1500,103,1,28.0
11137,7766.0,VICTORIAN SEWING BOX SMALL ,7,327,21,2200,1873,1,42.0
11138,7767.0,VICTORIAN SEWING BOX MEDIUM,7,172,21,2200,2028,1,42.0
11139,7768.0,SET/10 RED POLKADOT PARTY CANDLES,5,894,11,1200,306,1,22.0
11140,7769.0,WASHROOM METAL SIGN,3,115,2,300,185,1,4.0
11141,7770.0,BLACK SWEETHEART BRACELET,1,795,9,1000,205,1,18.0
11142,7771.0,DIAMANTE HAIR GRIP PACK/2 BLACK DIA,6,1584,18,1900,316,1,36.0
11143,7772.0,BLACK DIAMANTE EXPANDABLE RING,7,1123,11,1200,77,1,22.0
11144,7773.0,DIAMANTE HAIR GRIP PACK/2 RUBY,10,198,21,2200,2002,1,42.0
11145,7774.0,DIAMANTE HAIR GRIP PACK/2 MONTANA,7,2559,25,2600,41,1,50.0
11146,7775.0,BLUE SWEETHEART BRACELET,1,173,1,200,27,1,2.0
11147,7776.0,PINK SWEETHEART BRACELET,6,573,5,600,27,1,10.0
11148,7777.0,PURPLE SWEETHEART BRACELET,3,232,10,1100,868,1,20.0
11149,7778.0,JUMBO BAG PINK POLKADOT,3,1446,20,2100,654,1,40.0
11150,7779.0,JUMBO BAG RED RETROSPOT,10,947,18,1900,953,1,36.0
11151,7780.0,ASSORTED COLOUR BIRD ORNAMENT,7,2256,23,2400,144,1,46.0
11152,7781.0,PAPER CHAIN KIT 50'S CHRISTMAS ,1,1455,16,1700,245,1,32.0
11153,7782.0,RIBBON REEL CHRISTMAS PRESENT ,9,341,13,1400,1059,1,26.0
11154,7783.0,FIRST AID TIN,3,1209,25,2600,1391,1,50.0
11155,7784.0,MAKE YOUR OWN MONSOON CARD KIT,2,131,21,2200,2069,1,42.0
11156,7785.0,PACK OF 12 HEARTS DESIGN TISSUES ,5,1864,20,2100,236,1,40.0
11157,7786.0,PACK OF 12 RED RETROSPOT TISSUES ,7,472,10,1100,628,1,20.0
11158,7787.0,SOLDIERS EGG CUP ,4,2119,23,2400,281,1,46.0
11159,7788.0,HEART IVORY TRELLIS SMALL,5,842,16,1700,858,1,32.0
11160,7789.0,HEART FILIGREE DOVE  SMALL,5,529,11,1200,671,1,22.0
11161,7790.0,HEART FILIGREE DOVE LARGE,4,244,4,500,256,1,8.0
11162,7791.0,PACK 3 BOXES BIRD PANNETONE ,9,1989,24,2500,511,1,48.0
11163,7792.0,PACK 3 BOXES CHRISTMAS PANNETONE,2,808,18,1900,1092,1,36.0
11164,7793.0,SMALL POPCORN HOLDER,3,926,21,2200,1274,1,42.0
11165,7794.0,PACK OF 60 PINK PAISLEY CAKE CASES,3,486,7,800,314,1,14.0
11166,7795.0,SET OF 6 SOLDIER SKITTLES,3,931,15,1600,669,1,30.0
11167,7796.0,SWIRLY CIRCULAR RUBBERS IN BAG,1,294,3,400,106,1,6.0
11168,7797.0,VINTAGE PAISLEY STATIONERY SET,4,2440,24,2500,60,1,48.0
11169,7798.0,PAPER CHAIN KIT VINTAGE CHRISTMAS,9,822,21,2200,1378,1,42.0
11170,7799.0,SET/10 BLUE POLKADOT PARTY CANDLES,4,1087,10,1100,13,1,20.0
11171,7800.0,RIBBON REEL SOCKS AND MITTENS,4,407,11,1200,793,1,22.0
11172,7801.0,66 CAKE CASES VINTAGE CHRISTMAS,4,2033,20,2100,67,1,40.0
11173,7802.0,CHRISTMAS METAL TAGS ASSORTED ,6,122,6,700,578,1,12.0
11174,7803.0,CHRISTMAS TREE T-LIGHT HOLDER,10,995,14,1500,505,1,28.0
11175,7804.0,STAR  T-LIGHT HOLDER ,1,100,0,100,0,1,0.0
11176,7805.0,HEART T-LIGHT HOLDER ,2,106,2,300,194,1,4.0
11177,7806.0,MINI FUNKY DESIGN TAPES,4,362,13,1400,1038,1,26.0
11178,7807.0,SET OF 6 T-LIGHTS SNOWMEN,5,132,1,200,68,1,2.0
11179,7808.0,STAR WOODEN CHRISTMAS DECORATION,6,624,23,2400,1776,1,46.0
11180,7809.0,WOODEN HEART CHRISTMAS SCANDINAVIAN,9,847,13,1400,553,1,26.0
11181,7810.0,CHRISTMAS RETROSPOT TREE WOOD,5,509,12,1300,791,1,24.0
11182,7811.0,SET OF 6 T-LIGHTS SANTA,10,346,12,1300,954,1,24.0
11183,7812.0,SET/9 CHRISTMAS T-LIGHTS SCENTED ,8,1254,13,1400,146,1,26.0
11184,7813.0,BLUE ROSE FABRIC MIRROR,2,608,15,1600,992,1,30.0
11185,7814.0,THREE CANVAS LUGGAGE TAGS,8,244,2,300,56,1,4.0
11186,7815.0,RETROSPOT PARTY BAG + STICKER SET,10,249,2,300,51,1,4.0
11187,7816.0,PLASTERS IN TIN VINTAGE PAISLEY ,1,344,15,1600,1256,1,30.0
11188,7817.0,RETROSPOT SMALL TUBE MATCHES,10,365,5,600,235,1,10.0
11189,7818.0,HAND WARMER SCOTTY DOG DESIGN,3,258,5,600,342,1,10.0
11190,7819.0,3D CHRISTMAS STAMPS STICKERS ,2,511,15,1600,1089,1,30.0
11191,7820.0,HAND WARMER SCOTTY DOG DESIGN,2,100,0,100,0,1,0.0
11192,7821.0,HAND WARMER SCOTTY DOG DESIGN,2,601,18,1900,1299,1,36.0
11193,7822.0,CLOTHES PEGS RETROSPOT PACK 30,3,107,14,1500,1393,1,28.0
11194,7823.0,42 FOIL HEART CAKE CASES,9,1196,21,2200,1004,1,42.0
11195,7824.0,CHRISTMAS METAL TAGS ASSORTED ,8,1045,23,2400,1355,1,46.0
11196,7825.0,PACK OF 6 SWEETIE GIFT BOXES,2,120,1,200,80,1,2.0
11197,7826.0,PACK OF 72 RETROSPOT CAKE CASES,10,1648,25,2600,952,1,50.0
11198,7827.0,PACK OF 72 RETROSPOT CAKE CASES,9,163,1,200,37,1,2.0
11199,7828.0,PACK OF 6 BIRDY GIFT TAGS,5,791,20,2100,1309,1,40.0
11200,7829.0,SET/10 RED POLKADOT PARTY CANDLES,2,139,7,800,661,1,14.0
11201,7830.0,SET/10 PINK POLKADOT PARTY CANDLES,7,374,23,2400,2026,1,46.0
11202,7831.0,SET OF 3 NOTEBOOKS IN PARCEL,9,213,5,600,387,1,10.0
11203,7832.0,STAR  T-LIGHT HOLDER ,9,264,6,700,436,1,12.0
11204,7833.0,CINAMMON SET OF 9 T-LIGHTS,6,424,6,700,276,1,12.0
11205,7834.0,ORANGE SCENTED SET/9 T-LIGHTS,4,435,23,2400,1965,1,46.0
11206,7835.0,RIBBON REEL STRIPES DESIGN ,10,758,12,1300,542,1,24.0
11207,7836.0,SET OF 2 TINS JARDIN DE PROVENCE,9,784,9,1000,216,1,18.0
11208,7837.0,MAKE YOUR OWN PLAYTIME CARD KIT,10,136,2,300,164,1,4.0
11209,7838.0,DINOSAURS  WRITING SET ,8,411,12,1300,889,1,24.0
11210,7839.0,BALLOONS  WRITING SET ,7,2278,24,2500,222,1,48.0
11211,7840.0,SKULLS WRITING SET ,8,847,10,1100,253,1,20.0
11212,7841.0,VINTAGE PAISLEY STATIONERY SET,10,375,7,800,425,1,14.0
11213,7842.0,COSY SLIPPER SHOES SMALL  RED ,7,2089,25,2600,511,1,50.0
11214,7843.0,DOORMAT BLACK FLOCK ,9,774,21,2200,1426,1,42.0
11215,7844.0,JUMBO  BAG BAROQUE BLACK WHITE,10,1364,14,1500,136,1,28.0
11216,7845.0,JAM MAKING SET WITH JARS,2,411,18,1900,1489,1,36.0
11217,7846.0,ORANGE SCENTED SET/9 T-LIGHTS,1,169,1,200,31,1,2.0
11218,7847.0,CINAMMON SET OF 9 T-LIGHTS,4,454,6,700,246,1,12.0
11219,7848.0,HAND WARMER SCOTTY DOG DESIGN,4,1066,16,1700,634,1,32.0
11220,7849.0,CHRISTMAS DECOUPAGE CANDLE,7,385,7,800,415,1,14.0
11221,7850.0,HEART T-LIGHT HOLDER ,10,1078,18,1900,822,1,36.0
11222,7851.0,GROW YOUR OWN BASIL IN ENAMEL MUG,7,496,9,1000,504,1,18.0
11223,7852.0,OFFICE MUG WARMER POLKADOT,2,1091,16,1700,609,1,32.0
11224,7853.0,SMALL POPCORN HOLDER,5,747,11,1200,453,1,22.0
11225,7854.0,JUMBO BAG DOLLY GIRL DESIGN,4,482,4,500,18,1,8.0
11226,7855.0,JAM MAKING SET WITH JARS,10,1573,22,2300,727,1,44.0
11227,7856.0,JAM MAKING SET PRINTED,1,1901,19,2000,99,1,38.0
11228,7857.0,SMALL GLASS HEART TRINKET POT,10,259,4,500,241,1,8.0
11229,7858.0,RED WOOLLY HOTTIE WHITE HEART.,7,171,1,200,29,1,2.0
11230,7859.0,BLACK RECORD COVER FRAME,1,752,18,1900,1148,1,36.0
11231,7860.0,"RECORD FRAME 7"" SINGLE SIZE ",10,176,23,2400,2224,1,46.0
11232,7861.0,42 PENCILS TUBE RED RETROSPOT,7,1263,19,2000,737,1,38.0
11233,7862.0,42 PENCILS TUBE WOODLAND,3,1368,16,1700,332,1,32.0
11234,7863.0,SET OF 6 SOLDIER SKITTLES,9,252,2,300,48,1,4.0
11235,7864.0,ROCKING HORSE RED CHRISTMAS ,10,250,21,2200,1950,1,42.0
11236,7865.0,CHRISTMAS GINGHAM HEART,4,2027,25,2600,573,1,50.0
11237,7866.0,CHRISTMAS GINGHAM STAR,9,931,16,1700,769,1,32.0
11238,7867.0,HAND WARMER UNION JACK,9,933,18,1900,967,1,36.0
11239,7868.0,HAND WARMER RED RETROSPOT,1,413,4,500,87,1,8.0
11240,7869.0,REGENCY CAKESTAND 3 TIER,3,100,0,100,0,1,0.0
11241,7870.0,JUMBO SHOPPER VINTAGE RED PAISLEY,1,1639,23,2400,761,1,46.0
11242,7871.0,RIBBON REEL SNOWY VILLAGE,1,1924,23,2400,476,1,46.0
11243,7872.0,VINTAGE UNION JACK BUNTING,3,807,10,1100,293,1,20.0
11244,7873.0,JAM MAKING SET WITH JARS,3,1042,24,2500,1458,1,48.0
11245,7874.0,RIBBON REEL STRIPES DESIGN ,7,935,13,1400,465,1,26.0
11246,7875.0,RETRO LONGBOARD IRONING BOARD COVER,6,1557,20,2100,543,1,40.0
11247,7876.0,3D DOG PICTURE PLAYING CARDS,9,202,7,800,598,1,14.0
11248,7877.0,RETROSPOT CIGAR BOX MATCHES ,4,170,2,300,130,1,4.0
11249,7878.0,SET/9 CHRISTMAS T-LIGHTS SCENTED ,6,219,4,500,281,1,8.0
11250,7879.0,ROTATING SILVER ANGELS T-LIGHT HLDR,7,909,13,1400,491,1,26.0
11251,7880.0,ROTATING SILVER ANGELS T-LIGHT HLDR,9,106,13,1400,1294,1,26.0
11252,7881.0,SAVE THE PLANET COTTON TOTE BAG,1,1341,13,1400,59,1,26.0
11253,7882.0,SET OF 20 VINTAGE CHRISTMAS NAPKINS,7,1191,17,1800,609,1,34.0
11254,7883.0,PAPER BUNTING WHITE LACE,5,1614,20,2100,486,1,40.0
11255,7884.0,GENTLEMAN SHIRT REPAIR KIT ,4,1600,24,2500,900,1,48.0
11256,7885.0,CARD I LOVE LONDON ,2,295,2,300,5,1,4.0
11257,7886.0,PAPER CHAIN KIT VINTAGE CHRISTMAS,6,308,17,1800,1492,1,34.0
11258,7887.0,MIRRORED WALL ART FOXY,1,140,1,200,60,1,2.0
11259,7888.0,MIRRORED WALL ART GENTS,5,824,9,1000,176,1,18.0
11260,7889.0,AIRLINE BAG VINTAGE JET SET WHITE,4,1013,17,1800,787,1,34.0
11261,7890.0,JAM MAKING SET PRINTED,3,1665,17,1800,135,1,34.0
11262,7891.0,POTTING SHED SOW 'N' GROW SET,9,376,4,500,124,1,8.0
11263,7892.0,BABUSHKA LIGHTS STRING OF 16,10,531,6,700,169,1,12.0
11264,7893.0,REX CASH+CARRY JUMBO SHOPPER,3,988,14,1500,512,1,28.0
11265,7894.0,AIRLINE BAG VINTAGE WORLD CHAMPION ,1,1013,24,2500,1487,1,48.0
11266,7895.0,HAND WARMER BIRD DESIGN,7,122,12,1300,1178,1,24.0
11267,7896.0,CHRISTMAS CRAFT LITTLE FRIENDS,1,1453,25,2600,1147,1,50.0
11268,7897.0,PINK HEARTS PAPER GARLAND,7,104,1,200,96,1,2.0
11269,7898.0,POTTING SHED SEED ENVELOPES,8,1058,19,2000,942,1,38.0
11270,7899.0,HI TEC ALPINE HAND WARMER,5,100,0,100,0,1,0.0
11271,7900.0,FELTCRAFT CHRISTMAS FAIRY,1,1093,24,2500,1407,1,48.0
11272,7901.0,HI TEC ALPINE HAND WARMER,9,1675,22,2300,625,1,44.0
11273,7902.0,ROTATING SILVER ANGELS T-LIGHT HLDR,9,1707,24,2500,793,1,48.0
11274,7903.0,9 STRIPEY MICE FELTCRAFT,6,490,20,2100,1610,1,40.0
11275,7904.0,FELTCRAFT 6 FLOWER FRIENDS,3,364,14,1500,1136,1,28.0
11276,7905.0,CHRISTMAS CRAFT LITTLE FRIENDS,6,100,0,100,0,1,0.0
11277,7906.0,VINTAGE UNION JACK CUSHION COVER,7,2015,20,2100,85,1,40.0
11278,7907.0,POLYESTER FILLER PAD 45x45cm,6,113,2,300,187,1,4.0
11279,7908.0,DOLLY GIRL LUNCH BOX,4,554,7,800,246,1,14.0
11280,7909.0,PACK OF 12 LONDON TISSUES ,10,2551,25,2600,49,1,50.0
11281,7910.0,CARD DOLLY GIRL ,2,2147,25,2600,453,1,50.0
11282,7911.0,CARD BILLBOARD FONT,3,350,3,400,50,1,6.0
11283,7912.0,RAINY LADIES BIRTHDAY CARD,10,423,12,1300,877,1,24.0
11284,7913.0,GREY HEART HOT WATER BOTTLE,7,1143,15,1600,457,1,30.0
11285,7914.0,RED WOOLLY HOTTIE WHITE HEART.,2,1534,21,2200,666,1,42.0
11286,7915.0,RED WHITE SCARF  HOT WATER BOTTLE,9,413,7,800,387,1,14.0
11287,7916.0, SET 2 TEA TOWELS I LOVE LONDON ,3,283,24,2500,2217,1,48.0
11288,7917.0,SET OF 2 TEA TOWELS APPLE AND PEARS,4,236,2,300,64,1,4.0
11289,7918.0,SET/2 RED RETROSPOT TEA TOWELS ,8,688,10,1100,412,1,20.0
11290,7919.0,LOVE BUILDING BLOCK WORD,6,2098,22,2300,202,1,44.0
11291,7920.0,HOME BUILDING BLOCK WORD,8,1250,15,1600,350,1,30.0
11292,7921.0,ASSORTED COLOUR BIRD ORNAMENT,2,791,19,2000,1209,1,38.0
11293,7922.0,LANTERN CREAM GAZEBO ,10,794,9,1000,206,1,18.0
11294,7923.0,BLUE BIRDHOUSE DECORATION,9,813,10,1100,287,1,20.0
11295,7924.0,WHITE HANGING HEART T-LIGHT HOLDER,3,1982,19,2000,18,1,38.0
11296,7925.0,REGENCY CAKESTAND 3 TIER,5,804,11,1200,396,1,22.0
11297,7926.0,ANTIQUE SILVER TEA GLASS ENGRAVED,4,845,10,1100,255,1,20.0
11298,7927.0,AGED GLASS SILVER T-LIGHT HOLDER,6,378,4,500,122,1,8.0
11299,7928.0,JAM MAKING SET WITH JARS,3,464,19,2000,1536,1,38.0
11300,7929.0,HAND WARMER OWL DESIGN,3,1219,18,1900,681,1,36.0
11301,7930.0,SET OF 2 WOODEN MARKET CRATES,1,875,12,1300,425,1,24.0
11302,7931.0,SET OF 6 T-LIGHTS TOADSTOOLS,7,1183,22,2300,1117,1,44.0
11303,7932.0,HAND WARMER UNION JACK,7,1242,12,1300,58,1,24.0
11304,7933.0,HAND WARMER SCOTTY DOG DESIGN,7,1062,25,2600,1538,1,50.0
11305,7934.0,CLASSIC FRENCH STYLE BASKET NATURAL,1,300,17,1800,1500,1,34.0
11306,7935.0,CRAZY DAISY HEART DECORATION,8,132,7,800,668,1,14.0
11307,7936.0,GIN + TONIC DIET METAL SIGN,9,220,13,1400,1180,1,26.0
11308,7937.0,IVORY GIANT GARDEN THERMOMETER,9,1354,17,1800,446,1,34.0
11309,7938.0,CARD HOLDER GINGHAM HEART,9,184,7,800,616,1,14.0
11310,7939.0,SMALL STRIPES CHOCOLATE GIFT BAG ,8,100,0,100,0,1,0.0
11311,7940.0,S/6 WOODEN SKITTLES IN COTTON BAG,3,373,12,1300,927,1,24.0
11312,7941.0,HAND WARMER RED RETROSPOT,10,1785,22,2300,515,1,44.0
11313,7942.0,HAND WARMER UNION JACK,10,1883,24,2500,617,1,48.0
11314,7943.0,FRENCH WC SIGN BLUE METAL,8,436,12,1300,864,1,24.0
11315,7944.0,PINK UNION JACK  LUGGAGE TAG,1,109,11,1200,1091,1,22.0
11316,7945.0,"TRAY, BREAKFAST IN BED",4,228,2,300,72,1,4.0
11317,7946.0,PIZZA PLATE IN BOX,9,154,3,400,246,1,6.0
11318,7947.0,HEART OF WICKER LARGE,4,100,0,100,0,1,0.0
11319,7948.0,PINK HEART DOTS HOT WATER BOTTLE,1,185,11,1200,1015,1,22.0
11320,7949.0,PLACE SETTING WHITE HEART,2,1170,19,2000,830,1,38.0
11321,7950.0,SET OF 4 NAPKIN CHARMS LEAVES   ,1,223,19,2000,1777,1,38.0
11322,7951.0,SET OF 4 NAPKIN CHARMS STARS   ,1,295,2,300,5,1,4.0
11323,7952.0,SET OF 4 NAPKIN CHARMS CUTLERY,3,499,8,900,401,1,16.0
11324,7953.0,CARAVAN SQUARE TISSUE BOX,3,903,14,1500,597,1,28.0
11325,7954.0,PLASTERS IN TIN SKULLS,9,100,0,100,0,1,0.0
11326,7955.0,PLASTERS IN TIN SPACEBOY,3,138,23,2400,2262,1,46.0
11327,7956.0,BUTTON BOX ,8,643,9,1000,357,1,18.0
11328,7957.0,PLASTERS IN TIN VINTAGE PAISLEY ,6,166,3,400,234,1,6.0
11329,7958.0,18 MESSAGE CARDS WITH ENVELOPES,10,1378,14,1500,122,1,28.0
11330,7959.0,SMALL RED BABUSHKA NOTEBOOK ,1,788,10,1100,312,1,20.0
11331,7960.0,CUPCAKE LACE PAPER SET 12,8,362,3,400,38,1,6.0
11332,7961.0,PACK 3 BOXES CHRISTMAS PANNETONE,9,371,5,600,229,1,10.0
11333,7962.0,HERB MARKER MINT,1,353,19,2000,1647,1,38.0
11334,7963.0,HERB MARKER ROSEMARY,5,379,3,400,21,1,6.0
11335,7964.0,HERB MARKER BASIL,5,475,8,900,425,1,16.0
11336,7965.0,HERB MARKER CHIVES ,8,121,5,600,479,1,10.0
11337,7966.0,HERB MARKER PARSLEY,5,226,7,800,574,1,14.0
11338,7967.0,HERB MARKER THYME,6,576,6,700,124,1,12.0
11339,7968.0,WHITE HANGING HEART T-LIGHT HOLDER,6,242,7,800,558,1,14.0
11340,7969.0,METAL MERRY CHRISTMAS WREATH,2,127,22,2300,2173,1,44.0
11341,7970.0,WHITE CHRISTMAS GARLAND STARS TREES,1,257,4,500,243,1,8.0
11342,7971.0,RETROSPOT SMALL TUBE MATCHES,1,368,17,1800,1432,1,34.0
11343,7972.0,RETROSPOT GIANT TUBE MATCHES,6,100,0,100,0,1,0.0
11344,7973.0,PLACE SETTING WHITE STAR,4,319,18,1900,1581,1,36.0
11345,7974.0,GROW YOUR OWN BASIL IN ENAMEL MUG,6,1495,15,1600,105,1,30.0
11346,7975.0,42 FOIL STAR CAKE CASES ,1,390,12,1300,910,1,24.0
11347,7976.0,42 FOIL HEART CAKE CASES,9,806,19,2000,1194,1,38.0
11348,7977.0,PACK OF 6 SWEETIE GIFT BOXES,3,266,3,400,134,1,6.0
11349,7978.0,PACK OF 6 HANDBAG GIFT BOXES,4,706,18,1900,1194,1,36.0
11350,7979.0,GARLAND WOODEN HAPPY EASTER,10,100,0,100,0,1,0.0
11351,7980.0,CALENDAR PAPER CUT DESIGN,9,276,6,700,424,1,12.0
11352,7981.0,CALENDAR IN SEASON DESIGN,6,838,14,1500,662,1,28.0
11353,7982.0,SMALL POPCORN HOLDER,2,205,10,1100,895,1,20.0
11354,7983.0,BLUE PAISLEY TISSUE BOX,2,619,13,1400,781,1,26.0
11355,7984.0,HEART OF WICKER SMALL,1,188,1,200,12,1,2.0
11356,7985.0,SKULLS SQUARE TISSUE BOX,8,260,2,300,40,1,4.0
11357,7986.0,SKULLS SQUARE TISSUE BOX,7,395,3,400,5,1,6.0
11358,7987.0,WHITE HANGING HEART T-LIGHT HOLDER,9,698,14,1500,802,1,28.0
11359,7988.0,WHITE METAL LANTERN,7,1470,18,1900,430,1,36.0
11360,7989.0,CREAM CUPID HEARTS COAT HANGER,6,294,6,700,406,1,12.0
11361,7990.0,KNITTED UNION FLAG HOT WATER BOTTLE,7,704,10,1100,396,1,20.0
11362,7991.0,RED WOOLLY HOTTIE WHITE HEART.,7,1995,25,2600,605,1,50.0
11363,7992.0,SET 7 BABUSHKA NESTING BOXES,6,810,22,2300,1490,1,44.0
11364,7993.0,GLASS STAR FROSTED T-LIGHT HOLDER,5,1211,19,2000,789,1,38.0
11365,7994.0,HAND WARMER UNION JACK,3,1165,12,1300,135,1,24.0
11366,7995.0,HAND WARMER RED POLKA DOT,3,597,18,1900,1303,1,36.0
11367,7996.0,ASSORTED COLOUR BIRD ORNAMENT,2,654,17,1800,1146,1,34.0
11368,7997.0,POPPY'S PLAYHOUSE BEDROOM ,6,262,2,300,38,1,4.0
11369,7998.0,POPPY'S PLAYHOUSE KITCHEN,7,139,9,1000,861,1,18.0
11370,7999.0,FELTCRAFT PRINCESS CHARLOTTE DOLL,5,190,1,200,10,1,2.0
11371,8000.0,IVORY KNITTED MUG COSY ,9,1586,24,2500,914,1,48.0
11372,8001.0,BOX OF 6 ASSORTED COLOUR TEASPOONS,2,762,9,1000,238,1,18.0
11373,8002.0,BOX OF VINTAGE JIGSAW BLOCKS ,8,2111,23,2400,289,1,46.0
11374,8003.0,BOX OF VINTAGE ALPHABET BLOCKS,4,974,20,2100,1126,1,40.0
11375,8004.0,HOME BUILDING BLOCK WORD,1,595,11,1200,605,1,22.0
11376,8005.0,LOVE BUILDING BLOCK WORD,6,584,25,2600,2016,1,50.0
11377,8006.0,RECIPE BOX WITH METAL HEART,5,261,12,1300,1039,1,24.0
11378,8007.0,DOORMAT NEW ENGLAND,8,255,2,300,45,1,4.0
11379,8008.0,JAM MAKING SET WITH JARS,9,170,7,800,630,1,14.0
11380,8009.0,RED COAT RACK PARIS FASHION,5,496,12,1300,804,1,24.0
11381,8010.0,YELLOW COAT RACK PARIS FASHION,5,739,23,2400,1661,1,46.0
11382,8011.0,BLUE COAT RACK PARIS FASHION,2,1121,12,1300,179,1,24.0
11383,8012.0,BATH BUILDING BLOCK WORD,6,1361,22,2300,939,1,44.0
11384,8013.0,ALARM CLOCK BAKELIKE PINK,5,431,6,700,269,1,12.0
11385,8014.0,ALARM CLOCK BAKELIKE RED ,2,1818,23,2400,582,1,46.0
11386,8015.0,ALARM CLOCK BAKELIKE GREEN,9,370,19,2000,1630,1,38.0
11387,8016.0,PANDA AND BUNNIES STICKER SHEET,6,249,25,2600,2351,1,50.0
11388,8017.0,STARS GIFT TAPE ,9,491,10,1100,609,1,20.0
11389,8018.0,INFLATABLE POLITICAL GLOBE ,1,217,3,400,183,1,6.0
11390,8019.0,VINTAGE HEADS AND TAILS CARD GAME ,4,427,10,1100,673,1,20.0
11391,8020.0,SET/2 RED RETROSPOT TEA TOWELS ,7,445,18,1900,1455,1,36.0
11392,8021.0,ROUND SNACK BOXES SET OF4 WOODLAND ,3,1423,22,2300,877,1,44.0
11393,8022.0,SPACEBOY LUNCH BOX ,3,814,18,1900,1086,1,36.0
11394,8023.0,LUNCH BOX I LOVE LONDON,6,220,3,400,180,1,6.0
11395,8024.0,CIRCUS PARADE LUNCH BOX ,10,1515,17,1800,285,1,34.0
11396,8025.0,CHARLOTTE BAG DOLLY GIRL DESIGN,5,1050,17,1800,750,1,34.0
11397,8026.0,RED TOADSTOOL LED NIGHT LIGHT,6,263,7,800,537,1,14.0
11398,8027.0, SET 2 TEA TOWELS I LOVE LONDON ,3,993,24,2500,1507,1,48.0
11399,8028.0,VINTAGE SEASIDE JIGSAW PUZZLES,5,316,8,900,584,1,16.0
11400,8029.0,MINI JIGSAW CIRCUS PARADE ,5,1496,20,2100,604,1,40.0
11401,8030.0,MINI JIGSAW SPACEBOY,4,609,6,700,91,1,12.0
11402,8031.0,MINI PAINT SET VINTAGE ,4,1140,24,2500,1360,1,48.0
11403,8032.0,POSTAGE,8,409,11,1200,791,1,22.0
11404,8033.0,PAPER CHAIN KIT 50'S CHRISTMAS ,1,552,9,1000,448,1,18.0
11405,8034.0,HAND WARMER RED POLKA DOT,1,365,8,900,535,1,16.0
11406,8035.0,HAND WARMER UNION JACK,8,468,16,1700,1232,1,32.0
11407,8036.0,WHITE HANGING HEART T-LIGHT HOLDER,3,494,13,1400,906,1,26.0
11408,8037.0,WHITE METAL LANTERN,2,653,18,1900,1247,1,36.0
11409,8038.0,CREAM CUPID HEARTS COAT HANGER,10,541,7,800,259,1,14.0
11410,8039.0,EDWARDIAN PARASOL RED,3,462,19,2000,1538,1,38.0
11411,8040.0,RETRO COFFEE MUGS ASSORTED,4,167,3,400,233,1,6.0
11412,8041.0,SAVE THE PLANET MUG,8,124,6,700,576,1,12.0
11413,8042.0,VINTAGE BILLBOARD DRINK ME MUG,2,307,3,400,93,1,6.0
11414,8043.0,VINTAGE BILLBOARD LOVE/HATE MUG,3,209,3,400,191,1,6.0
11415,8044.0,WOOD 2 DRAWER CABINET WHITE FINISH,1,246,3,400,154,1,6.0
11416,8045.0,WOOD S/3 CABINET ANT WHITE FINISH,4,2365,23,2400,35,1,46.0
11417,8046.0,WOODEN PICTURE FRAME WHITE FINISH,1,1203,23,2400,1197,1,46.0
11418,8047.0,WOODEN FRAME ANTIQUE WHITE ,6,255,3,400,145,1,6.0
11419,8048.0,KNITTED UNION FLAG HOT WATER BOTTLE,6,120,3,400,280,1,6.0
11420,8049.0,RED WOOLLY HOTTIE WHITE HEART.,8,868,23,2400,1532,1,46.0
11421,8050.0,SET 7 BABUSHKA NESTING BOXES,3,898,24,2500,1602,1,48.0
11422,8051.0,GLASS STAR FROSTED T-LIGHT HOLDER,1,1221,12,1300,79,1,24.0
11423,8052.0,VICTORIAN SEWING BOX LARGE,2,138,1,200,62,1,2.0
11424,8053.0,WHITE HANGING HEART T-LIGHT HOLDER,7,1555,18,1900,345,1,36.0
11425,8054.0,WHITE METAL LANTERN,2,254,14,1500,1246,1,28.0
11426,8055.0,CREAM CUPID HEARTS COAT HANGER,6,1441,19,2000,559,1,38.0
11427,8056.0,EDWARDIAN PARASOL RED,3,100,0,100,0,1,0.0
11428,8057.0,RETRO COFFEE MUGS ASSORTED,6,365,3,400,35,1,6.0
11429,8058.0,SAVE THE PLANET MUG,8,691,10,1100,409,1,20.0
11430,8059.0,VINTAGE BILLBOARD DRINK ME MUG,2,702,8,900,198,1,16.0
11431,8060.0,VINTAGE BILLBOARD LOVE/HATE MUG,5,117,2,300,183,1,4.0
11432,8061.0,WOOD 2 DRAWER CABINET WHITE FINISH,8,257,5,600,343,1,10.0
11433,8062.0,WOOD S/3 CABINET ANT WHITE FINISH,7,409,24,2500,2091,1,48.0
11434,8063.0,WOODEN PICTURE FRAME WHITE FINISH,3,172,3,400,228,1,6.0
11435,8064.0,WOODEN FRAME ANTIQUE WHITE ,9,917,11,1200,283,1,22.0
11436,8065.0,KNITTED UNION FLAG HOT WATER BOTTLE,2,632,23,2400,1768,1,46.0
11437,8066.0,RED WOOLLY HOTTIE WHITE HEART.,8,1108,14,1500,392,1,28.0
11438,8067.0,SET 7 BABUSHKA NESTING BOXES,7,172,4,500,328,1,8.0
11439,8068.0,GLASS STAR FROSTED T-LIGHT HOLDER,5,836,24,2500,1664,1,48.0
11440,8069.0,HOT WATER BOTTLE TEA AND SYMPATHY,1,172,4,500,328,1,8.0
11441,8070.0,RED HANGING HEART T-LIGHT HOLDER,8,611,6,700,89,1,12.0
11442,8071.0,HAND WARMER RED POLKA DOT,5,922,22,2300,1378,1,44.0
11443,8072.0,HAND WARMER UNION JACK,1,620,12,1300,680,1,24.0
11444,8073.0,JUMBO BAG PINK POLKADOT,2,1063,13,1400,337,1,26.0
11445,8074.0,JUMBO  BAG BAROQUE BLACK WHITE,3,1242,19,2000,758,1,38.0
11446,8075.0,JUMBO BAG CHARLIE AND LOLA TOYS,9,1141,13,1400,259,1,26.0
11447,8076.0,STRAWBERRY CHARLOTTE BAG,6,915,18,1900,985,1,36.0
11448,8077.0,RED 3 PIECE RETROSPOT CUTLERY SET,4,578,6,700,122,1,12.0
11449,8078.0,BLUE 3 PIECE POLKADOT CUTLERY SET,3,553,11,1200,647,1,22.0
11450,8079.0,SET/6 RED SPOTTY PAPER PLATES,2,199,5,600,401,1,10.0
11451,8080.0,LUNCH BAG RED RETROSPOT,1,265,9,1000,735,1,18.0
11452,8081.0,STRAWBERRY LUNCH BOX WITH CUTLERY,4,342,23,2400,2058,1,46.0
11453,8082.0,LUNCH BOX WITH CUTLERY RETROSPOT ,5,904,22,2300,1396,1,44.0
11454,8083.0,PACK OF 72 RETROSPOT CAKE CASES,6,142,1,200,58,1,2.0
11455,8084.0,PACK OF 60 DINOSAUR CAKE CASES,3,651,25,2600,1949,1,50.0
11456,8085.0,PACK OF 60 PINK PAISLEY CAKE CASES,9,590,23,2400,1810,1,46.0
11457,8086.0,67 TEATIME FAIRY CAKE CASES,9,100,0,100,0,1,0.0
11458,8087.0,TOMATO CHARLIE+LOLA COASTER SET,9,692,8,900,208,1,16.0
11459,8088.0,CHARLIE & LOLA WASTEPAPER BIN FLORA,9,398,14,1500,1102,1,28.0
11460,8089.0,RED CHARLIE+LOLA PERSONAL DOORSIGN,2,634,22,2300,1666,1,44.0
11461,8090.0,JUMBO STORAGE BAG SUKI,10,1062,19,2000,938,1,38.0
11462,8091.0,JUMBO BAG PINK VINTAGE PAISLEY,10,419,8,900,481,1,16.0
11463,8092.0,JAM MAKING SET PRINTED,6,127,7,800,673,1,14.0
11464,8093.0,RETROSPOT TEA SET CERAMIC 11 PC ,1,738,16,1700,962,1,32.0
11465,8094.0,GIRLY PINK TOOL SET,6,241,4,500,259,1,8.0
11466,8095.0,JUMBO SHOPPER VINTAGE RED PAISLEY,7,412,11,1200,788,1,22.0
11467,8096.0,"AIRLINE LOUNGE,METAL SIGN",7,885,16,1700,815,1,32.0
11468,8097.0,WHITE SPOT RED CERAMIC DRAWER KNOB,6,928,15,1600,672,1,30.0
11469,8098.0,RED DRAWER KNOB ACRYLIC EDWARDIAN,6,381,3,400,19,1,6.0
11470,8099.0,CLEAR DRAWER KNOB ACRYLIC EDWARDIAN,10,1598,15,1600,2,1,30.0
11471,8100.0,PHOTO CLIP LINE,4,1649,16,1700,51,1,32.0
11472,8101.0,FELT EGG COSY CHICKEN,6,1142,11,1200,58,1,22.0
11473,8102.0,PIGGY BANK RETROSPOT ,1,974,25,2600,1626,1,50.0
11474,8103.0,SKULL SHOULDER BAG,2,390,12,1300,910,1,24.0
11475,8104.0,YOU'RE CONFUSING ME METAL SIGN ,4,180,3,400,220,1,6.0
11476,8105.0,COOK WITH WINE METAL SIGN ,10,870,17,1800,930,1,34.0
11477,8106.0,GIN + TONIC DIET METAL SIGN,6,105,5,600,495,1,10.0
11478,8107.0,YELLOW BREAKFAST CUP AND SAUCER,6,526,12,1300,774,1,24.0
11479,8108.0,PINK BREAKFAST CUP AND SAUCER ,9,112,8,900,788,1,16.0
11480,8109.0,PAPER CHAIN KIT 50'S CHRISTMAS ,3,717,21,2200,1483,1,42.0
11481,8110.0,PAPER CHAIN KIT RETROSPOT,6,130,9,1000,870,1,18.0
11482,8111.0,SMALL HEART FLOWERS HOOK ,9,103,11,1200,1097,1,22.0
11483,8112.0,PHOTO CLIP LINE,4,1137,12,1300,163,1,24.0
11484,8113.0,TEA TIME DES TEA COSY,10,333,23,2400,2067,1,46.0
11485,8114.0,FELT EGG COSY WHITE RABBIT ,8,342,7,800,458,1,14.0
11486,8115.0,ZINC WILLIE WINKIE  CANDLE STICK,4,1631,21,2200,569,1,42.0
11487,8116.0,CERAMIC CHERRY CAKE MONEY BANK,10,111,1,200,89,1,2.0
11488,8117.0,RETROSPOT LARGE MILK JUG,4,758,7,800,42,1,14.0
11489,8118.0,SET OF 6 FUNKY BEAKERS,6,769,8,900,131,1,16.0
11490,8119.0,EDWARDIAN PARASOL BLACK,5,1367,15,1600,233,1,30.0
11491,8120.0,EDWARDIAN PARASOL NATURAL,1,337,8,900,563,1,16.0
11492,8121.0,CERAMIC STRAWBERRY CAKE MONEY BANK,9,896,21,2200,1304,1,42.0
11493,8122.0,BLUE OWL SOFT TOY,5,252,4,500,248,1,8.0
11494,8123.0,BALLOON ART MAKE YOUR OWN FLOWERS,9,1415,25,2600,1185,1,50.0
11495,8124.0,RED TOADSTOOL LED NIGHT LIGHT,2,941,13,1400,459,1,26.0
11496,8125.0,GLASS CLOCHE SMALL,4,1315,18,1900,585,1,36.0
11497,8126.0,GUMBALL MONOCHROME COAT RACK,3,377,11,1200,823,1,22.0
11498,8127.0,DOORMAT FANCY FONT HOME SWEET HOME,6,610,9,1000,390,1,18.0
11499,8128.0,Discount,5,972,12,1300,328,1,24.0
11500,8129.0,INFLATABLE POLITICAL GLOBE ,2,1957,22,2300,343,1,44.0
11501,8130.0,VINTAGE SNAKES & LADDERS,3,237,3,400,163,1,6.0
11502,8131.0,CHOCOLATE CALCULATOR,5,534,15,1600,1066,1,30.0
11503,8132.0,JUMBO SHOPPER VINTAGE RED PAISLEY,4,690,8,900,210,1,16.0
11504,8133.0,RECYCLING BAG RETROSPOT ,1,186,10,1100,914,1,20.0
11505,8134.0,TOY TIDY PINK POLKADOT,10,233,24,2500,2267,1,48.0
11506,8135.0,ANTIQUE GLASS DRESSING TABLE POT,4,256,2,300,44,1,4.0
11507,8136.0,ALARM CLOCK BAKELIKE GREEN,6,2217,22,2300,83,1,44.0
11508,8137.0,IVORY GIANT GARDEN THERMOMETER,2,174,3,400,226,1,6.0
11509,8138.0,10 TIER CAKE TIN GREEN AND CREAM,8,1927,24,2500,573,1,48.0
11510,8139.0,10 TIER CAKE TIN RED AND CREAM,7,1208,20,2100,892,1,40.0
11511,8140.0,SET 3 WICKER OVAL BASKETS W LIDS,9,371,10,1100,729,1,20.0
11512,8141.0,SET OF 3 COLOURED  FLYING DUCKS,7,856,25,2600,1744,1,50.0
11513,8142.0,WOOD BLACK BOARD ANT WHITE FINISH,5,927,11,1200,273,1,22.0
11514,8143.0,COLOUR GLASS T-LIGHT HOLDER HANGING,4,842,24,2500,1658,1,48.0
11515,8144.0,HANGING METAL HEART LANTERN,5,678,12,1300,622,1,24.0
11516,8145.0,HANGING MEDINA LANTERN SMALL,7,753,11,1200,447,1,22.0
11517,8146.0,NATURAL SLATE HEART CHALKBOARD ,4,111,10,1100,989,1,20.0
11518,8147.0,HEART OF WICKER SMALL,9,1596,22,2300,704,1,44.0
11519,8148.0,HEART OF WICKER LARGE,4,269,7,800,531,1,14.0
11520,8149.0,WHITE LOVEBIRD LANTERN,10,639,7,800,161,1,14.0
11521,8150.0,CLASSIC METAL BIRDCAGE PLANT HOLDER,8,525,11,1200,675,1,22.0
11522,8151.0,CREAM HEART CARD HOLDER,7,657,8,900,243,1,16.0
11523,8152.0,ENAMEL FLOWER JUG CREAM,7,924,23,2400,1476,1,46.0
11524,8153.0,ENAMEL FIRE BUCKET CREAM,1,1618,16,1700,82,1,32.0
11525,8154.0,ENAMEL BREAD BIN CREAM,4,2370,24,2500,130,1,48.0
11526,8155.0,SET 3 WICKER OVAL BASKETS W LIDS,1,535,5,600,65,1,10.0
11527,8156.0,JAM MAKING SET PRINTED,7,1236,13,1400,164,1,26.0
11528,8157.0,JAM MAKING SET WITH JARS,5,314,24,2500,2186,1,48.0
11529,8158.0,JUMBO BAG DOLLY GIRL DESIGN,9,304,13,1400,1096,1,26.0
11530,8159.0,TRADITIONAL CHRISTMAS RIBBONS,10,1008,17,1800,792,1,34.0
11531,8160.0,ORGANISER WOOD ANTIQUE WHITE ,7,693,8,900,207,1,16.0
11532,8161.0,LUNCH BAG DOLLY GIRL DESIGN,7,1261,25,2600,1339,1,50.0
11533,8162.0,WHITE WIRE EGG HOLDER,2,392,10,1100,708,1,20.0
11534,8163.0,JUMBO  BAG BAROQUE BLACK WHITE,4,439,20,2100,1661,1,40.0
11535,8164.0,JUMBO BAG RED RETROSPOT,10,267,5,600,333,1,10.0
11536,8165.0,CHILLI LIGHTS,5,534,10,1100,566,1,20.0
11537,8166.0,LIGHT GARLAND BUTTERFILES PINK,2,549,21,2200,1651,1,42.0
11538,8167.0,WOODEN OWLS LIGHT GARLAND ,7,659,21,2200,1541,1,42.0
11539,8168.0,FAIRY TALE COTTAGE NIGHTLIGHT,9,203,2,300,97,1,4.0
11540,8169.0,RED TOADSTOOL LED NIGHT LIGHT,7,392,4,500,108,1,8.0
11541,8170.0,HOME BUILDING BLOCK WORD,3,2258,23,2400,142,1,46.0
11542,8171.0,LOVE BUILDING BLOCK WORD,1,172,7,800,628,1,14.0
11543,8172.0,DOORMAT FANCY FONT HOME SWEET HOME,4,358,5,600,242,1,10.0
11544,8173.0,HOME SMALL WOOD LETTERS,3,1613,20,2100,487,1,40.0
11545,8174.0,GINGHAM HEART  DOORSTOP RED,4,468,6,700,232,1,12.0
11546,8175.0,FIVE HEART HANGING DECORATION,10,1098,21,2200,1102,1,42.0
11547,8176.0,HANGING METAL HEART LANTERN,9,207,4,500,293,1,8.0
11548,8177.0,ASSORTED BOTTLE TOP  MAGNETS ,10,388,14,1500,1112,1,28.0
11549,8178.0,FRIDGE MAGNETS US DINER ASSORTED,6,165,6,700,535,1,12.0
11550,8179.0,HOMEMADE JAM SCENTED CANDLES,5,550,19,2000,1450,1,38.0
11551,8180.0,FRIDGE MAGNETS LES ENFANTS ASSORTED,5,297,5,600,303,1,10.0
11552,8181.0,ROSE CARAVAN DOORSTOP,8,1116,17,1800,684,1,34.0
11553,8182.0,HEART OF WICKER SMALL,2,1085,10,1100,15,1,20.0
11554,8183.0,12 HOOK HANGER MAGIC TOADSTOOL,7,156,7,800,644,1,14.0
11555,8184.0,CHRISTMAS LIGHTS 10 REINDEER,8,1113,11,1200,87,1,22.0
11556,8185.0,VINTAGE UNION JACK CUSHION COVER,8,1148,15,1600,452,1,30.0
11557,8186.0,VINTAGE HEADS AND TAILS CARD GAME ,4,100,0,100,0,1,0.0
11558,8187.0,SET OF 3 COLOURED  FLYING DUCKS,3,783,25,2600,1817,1,50.0
11559,8188.0,SET OF 3 GOLD FLYING DUCKS,9,945,20,2100,1155,1,40.0
11560,8189.0,RED RETROSPOT UMBRELLA,7,1400,22,2300,900,1,44.0
11561,8190.0,BLACK/BLUE POLKADOT UMBRELLA,8,329,5,600,271,1,10.0
11562,8191.0,RED DINER WALL CLOCK,1,1163,23,2400,1237,1,46.0
11563,8192.0,ALARM CLOCK BAKELIKE GREEN,5,313,4,500,187,1,8.0
11564,8193.0,ALARM CLOCK BAKELIKE RED ,3,918,12,1300,382,1,24.0
11565,8194.0,BLUE DINER WALL CLOCK,1,187,1,200,13,1,2.0
11566,8195.0,IVORY DINER WALL CLOCK,6,1025,18,1900,875,1,36.0
11567,8196.0,LARGE HEART MEASURING SPOONS,3,387,10,1100,713,1,20.0
11568,8197.0,SMALL HEART MEASURING SPOONS,5,100,0,100,0,1,0.0
11569,8198.0,CHRISTMAS LIGHTS 10 REINDEER,4,157,3,400,243,1,6.0
11570,8199.0,JAM MAKING SET WITH JARS,6,376,14,1500,1124,1,28.0
11571,8200.0,JAM MAKING SET PRINTED,1,253,5,600,347,1,10.0
11572,8201.0,JAM JAR WITH PINK LID,3,373,4,500,127,1,8.0
11573,8202.0,JAM JAR WITH GREEN LID,2,189,13,1400,1211,1,26.0
11574,8203.0,ROSE COTTAGE KEEPSAKE BOX ,8,152,1,200,48,1,2.0
11575,8204.0,HANGING HEART ZINC T-LIGHT HOLDER,6,191,13,1400,1209,1,26.0
11576,8205.0,PAPER CHAIN KIT VINTAGE CHRISTMAS,6,1091,17,1800,709,1,34.0
11577,8206.0,DISCO BALL CHRISTMAS DECORATION,9,280,3,400,120,1,6.0
11578,8207.0,WHITE HANGING HEART T-LIGHT HOLDER,7,2118,23,2400,282,1,46.0
11579,8208.0,SMALL POPCORN HOLDER,8,319,9,1000,681,1,18.0
11580,8209.0,LARGE POPCORN HOLDER ,9,1819,23,2400,581,1,46.0
11581,8210.0,RETROSPOT LARGE MILK JUG,7,470,9,1000,530,1,18.0
11582,8211.0,SET/20 RED RETROSPOT PAPER NAPKINS ,4,2077,20,2100,23,1,40.0
11583,8212.0,SET/6 RED SPOTTY PAPER PLATES,7,1584,18,1900,316,1,36.0
11584,8213.0,SET/6 RED SPOTTY PAPER CUPS,9,953,17,1800,847,1,34.0
11585,8214.0,POLKADOT RAIN HAT ,7,1580,25,2600,1020,1,50.0
11586,8215.0,DELUXE SEWING KIT ,4,100,0,100,0,1,0.0
11587,8216.0,RETROSPOT HEART HOT WATER BOTTLE,6,1420,24,2500,1080,1,48.0
11588,8217.0,KNITTED UNION FLAG HOT WATER BOTTLE,2,1821,20,2100,279,1,40.0
11589,8218.0,ENGLISH ROSE HOT WATER BOTTLE,2,122,17,1800,1678,1,34.0
11590,8219.0,PHOTO CUBE,3,367,8,900,533,1,16.0
11591,8220.0,HOMEMADE JAM SCENTED CANDLES,4,463,13,1400,937,1,26.0
11592,8221.0,JUMBO BAG RED RETROSPOT,5,941,13,1400,459,1,26.0
11593,8222.0,PLASTERS IN TIN CIRCUS PARADE ,8,1044,17,1800,756,1,34.0
11594,8223.0,PACK OF 12 PINK PAISLEY TISSUES ,3,125,3,400,275,1,6.0
11595,8224.0,PACK OF 12 BLUE PAISLEY TISSUES ,2,1063,18,1900,837,1,36.0
11596,8225.0,PACK OF 12 RED RETROSPOT TISSUES ,6,1407,16,1700,293,1,32.0
11597,8226.0,CHICK GREY HOT WATER BOTTLE,9,634,24,2500,1866,1,48.0
11598,8227.0,PLASTERS IN TIN VINTAGE PAISLEY ,8,1083,18,1900,817,1,36.0
11599,8228.0,PLASTERS IN TIN SKULLS,8,704,12,1300,596,1,24.0
11600,8229.0,10 STRIPEY MICE FELTCRAFT,4,222,7,800,578,1,14.0
11601,8230.0,SET OF 6 SOLDIER SKITTLES,6,333,17,1800,1467,1,34.0
11602,8231.0,TRADITIONAL WOODEN SKIPPING ROPE,5,1697,21,2200,503,1,42.0
11603,8232.0,WOODEN BOX OF DOMINOES,7,200,21,2200,2000,1,42.0
11604,8233.0,RUSTIC  SEVENTEEN DRAWER SIDEBOARD,3,530,8,900,370,1,16.0
11605,8234.0,PARTY CONES CARNIVAL ASSORTED,7,732,23,2400,1668,1,46.0
11606,8235.0,PARTY CONES CANDY ASSORTED,3,371,16,1700,1329,1,32.0
11607,8236.0,PICNIC BASKET WICKER SMALL,3,285,2,300,15,1,4.0
11608,8237.0,ASSORTED COLOUR BIRD ORNAMENT,2,1157,24,2500,1343,1,48.0
11609,8238.0,STAR DECORATION PAINTED ZINC ,6,1671,20,2100,429,1,40.0
11610,8239.0,RETROSPOT LAMP,2,288,5,600,312,1,10.0
11611,8240.0,"FANCY FONT BIRTHDAY CARD, ",3,709,12,1300,591,1,24.0
11612,8241.0,HAND WARMER UNION JACK,4,583,6,700,117,1,12.0
11613,8242.0,HAND WARMER SCOTTY DOG DESIGN,5,766,16,1700,934,1,32.0
11614,8243.0,HAND WARMER OWL DESIGN,10,561,10,1100,539,1,20.0
11615,8244.0,HAND WARMER RED RETROSPOT,8,134,1,200,66,1,2.0
11616,8245.0,RETROSPOT HEART HOT WATER BOTTLE,5,1372,22,2300,928,1,44.0
11617,8246.0,DOG BOWL CHASING BALL DESIGN,4,596,14,1500,904,1,28.0
11618,8247.0,CLOTHES PEGS RETROSPOT PACK 31,4,153,15,1600,1447,1,30.0
11619,8248.0,HAND OVER THE CHOCOLATE   SIGN ,2,146,2,300,154,1,4.0
11620,8249.0,WHITE HANGING HEART T-LIGHT HOLDER,5,1226,21,2200,974,1,42.0
11621,8250.0,TRAVEL SEWING KIT,1,433,14,1500,1067,1,28.0
11622,8251.0,BLACK HEART CARD HOLDER,8,363,16,1700,1337,1,32.0
11623,8252.0,ASSORTED COLOUR BIRD ORNAMENT,5,202,6,700,498,1,12.0
11624,8253.0,PACK OF 60 PINK PAISLEY CAKE CASES,10,147,1,200,53,1,2.0
11625,8254.0,67 TEATIME FAIRY CAKE CASES,1,853,10,1100,247,1,20.0
11626,8255.0,PACK OF 72 RETROSPOT CAKE CASES,7,367,8,900,533,1,16.0
11627,8256.0,CHICK GREY HOT WATER BOTTLE,3,2031,21,2200,169,1,42.0
11628,8257.0,SMALL GLASS HEART TRINKET POT,4,513,7,800,287,1,14.0
11629,8258.0,ALARM CLOCK BAKELIKE IVORY,10,367,13,1400,1033,1,26.0
11630,8259.0,ALARM CLOCK BAKELIKE RED ,3,620,17,1800,1180,1,34.0
11631,8260.0,ALARM CLOCK BAKELIKE ORANGE,9,2434,25,2600,166,1,50.0
11632,8261.0,ALARM CLOCK BAKELIKE GREEN,9,151,14,1500,1349,1,28.0
11633,8262.0,HOT WATER BOTTLE TEA AND SYMPATHY,6,759,15,1600,841,1,30.0
11634,8263.0,HAND WARMER BIRD DESIGN,7,555,6,700,145,1,12.0
11635,8264.0,HAND WARMER SCOTTY DOG DESIGN,6,186,15,1600,1414,1,30.0
11636,8265.0,WHITE HANGING HEART T-LIGHT HOLDER,4,450,6,700,250,1,12.0
11637,8266.0,WHITE METAL LANTERN,3,1422,14,1500,78,1,28.0
11638,8267.0,CREAM CUPID HEARTS COAT HANGER,9,946,12,1300,354,1,24.0
11639,8268.0,EDWARDIAN PARASOL BLACK,9,451,10,1100,649,1,20.0
11640,8269.0,EDWARDIAN PARASOL RED,6,217,2,300,83,1,4.0
11641,8270.0,RETRO COFFEE MUGS ASSORTED,9,374,9,1000,626,1,18.0
11642,8271.0,SAVE THE PLANET MUG,3,772,22,2300,1528,1,44.0
11643,8272.0,VINTAGE BILLBOARD DRINK ME MUG,10,1337,24,2500,1163,1,48.0
11644,8273.0,VINTAGE BILLBOARD LOVE/HATE MUG,1,727,13,1400,673,1,26.0
11645,8274.0,WOOD 2 DRAWER CABINET WHITE FINISH,10,274,8,900,626,1,16.0
11646,8275.0,WOOD S/3 CABINET ANT WHITE FINISH,8,866,14,1500,634,1,28.0
11647,8276.0,WOODEN PICTURE FRAME WHITE FINISH,2,287,2,300,13,1,4.0
11648,8277.0,WOODEN FRAME ANTIQUE WHITE ,6,369,4,500,131,1,8.0
11649,8278.0,KNITTED UNION FLAG HOT WATER BOTTLE,6,1120,17,1800,680,1,34.0
11650,8279.0,RED WOOLLY HOTTIE WHITE HEART.,9,165,9,1000,835,1,18.0
11651,8280.0,SET 7 BABUSHKA NESTING BOXES,1,1228,15,1600,372,1,30.0
11652,8281.0,IVORY EMBROIDERED QUILT ,8,1523,18,1900,377,1,36.0
11653,8282.0,GLASS STAR FROSTED T-LIGHT HOLDER,8,100,4,500,400,1,8.0
11654,8283.0,SET OF 3 BLACK FLYING DUCKS,2,107,2,300,193,1,4.0
11655,8284.0,SET OF 3 COLOURED  FLYING DUCKS,5,100,0,100,0,1,0.0
11656,8285.0,PACK OF 12 RED RETROSPOT TISSUES ,4,176,3,400,224,1,6.0
11657,8286.0,RED RETROSPOT MUG,8,160,1,200,40,1,2.0
11658,8287.0,BABUSHKA LIGHTS STRING OF 17,6,840,10,1100,260,1,20.0
11659,8288.0,PIGGY BANK RETROSPOT ,3,107,1,200,93,1,2.0
11660,8289.0,SET 7 BABUSHKA NESTING BOXES,1,973,22,2300,1327,1,44.0
11661,8290.0,DOORMAT FAIRY CAKE,4,210,3,400,190,1,6.0
11662,8291.0,HAND WARMER RED RETROSPOT,4,365,4,500,135,1,8.0
11663,8292.0,HAND WARMER SCOTTY DOG DESIGN,9,1519,20,2100,581,1,40.0
11664,8293.0,HAND WARMER OWL DESIGN,1,1229,17,1800,571,1,34.0
11665,8294.0,STRAWBERRY CERAMIC TRINKET BOX,1,574,6,700,126,1,12.0
11666,8295.0,PINK DOUGHNUT TRINKET POT ,5,914,25,2600,1686,1,50.0
11667,8296.0,SILK PURSE BABUSHKA PINK,1,1594,15,1600,6,1,30.0
11668,8297.0,HOT WATER BOTTLE TEA AND SYMPATHY,1,284,17,1800,1516,1,34.0
11669,8298.0,HOT WATER BOTTLE I AM SO POORLY,9,236,6,700,464,1,12.0
11670,8299.0,CHOCOLATE HOT WATER BOTTLE,3,212,4,500,288,1,8.0
11671,8300.0,WHITE SKULL HOT WATER BOTTLE ,7,1498,21,2200,702,1,42.0
11672,8301.0,SCOTTIE DOG HOT WATER BOTTLE,8,227,2,300,73,1,4.0
11673,8302.0,HAND WARMER RED POLKA DOT,1,1147,11,1200,53,1,22.0
11674,8303.0,HAND WARMER UNION JACK,8,1352,24,2500,1148,1,48.0
11675,8304.0,HOMEMADE JAM SCENTED CANDLES,4,181,1,200,19,1,2.0
11676,8305.0,BIRD HOUSE HOT WATER BOTTLE,10,130,1,200,70,1,2.0
11677,8306.0,BOUDOIR SQUARE TISSUE BOX,1,671,24,2500,1829,1,48.0
11678,8307.0,SKULLS SQUARE TISSUE BOX,7,1566,15,1600,34,1,30.0
11679,8308.0,PHOTO FRAME CORNICE,6,416,16,1700,1284,1,32.0
11680,8309.0,SILK PURSE BABUSHKA RED,6,100,1,200,100,1,2.0
11681,8310.0,PICTURE DOMINOES,7,1504,16,1700,196,1,32.0
11682,8311.0,S/6 SEW ON CROCHET FLOWERS,2,2141,23,2400,259,1,46.0
11683,8312.0,SCANDINAVIAN REDS RIBBONS,3,2307,25,2600,293,1,50.0
11684,8313.0,BALLOONS  WRITING SET ,2,1600,15,1600,0,1,30.0
11685,8314.0,JAM MAKING SET PRINTED,6,1326,14,1500,174,1,28.0
11686,8315.0,LAVENDER INCENSE IN TIN,4,2336,24,2500,164,1,48.0
11687,8316.0,TV DINNER TRAY VINTAGE PAISLEY,2,1567,22,2300,733,1,44.0
11688,8317.0,SET OF 4 ENGLISH ROSE PLACEMATS,2,318,8,900,582,1,16.0
11689,8318.0,SET OF 4 ENGLISH ROSE COASTERS,4,124,4,500,376,1,8.0
11690,8319.0,TRIPLE PHOTO FRAME CORNICE ,1,1198,18,1900,702,1,36.0
11691,8320.0,FAMILY PHOTO FRAME CORNICE,3,886,16,1700,814,1,32.0
11692,8321.0,MIRRORED DISCO BALL ,9,953,13,1400,447,1,26.0
11693,8322.0,DISCO BALL ROTATOR BATTERY OPERATED,10,761,22,2300,1539,1,44.0
11694,8323.0,SILVER LOOKING MIRROR,1,1093,15,1600,507,1,30.0
11695,8324.0,LADIES & GENTLEMEN METAL SIGN,10,895,8,900,5,1,16.0
11696,8325.0,METAL SIGN HER DINNER IS SERVED ,3,100,0,100,0,1,0.0
11697,8326.0,YOU'RE CONFUSING ME METAL SIGN ,7,936,21,2200,1264,1,42.0
11698,8327.0,DOORMAT TOPIARY,10,292,12,1300,1008,1,24.0
11699,8328.0,BATHROOM METAL SIGN,2,2326,24,2500,174,1,48.0
11700,8329.0,KITCHEN METAL SIGN,1,1346,22,2300,954,1,44.0
11701,8330.0,TOILET METAL SIGN,10,1013,18,1900,887,1,36.0
11702,8331.0,METAL SIGN TAKE IT OR LEAVE IT ,7,340,13,1400,1060,1,26.0
11703,8332.0,I'M ON HOLIDAY METAL SIGN,9,2059,21,2200,141,1,42.0
11704,8333.0,GROW YOUR OWN BASIL IN ENAMEL MUG,9,329,6,700,371,1,12.0
11705,8334.0,SET/10 PINK POLKADOT PARTY CANDLES,1,821,20,2100,1279,1,40.0
11706,8335.0,SET 20 NAPKINS FAIRY CAKES DESIGN ,5,340,7,800,460,1,14.0
11707,8336.0,67 TEATIME FAIRY CAKE CASES,5,333,21,2200,1867,1,42.0
11708,8337.0,SET OF 6 T-LIGHTS SNOWMEN,7,468,12,1300,832,1,24.0
11709,8338.0,SET OF 6 T-LIGHTS SANTA,3,1535,21,2200,665,1,42.0
11710,8339.0,SET OF 9 HEART SHAPED BALLOONS,9,1306,16,1700,394,1,32.0
11711,8340.0,SANDWICH BATH SPONGE,3,250,9,1000,750,1,18.0
11712,8341.0,APPLE BATH SPONGE,1,100,0,100,0,1,0.0
11713,8342.0,STRAWBERRY BATH SPONGE ,6,936,14,1500,564,1,28.0
11714,8343.0,BLACK PIRATE TREASURE CHEST,2,1047,18,1900,853,1,36.0
11715,8344.0,STAR PORTABLE TABLE LIGHT ,6,100,0,100,0,1,0.0
11716,8345.0,SNOWFLAKE PORTABLE TABLE LIGHT ,4,622,14,1500,878,1,28.0
11717,8346.0,PINK OVAL JEWELLED MIRROR,2,264,11,1200,936,1,22.0
11718,8347.0,RETROSPOT CIGAR BOX MATCHES ,3,109,18,1900,1791,1,36.0
11719,8348.0,COSY HOUR GIANT TUBE MATCHES,4,238,8,900,662,1,16.0
11720,8349.0,JAZZ HEARTS PURSE NOTEBOOK,10,1314,25,2600,1286,1,50.0
11721,8350.0,LUNCH BAG DOLLY GIRL DESIGN,10,1086,23,2400,1314,1,46.0
11722,8351.0,WHITE HANGING HEART T-LIGHT HOLDER,9,198,1,200,2,1,2.0
11723,8352.0,CANDLEHOLDER PINK HANGING HEART,6,202,11,1200,998,1,22.0
11724,8353.0,WOOD 2 DRAWER CABINET WHITE FINISH,7,188,2,300,112,1,4.0
11725,8354.0,ASSORTED COLOUR MINI CASES,3,2065,21,2200,135,1,42.0
11726,8355.0,LUNCH BAG RED RETROSPOT,1,2438,24,2500,62,1,48.0
11727,8356.0,LUNCH BAG SPACEBOY DESIGN ,6,392,8,900,508,1,16.0
11728,8357.0,LUNCH BAG WOODLAND,2,874,12,1300,426,1,24.0
11729,8358.0,LUNCH BAG PINK POLKADOT,4,358,10,1100,742,1,20.0
11730,8359.0,GUMBALL COAT RACK,10,655,9,1000,345,1,18.0
11731,8360.0,BLUE NEW BAROQUE CANDLESTICK CANDLE,9,359,24,2500,2141,1,48.0
11732,8361.0,PINK NEW BAROQUECANDLESTICK CANDLE,10,2308,23,2400,92,1,46.0
11733,8362.0,FAIRY CAKE FLANNEL ASSORTED COLOUR,6,809,11,1200,391,1,22.0
11734,8363.0,BREAD BIN DINER STYLE PINK,9,1940,20,2100,160,1,40.0
11735,8364.0,JUMBO BAG CHARLIE AND LOLA TOYS,1,269,9,1000,731,1,18.0
11736,8365.0,TEA TIME TABLE CLOTH,3,996,9,1000,4,1,18.0
11737,8366.0,ENGLISH ROSE HOT WATER BOTTLE,3,190,23,2400,2210,1,46.0
11738,8367.0,ENAMEL FIRE BUCKET CREAM,2,428,16,1700,1272,1,32.0
11739,8368.0,PICNIC BASKET WICKER SMALL,6,302,9,1000,698,1,18.0
11740,8369.0,PAPER CHAIN KIT 50'S CHRISTMAS ,2,100,0,100,0,1,0.0
11741,8370.0,PAPER CHAIN KIT VINTAGE CHRISTMAS,2,1447,18,1900,453,1,36.0
11742,8371.0,HOT WATER BOTTLE BABUSHKA ,3,317,16,1700,1383,1,32.0
11743,8372.0,HAND WARMER BIRD DESIGN,9,961,14,1500,539,1,28.0
11744,8373.0,POSTAGE,4,1005,21,2200,1195,1,42.0
11745,8374.0,HEART IVORY TRELLIS SMALL,10,391,3,400,9,1,6.0
11746,8375.0,CLEAR DRAWER KNOB ACRYLIC EDWARDIAN,10,477,19,2000,1523,1,38.0
11747,8376.0,PINK DRAWER KNOB ACRYLIC EDWARDIAN,5,100,0,100,0,1,0.0
11748,8377.0,GREEN DRAWER KNOB ACRYLIC EDWARDIAN,8,1867,21,2200,333,1,42.0
11749,8378.0,BLUE DRAWER KNOB ACRYLIC EDWARDIAN,1,1237,12,1300,63,1,24.0
11750,8379.0,HEART OF WICKER SMALL,4,679,13,1400,721,1,26.0
11751,8380.0,SMALL POPCORN HOLDER,1,1782,18,1900,118,1,36.0
11752,8381.0,SET 6 FOOTBALL CELEBRATION CANDLES,3,1364,20,2100,736,1,40.0
11753,8382.0,SET OF 6 GIRLS CELEBRATION CANDLES,1,2100,23,2400,300,1,46.0
11754,8383.0,ROMANTIC PINKS RIBBONS ,7,100,0,100,0,1,0.0
11755,8384.0,BRIGHT BLUES RIBBONS ,10,1288,20,2100,812,1,40.0
11756,8385.0,SCANDINAVIAN REDS RIBBONS,9,104,6,700,596,1,12.0
11757,8386.0,CHOCOLATE BOX RIBBONS ,7,1137,20,2100,963,1,40.0
11758,8387.0,PARTY INVITES FOOTBALL,1,1315,15,1600,285,1,30.0
11759,8388.0,PARTY INVITES JAZZ HEARTS,7,620,11,1200,580,1,22.0
11760,8389.0,PARTY INVITES SPACEMAN,8,1168,19,2000,832,1,38.0
11761,8390.0,SET OF 3 BUTTERFLY COOKIE CUTTERS,5,380,7,800,420,1,14.0
11762,8391.0,SET OF 3 HEART COOKIE CUTTERS,3,506,10,1100,594,1,20.0
11763,8392.0,10 PIECE SPACEBOY COOKIE CUTTER SET,6,1635,16,1700,65,1,32.0
11764,8393.0,PACK OF 72 SKULL CAKE CASES,6,844,9,1000,156,1,18.0
11765,8394.0,PACK OF 60 SPACEBOY CAKE CASES,6,630,8,900,270,1,16.0
11766,8395.0,PACK OF 72 RETROSPOT CAKE CASES,1,1869,19,2000,131,1,38.0
11767,8396.0,79 SWEETHEART FAIRY CAKE CASES,5,907,17,1800,893,1,34.0
11768,8397.0,PACK OF 60 DINOSAUR CAKE CASES,1,238,12,1300,1062,1,24.0
11769,8398.0,LUNCH BAG SUKI  DESIGN ,7,225,3,400,175,1,6.0
11770,8399.0,LUNCH BAG CARS BLUE,1,262,25,2600,2338,1,50.0
11771,8400.0,LUNCH BAG  BLACK SKULL.,1,100,0,100,0,1,0.0
11772,8401.0,HEART IVORY TRELLIS LARGE,9,130,4,500,370,1,8.0
11773,8402.0,SET/5 RED RETROSPOT LID GLASS BOWLS,8,612,16,1700,1088,1,32.0
11774,8403.0,WHITE HANGING HEART T-LIGHT HOLDER,6,459,7,800,341,1,14.0
11775,8404.0,WHITE METAL LANTERN,10,1435,21,2200,765,1,42.0
11776,8405.0,CREAM CUPID HEARTS COAT HANGER,7,1356,23,2400,1044,1,46.0
11777,8406.0,EDWARDIAN PARASOL RED,4,2337,25,2600,263,1,50.0
11778,8407.0,RETRO COFFEE MUGS ASSORTED,7,793,10,1100,307,1,20.0
11779,8408.0,SAVE THE PLANET MUG,6,541,8,900,359,1,16.0
11780,8409.0,VINTAGE BILLBOARD DRINK ME MUG,6,513,11,1200,687,1,22.0
11781,8410.0,VINTAGE BILLBOARD LOVE/HATE MUG,5,1154,16,1700,546,1,32.0
11782,8411.0,WOOD 2 DRAWER CABINET WHITE FINISH,1,2322,25,2600,278,1,50.0
11783,8412.0,WOOD S/3 CABINET ANT WHITE FINISH,1,1461,16,1700,239,1,32.0
11784,8413.0,WOODEN PICTURE FRAME WHITE FINISH,3,232,9,1000,768,1,18.0
11785,8414.0,WOODEN FRAME ANTIQUE WHITE ,6,114,13,1400,1286,1,26.0
11786,8415.0,KNITTED UNION FLAG HOT WATER BOTTLE,5,102,12,1300,1198,1,24.0
11787,8416.0,RED WOOLLY HOTTIE WHITE HEART.,2,1668,18,1900,232,1,36.0
11788,8417.0,SET 7 BABUSHKA NESTING BOXES,10,881,8,900,19,1,16.0
11789,8418.0,IVORY EMBROIDERED QUILT ,2,222,6,700,478,1,12.0
11790,8419.0,GLASS STAR FROSTED T-LIGHT HOLDER,3,100,0,100,0,1,0.0
11791,8420.0,HAND WARMER RED POLKA DOT,8,834,10,1100,266,1,20.0
11792,8421.0,HAND WARMER UNION JACK,10,382,11,1200,818,1,22.0
11793,8422.0,MAGIC DRAWING SLATE DINOSAUR,6,1734,24,2500,766,1,48.0
11794,8423.0,MAGIC DRAWING SLATE BAKE A CAKE ,4,2381,24,2500,119,1,48.0
11795,8424.0,19 PENCILS TALL TUBE SKULLS,8,367,5,600,233,1,10.0
11796,8425.0,CHOCOLATE CALCULATOR,2,492,25,2600,2108,1,50.0
11797,8426.0,RED  HARMONICA IN BOX ,5,244,6,700,456,1,12.0
11798,8427.0,BLUE HARMONICA IN BOX ,3,231,6,700,469,1,12.0
11799,8428.0,SKULLS  WATER TRANSFER TATTOOS ,1,228,2,300,72,1,4.0
11800,8429.0,PACK 3 BOXES BIRD PANNETONE ,7,171,5,600,429,1,10.0
11801,8430.0,HOT WATER BOTTLE TEA AND SYMPATHY,3,977,9,1000,23,1,18.0
11802,8431.0,RED WOOLLY HOTTIE WHITE HEART.,5,749,16,1700,951,1,32.0
11803,8432.0,WHITE SKULL HOT WATER BOTTLE ,3,881,11,1200,319,1,22.0
11804,8433.0,10 PIECE SPACEBOY COOKIE CUTTER SET,10,774,7,800,26,1,14.0
11805,8434.0,SET OF 20 KIDS COOKIE CUTTERS,4,371,4,500,129,1,8.0
11806,8435.0,17 COLOUR SPACEBOY PEN,1,140,11,1200,1060,1,22.0
11807,8436.0,VICTORIAN GLASS HANGING T-LIGHT,5,2225,25,2600,375,1,50.0
11808,8437.0,SINGLE HEART ZINC T-LIGHT HOLDER,3,454,20,2100,1646,1,40.0
11809,8438.0,RED HANGING HEART T-LIGHT HOLDER,9,778,14,1500,722,1,28.0
11810,8439.0,HANGING METAL STAR LANTERN,7,761,13,1400,639,1,26.0
11811,8440.0,SILVER HANGING T-LIGHT HOLDER,4,220,5,600,380,1,10.0
11812,8441.0,DOORMAT RED RETROSPOT,5,788,7,800,12,1,14.0
11813,8442.0,DOORMAT HEARTS,6,100,0,100,0,1,0.0
11814,8443.0,NATURAL SLATE RECTANGLE CHALKBOARD,4,151,2,300,149,1,4.0
11815,8444.0,LOVEBIRD HANGING DECORATION WHITE ,10,1033,18,1900,867,1,36.0
11816,8445.0,ASSORTED COLOUR BIRD ORNAMENT,2,589,10,1100,511,1,20.0
11817,8446.0,HOME BUILDING BLOCK WORD,1,204,13,1400,1196,1,26.0
11818,8447.0,LOVE BUILDING BLOCK WORD,7,432,9,1000,568,1,18.0
11819,8448.0,PHOTO FRAME CORNICE,3,282,8,900,618,1,16.0
11820,8449.0,PENS ASSORTED FUNNY FACE,3,142,24,2500,2358,1,48.0
11821,8450.0,CARD CIRCUS PARADE,7,290,2,300,10,1,4.0
11822,8451.0,WRAP COWBOYS  ,4,1349,14,1500,151,1,28.0
11823,8452.0,AIRLINE BAG VINTAGE TOKYO 85,5,1159,14,1500,341,1,28.0
11824,8453.0,RED RETROSPOT UMBRELLA,10,444,4,500,56,1,8.0
11825,8454.0,BLACK/BLUE POLKADOT UMBRELLA,10,145,2,300,155,1,4.0
11826,8455.0,RED 3 PIECE RETROSPOT CUTLERY SET,10,194,6,700,506,1,12.0
11827,8456.0,PACK OF 72 RETROSPOT CAKE CASES,7,192,7,800,608,1,14.0
11828,8457.0,SET OF 72 RETROSPOT PAPER  DOILIES,2,728,10,1100,372,1,20.0
11829,8458.0,BLUE COAT RACK PARIS FASHION,10,1918,22,2300,382,1,44.0
11830,8459.0,PLASTERS IN TIN SKULLS,4,199,7,800,601,1,14.0
11831,8460.0,SLEEPING CAT ERASERS,9,153,2,300,147,1,4.0
11832,8461.0,CARD BIRTHDAY COWBOY,6,150,16,1700,1550,1,32.0
11833,8462.0,PACK 3 BOXES CHRISTMAS PANNETONE,3,445,13,1400,955,1,26.0
11834,8463.0,ROTATING SILVER ANGELS T-LIGHT HLDR,4,433,4,500,67,1,8.0
11835,8464.0,COSY HOUR GIANT TUBE MATCHES,3,713,25,2600,1887,1,50.0
11836,8465.0,RIBBON REEL MAKING SNOWMEN ,1,1736,24,2500,764,1,48.0
11837,8466.0,MINI PAINT SET VINTAGE ,10,1143,18,1900,757,1,36.0
11838,8467.0,11 TRADITIONAL SPINNING TOPS,4,259,24,2500,2241,1,48.0
11839,8468.0,SET OF 6 SOLDIER SKITTLES,4,600,23,2400,1800,1,46.0
11840,8469.0,BAG 500g SWIRLY MARBLES,10,582,8,900,318,1,16.0
11841,8470.0,12 STRAND GLASS NECKLACE CRYSTAL,1,654,25,2600,1946,1,50.0
11842,8471.0,WHITE SKULL HOT WATER BOTTLE ,9,923,15,1600,677,1,30.0
11843,8472.0,SCOTTIE DOG HOT WATER BOTTLE,5,143,23,2400,2257,1,46.0
11844,8473.0,SQUARECUSHION COVER PINK UNION FLAG,7,512,21,2200,1688,1,42.0
11845,8474.0,SPACEBOY CHILDRENS EGG CUP,9,1196,20,2100,904,1,40.0
11846,8475.0,CHILDREN'S SPACEBOY MUG,9,458,19,2000,1542,1,38.0
11847,8476.0,HAND WARMER SCOTTY DOG DESIGN,2,873,21,2200,1327,1,42.0
11848,8477.0,FELTCRAFT CUSHION OWL,7,2151,23,2400,249,1,46.0
11849,8478.0,BLACK CANDELABRA T-LIGHT HOLDER,3,100,0,100,0,1,0.0
11850,8479.0,TOY TIDY DOLLY GIRL DESIGN,6,632,19,2000,1368,1,38.0
11851,8480.0,SET 12 LAVENDER  BOTANICAL T-LIGHTS,8,2015,24,2500,485,1,48.0
11852,8481.0,UNION JACK FLAG LUGGAGE TAG,10,423,5,600,177,1,10.0
11853,8482.0,RED HEART LUGGAGE TAG,10,855,21,2200,1345,1,42.0
11854,8483.0,RED GLASS TASSLE BAG CHARM,6,217,13,1400,1183,1,26.0
11855,8484.0,CLEAR ACRYLIC FACETED BANGLE,5,731,17,1800,1069,1,34.0
11856,8485.0,12 STRAND GLASS NECKLACE CRYSTAL,6,389,8,900,511,1,16.0
11857,8486.0,DOORMAT UNION JACK GUNS AND ROSES,7,864,21,2200,1336,1,42.0
11858,8487.0,VANILLA SCENT CANDLE JEWELLED BOX,9,1461,21,2200,739,1,42.0
11859,8488.0,FULL ENGLISH BREAKFAST PLATE,1,1340,19,2000,660,1,38.0
11860,8489.0,BLACK CANDELABRA T-LIGHT HOLDER,9,1152,18,1900,748,1,36.0
11861,8490.0,MAGIC DRAWING SLATE CIRCUS PARADE  ,5,1309,17,1800,491,1,34.0
11862,8491.0,CHRISTMAS HANGING HEART WITH BELL,6,713,10,1100,387,1,20.0
11863,8492.0,CAKE STAND VICTORIAN FILIGREE MED,7,995,10,1100,105,1,20.0
11864,8493.0,PAISLEY PATTERN  STICKERS,4,936,9,1000,64,1,18.0
11865,8494.0,FLOWERS  STICKERS,6,342,14,1500,1158,1,28.0
11866,8495.0,PINK NEW BAROQUECANDLESTICK CANDLE,4,109,1,200,91,1,2.0
11867,8496.0,BLUE NEW BAROQUE CANDLESTICK CANDLE,2,461,10,1100,639,1,20.0
11868,8497.0,JUMBO STORAGE BAG SUKI,7,194,1,200,6,1,2.0
11869,8498.0,BLACK LOVE BIRD CANDLE,5,839,23,2400,1561,1,46.0
11870,8499.0,PARTY TIME PENCIL ERASERS,1,584,21,2200,1616,1,42.0
11871,8500.0,DISCO BALL CHRISTMAS DECORATION,8,693,21,2200,1507,1,42.0
11872,8501.0,PINK B'FLY C/COVER W BOBBLES,4,1087,25,2600,1513,1,50.0
11873,8502.0,PINK UNION JACK  LUGGAGE TAG,3,486,11,1200,714,1,22.0
11874,8503.0,13 RIBBONS ELEGANT CHRISTMAS ,1,1929,21,2200,271,1,42.0
11875,8504.0,UNION JACK FLAG LUGGAGE TAG,7,512,13,1400,888,1,26.0
11876,8505.0,AGED GLASS SILVER T-LIGHT HOLDER,6,2203,22,2300,97,1,44.0
11877,8506.0,BOOM BOX SPEAKER GIRLS,5,279,2,300,21,1,4.0
11878,8507.0,13 RIBBONS SHIMMERING PINKS ,4,1271,13,1400,129,1,26.0
11879,8508.0, SET 2 TEA TOWELS I LOVE LONDON ,3,1154,12,1300,146,1,24.0
11880,8509.0,JUMBO BAG OWLS,5,1688,23,2400,712,1,46.0
11881,8510.0,SANDWICH BATH SPONGE,2,330,7,800,470,1,14.0
11882,8511.0,OWL DOORSTOP,1,121,4,500,379,1,8.0
11883,8512.0,12 STRAND GLASS NECKLACE CRYSTAL,1,1289,14,1500,211,1,28.0
11884,8513.0,HAND WARMER UNION JACK,3,834,9,1000,166,1,18.0
11885,8514.0,HAND WARMER SCOTTY DOG DESIGN,10,1904,20,2100,196,1,40.0
11886,8515.0,LARGE POPCORN HOLDER ,3,1537,23,2400,863,1,46.0
11887,8516.0,PAINTED METAL STAR WITH HOLLY BELLS,2,159,6,700,541,1,12.0
11888,8517.0,PAINTED METAL HEART WITH HOLLY BELL,4,376,5,600,224,1,10.0
11889,8518.0,ANGEL DECORATION STARS ON DRESS,2,982,9,1000,18,1,18.0
11890,8519.0,SMALL POPCORN HOLDER,3,1062,19,2000,938,1,38.0
11891,8520.0,JUMBO BAG RED RETROSPOT,9,192,1,200,8,1,2.0
11892,8521.0,JUMBO BAG STRAWBERRY,4,2274,22,2300,26,1,44.0
11893,8522.0,STRAWBERRY SHOPPER BAG,9,1310,19,2000,690,1,38.0
11894,8523.0,STRAWBERRY CHARLOTTE BAG,7,866,8,900,34,1,16.0
11895,8524.0, SET 2 TEA TOWELS I LOVE LONDON ,2,116,3,400,284,1,6.0
11896,8525.0,PACK OF 12 RED RETROSPOT TISSUES ,4,310,6,700,390,1,12.0
11897,8526.0,SCOTTIE DOG HOT WATER BOTTLE,8,594,25,2600,2006,1,50.0
11898,8527.0,CHOCOLATE HOT WATER BOTTLE,1,1044,17,1800,756,1,34.0
11899,8528.0,LUNCH BAG CARS BLUE,10,348,3,400,52,1,6.0
11900,8529.0,LUNCH BAG SPACEBOY DESIGN ,9,219,8,900,681,1,16.0
11901,8530.0,ROUND SNACK BOXES SET OF4 WOODLAND ,4,100,0,100,0,1,0.0
11902,8531.0,LUNCH BAG DOLLY GIRL DESIGN,3,920,15,1600,680,1,30.0
11903,8532.0,LUNCH BAG SUKI  DESIGN ,6,1462,21,2200,738,1,42.0
11904,8533.0,LUNCH BAG  BLACK SKULL.,5,373,9,1000,627,1,18.0
11905,8534.0,ROUND SNACK BOXES SET OF 4 FRUITS ,4,852,10,1100,248,1,20.0
11906,8535.0,ROUND SNACK BOXES SET OF 4 SKULLS,2,1302,18,1900,598,1,36.0
11907,8536.0,DOLLY GIRL LUNCH BOX,9,926,11,1200,274,1,22.0
11908,8537.0,SPACEBOY LUNCH BOX ,5,218,3,400,182,1,6.0
11909,8538.0,GREEN POLKADOT PLATE ,3,880,8,900,20,1,16.0
11910,8539.0,BLUE POLKADOT PLATE ,5,2489,24,2500,11,1,48.0
11911,8540.0,RED RETROSPOT PLATE ,3,1185,24,2500,1315,1,48.0
11912,8541.0,PINK  POLKADOT PLATE ,4,2112,21,2200,88,1,42.0
11913,8542.0,ROUND SNACK BOXES SET OF 4 SKULLS,5,402,5,600,198,1,10.0
11914,8543.0,FELTCRAFT DOLL MOLLY,5,1114,19,2000,886,1,38.0
11915,8544.0,FELTCRAFT CHRISTMAS FAIRY,8,880,11,1200,320,1,22.0
11916,8545.0,TRAVEL SEWING KIT,2,150,2,300,150,1,4.0
11917,8546.0,SET OF 3 NOTEBOOKS IN PARCEL,1,102,12,1300,1198,1,24.0
11918,8547.0,RED RETROSPOT TAPE,1,888,25,2600,1712,1,50.0
11919,8548.0,COSY SLIPPER SHOES SMALL  RED ,1,1514,17,1800,286,1,34.0
11920,8549.0,13 RIBBONS RUSTIC CHARM,7,1670,24,2500,830,1,48.0
11921,8550.0,SCANDINAVIAN REDS RIBBONS,7,882,24,2500,1618,1,48.0
11922,8551.0,JAM MAKING SET PRINTED,10,889,11,1200,311,1,22.0
11923,8552.0,19 DAISY PEGS IN WOOD BOX,3,639,9,1000,361,1,18.0
11924,8553.0,HOT WATER BOTTLE BABUSHKA ,1,1176,15,1600,424,1,30.0
11925,8554.0,FELTCRAFT PRINCESS CHARLOTTE DOLL,8,585,9,1000,415,1,18.0
11926,8555.0,FELTCRAFT CHRISTMAS FAIRY,6,272,6,700,428,1,12.0
11927,8556.0,FELTCRAFT PRINCESS CHARLOTTE DOLL,10,1270,20,2100,830,1,40.0
11928,8557.0,13 RIBBONS RUSTIC CHARM,8,582,13,1400,818,1,26.0
11929,8558.0,COSY SLIPPER SHOES SMALL  RED ,6,113,6,700,587,1,12.0
11930,8559.0,SCANDINAVIAN REDS RIBBONS,2,1409,19,2000,591,1,38.0
11931,8560.0,12 HOOK HANGER RED MAGIC TOADSTOOL,3,1521,18,1900,379,1,36.0
11932,8561.0,CHRISTMAS CRAFT TREE TOP ANGEL,3,379,23,2400,2021,1,46.0
11933,8562.0,CHRISTMAS CRAFT LITTLE FRIENDS,3,261,4,500,239,1,8.0
11934,8563.0,12 HOOK HANGER RED MAGIC TOADSTOOL,1,372,24,2500,2128,1,48.0
11935,8564.0,13 RIBBONS RUSTIC CHARM,5,221,6,700,479,1,12.0
11936,8565.0,19 DAISY PEGS IN WOOD BOX,1,566,7,800,234,1,14.0
11937,8566.0,SET OF 3 NOTEBOOKS IN PARCEL,2,181,6,700,519,1,12.0
11938,8567.0,12 HOOK HANGER MAGIC TOADSTOOL,4,130,3,400,270,1,6.0
11939,8568.0,SCANDINAVIAN REDS RIBBONS,9,1163,14,1500,337,1,28.0
11940,8569.0,RED TOADSTOOL LED NIGHT LIGHT,5,1015,13,1400,385,1,26.0
11941,8570.0,12 HOOK HANGER RED MAGIC TOADSTOOL,3,661,11,1200,539,1,22.0
11942,8571.0,COSY SLIPPER SHOES SMALL GREEN,9,100,0,100,0,1,0.0
11943,8572.0,COSY SLIPPER SHOES SMALL  RED ,9,1887,19,2000,113,1,38.0
11944,8573.0,FELTCRAFT DOLL ROSIE,6,1453,25,2600,1147,1,50.0
11945,8574.0,FELTCRAFT DOLL MOLLY,2,325,9,1000,675,1,18.0
11946,8575.0,FELTCRAFT DOLL EMILY,10,513,18,1900,1387,1,36.0
11947,8576.0,FELTCRAFT PRINCESS CHARLOTTE DOLL,2,541,9,1000,459,1,18.0
11948,8577.0,FELTCRAFT PRINCESS OLIVIA DOLL,3,506,8,900,394,1,16.0
11949,8578.0,REX CASH+CARRY JUMBO SHOPPER,3,289,2,300,11,1,4.0
11950,8579.0,FELTCRAFT DOLL MOLLY,5,931,14,1500,569,1,28.0
11951,8580.0,FELTCRAFT CUSHION OWL,10,649,24,2500,1851,1,48.0
11952,8581.0,CHRISTMAS CRAFT TREE TOP ANGEL,8,175,9,1000,825,1,18.0
11953,8582.0,CHRISTMAS CRAFT LITTLE FRIENDS,5,100,0,100,0,1,0.0
11954,8583.0,FELTCRAFT CUSHION RABBIT,8,739,25,2600,1861,1,50.0
11955,8584.0,FELTCRAFT CUSHION BUTTERFLY,4,203,21,2200,1997,1,42.0
11956,8585.0,19 DAISY PEGS IN WOOD BOX,4,200,1,200,0,1,2.0
11957,8586.0,PAPER CHAIN KIT 50'S CHRISTMAS ,3,244,21,2200,1956,1,42.0
11958,8587.0,FELTCRAFT CUSHION BUTTERFLY,10,479,17,1800,1321,1,34.0
11959,8588.0,19 DAISY PEGS IN WOOD BOX,1,693,14,1500,807,1,28.0
11960,8589.0,ROSE COTTAGE KEEPSAKE BOX ,1,818,17,1800,982,1,34.0
11961,8590.0,TOTE BAG I LOVE LONDON,10,265,12,1300,1035,1,24.0
11962,8591.0,19 DAISY PEGS IN WOOD BOX,10,100,0,100,0,1,0.0
11963,8592.0,TOTE BAG I LOVE LONDON,9,1750,22,2300,550,1,44.0
11964,8593.0,FOLDING UMBRELLA PINKWHITE POLKADOT,1,399,4,500,101,1,8.0
11965,8594.0,FOLDING UMBRELLA CREAM POLKADOT,1,121,1,200,79,1,2.0
11966,8595.0,FOLDING UMBRELLA WHITE/RED POLKADOT,3,950,15,1600,650,1,30.0
11967,8596.0,SET 10 LIGHTS NIGHT OWL,9,163,5,600,437,1,10.0
11968,8597.0,SMALL POPCORN HOLDER,2,1278,16,1700,422,1,32.0
11969,8598.0, SET 2 TEA TOWELS I LOVE LONDON ,2,371,5,600,229,1,10.0
11970,8599.0,FOLDING UMBRELLA RED/WHITE POLKADOT,9,517,13,1400,883,1,26.0
11971,8600.0,BABUSHKA LIGHTS STRING OF 17,4,1858,25,2600,742,1,50.0
11972,8601.0,LUNCH BAG RED RETROSPOT,7,117,17,1800,1683,1,34.0
11973,8602.0,S/4 VALENTINE DECOUPAGE HEART BOX,4,381,19,2000,1619,1,38.0
11974,8603.0,FOLDING UMBRELLA CREAM POLKADOT,2,1589,18,1900,311,1,36.0
11975,8604.0, SET 2 TEA TOWELS I LOVE LONDON ,8,100,0,100,0,1,0.0
11976,8605.0,FOLDING UMBRELLA RED/WHITE POLKADOT,3,533,14,1500,967,1,28.0
11977,8606.0,SOLDIERS EGG CUP ,3,317,9,1000,683,1,18.0
11978,8607.0,S/4 VALENTINE DECOUPAGE HEART BOX,10,354,14,1500,1146,1,28.0
11979,8608.0,RED RETROSPOT MINI CASES,3,1685,21,2200,515,1,42.0
11980,8609.0,,10,445,22,2300,1855,1,44.0
11981,8610.0,67 CAKE CASES VINTAGE CHRISTMAS,10,597,25,2600,2003,1,50.0
11982,8611.0,PAPER CHAIN KIT VINTAGE CHRISTMAS,1,710,11,1200,490,1,22.0
11983,8612.0,RIBBON REEL CHRISTMAS SOCK BAUBLE,1,837,20,2100,1263,1,40.0
11984,8613.0,RIBBON REEL SNOWY VILLAGE,5,230,4,500,270,1,8.0
11985,8614.0,RIBBON REEL MAKING SNOWMEN ,1,130,10,1100,970,1,20.0
11986,8615.0,SET OF 20 VINTAGE CHRISTMAS NAPKINS,8,585,5,600,15,1,10.0
11987,8616.0,TURQUOISE CHRISTMAS TREE ,1,129,20,2100,1971,1,40.0
11988,8617.0,RED STAR CARD HOLDER,7,1460,22,2300,840,1,44.0
11989,8618.0,WICKER WREATH SMALL,2,1944,21,2200,256,1,42.0
11990,8619.0,HEART OF WICKER LARGE,2,205,9,1000,795,1,18.0
11991,8620.0,ADVENT CALENDAR GINGHAM SACK,10,135,24,2500,2365,1,48.0
11992,8621.0,HEART OF WICKER SMALL,10,1391,17,1800,409,1,34.0
11993,8622.0,FELTCRAFT BUTTERFLY HEARTS,10,654,13,1400,746,1,26.0
11994,8623.0,PARTY CONE CHRISTMAS DECORATION ,8,147,2,300,153,1,4.0
11995,8624.0,VINTAGE HEADS AND TAILS CARD GAME ,3,1663,16,1700,37,1,32.0
11996,8625.0,WICKER STAR ,9,1559,25,2600,1041,1,50.0
11997,8626.0,VINTAGE SNAP CARDS,7,167,3,400,233,1,6.0
11998,8627.0,FELTCRAFT 6 FLOWER FRIENDS,9,523,25,2600,2077,1,50.0
11999,8628.0, SET 2 TEA TOWELS I LOVE LONDON ,4,850,9,1000,150,1,18.0
12000,8629.0,JAM MAKING SET PRINTED,2,1908,24,2500,592,1,48.0
12001,8630.0,BIRD DECORATION RED RETROSPOT,5,262,7,800,538,1,14.0
12002,8631.0,CHRISTMAS GINGHAM TREE,9,1081,11,1200,119,1,22.0
12003,8632.0,CHRISTMAS GINGHAM STAR,7,1120,13,1400,280,1,26.0
12004,8633.0,CHRISTMAS GINGHAM HEART,4,670,10,1100,430,1,20.0
12005,8634.0,PACK OF 12 PINK POLKADOT TISSUES,9,237,17,1800,1563,1,34.0
12006,8635.0,FELTCRAFT PRINCESS LOLA DOLL,1,100,0,100,0,1,0.0
12007,8636.0,PACK OF 12 LONDON TISSUES ,3,126,18,1900,1774,1,36.0
12008,8637.0,PURPLE DRAWERKNOB ACRYLIC EDWARDIAN,4,658,6,700,42,1,12.0
12009,8638.0,CHILDREN'S APRON DOLLY GIRL ,10,191,1,200,9,1,2.0
12010,8639.0,CHILDRENS APRON SPACEBOY DESIGN,1,657,22,2300,1643,1,44.0
12011,8640.0,CHRISTMAS LIGHTS 10 SANTAS ,2,647,11,1200,553,1,22.0
12012,8641.0,CHRISTMAS LIGHTS 10 REINDEER,4,821,23,2400,1579,1,46.0
12013,8642.0,PAPER CHAIN KIT 50'S CHRISTMAS ,9,1275,13,1400,125,1,26.0
12014,8643.0,FELTCRAFT CHRISTMAS FAIRY,1,1017,10,1100,83,1,20.0
12015,8644.0,PACK OF 72 RETROSPOT CAKE CASES,2,1519,16,1700,181,1,32.0
12016,8645.0,PACK OF 60 MUSHROOM CAKE CASES,10,898,9,1000,102,1,18.0
12017,8646.0,67 CAKE CASES DOLLY GIRL DESIGN,1,1853,21,2200,347,1,42.0
12018,8647.0,PACK OF 60 PINK PAISLEY CAKE CASES,7,729,10,1100,371,1,20.0
12019,8648.0,HAND WARMER BABUSHKA DESIGN,6,1924,22,2300,376,1,44.0
12020,8649.0,HAND WARMER BIRD DESIGN,7,1897,19,2000,103,1,38.0
12021,8650.0,HAND WARMER OWL DESIGN,2,806,20,2100,1294,1,40.0
12022,8651.0,HAND WARMER RED RETROSPOT,7,1442,19,2000,558,1,38.0
12023,8652.0,SET 12 RETRO WHITE CHALK STICKS,6,1557,23,2400,843,1,46.0
12024,8653.0,FELTCRAFT HAIRBAND RED AND BLUE,3,1564,17,1800,236,1,34.0
12025,8654.0,FELTCRAFT HAIRBAND PINK AND PURPLE,6,715,23,2400,1685,1,46.0
12026,8655.0,FELTCRAFT HAIRBANDS PINK AND WHITE ,10,1335,20,2100,765,1,40.0
12027,8656.0,TV DINNER TRAY DOLLY GIRL,5,470,7,800,330,1,14.0
12028,8657.0,PLASTERS IN TIN VINTAGE PAISLEY ,8,196,13,1400,1204,1,26.0
12029,8658.0,PLASTERS IN TIN SPACEBOY,10,1679,18,1900,221,1,36.0
12030,8659.0,PLASTERS IN TIN WOODLAND ANIMALS,2,231,7,800,569,1,14.0
12031,8660.0,MAGIC DRAWING SLATE SPACEBOY ,9,2376,23,2400,24,1,46.0
12032,8661.0,MAGIC DRAWING SLATE CIRCUS PARADE  ,9,296,23,2400,2104,1,46.0
12033,8662.0,MAGIC DRAWING SLATE GO TO THE FAIR ,10,377,3,400,23,1,6.0
12034,8663.0,MAGIC DRAWING SLATE DOLLY GIRL ,7,492,24,2500,2008,1,48.0
12035,8664.0,CHARLIE + LOLA RED HOT WATER BOTTLE,8,453,15,1600,1147,1,30.0
12036,8665.0,HOT WATER BOTTLE BABUSHKA ,10,1601,24,2500,899,1,48.0
12037,8666.0,URBAN BLACK RIBBONS ,6,261,18,1900,1639,1,36.0
12038,8667.0,FELTCRAFT PRINCESS CHARLOTTE DOLL,7,491,8,900,409,1,16.0
12039,8668.0,SET OF 6 T-LIGHTS TOADSTOOLS,3,875,11,1200,325,1,22.0
12040,8669.0,ROTATING LEAVES T-LIGHT HOLDER,3,1632,16,1700,68,1,32.0
12041,8670.0,RED  HARMONICA IN BOX ,5,194,1,200,6,1,2.0
12042,8671.0,CUPCAKE LACE PAPER SET 13,9,372,10,1100,728,1,20.0
12043,8672.0,FAMILY PHOTO FRAME CORNICE,9,1771,20,2100,329,1,40.0
12044,8673.0,TRIPLE PHOTO FRAME CORNICE ,7,1690,16,1700,10,1,32.0
12045,8674.0,WOODEN FRAME ANTIQUE WHITE ,6,698,6,700,2,1,12.0
12046,8675.0,WOODEN BOX OF DOMINOES,5,1009,11,1200,191,1,22.0
12047,8676.0,TRADITIONAL WOODEN CATCH CUP GAME ,4,2188,23,2400,212,1,46.0
12048,8677.0,TRADITIONAL WOODEN SKIPPING ROPE,3,796,22,2300,1504,1,44.0
12049,8678.0,S/6 WOODEN SKITTLES IN COTTON BAG,3,279,11,1200,921,1,22.0
12050,8679.0,RED METAL BEACH SPADE ,8,1813,24,2500,687,1,48.0
12051,8680.0,BOYS VINTAGE TIN SEASIDE BUCKET,9,844,12,1300,456,1,24.0
12052,8681.0,GIRLS VINTAGE TIN SEASIDE BUCKET,4,358,3,400,42,1,6.0
12053,8682.0,GREY HEART HOT WATER BOTTLE,8,1101,24,2500,1399,1,48.0
12054,8683.0,SCOTTIE DOG HOT WATER BOTTLE,2,1819,22,2300,481,1,44.0
12055,8684.0,BIRD HOUSE HOT WATER BOTTLE,3,706,10,1100,394,1,20.0
12056,8685.0,KINGS CHOICE TEA CADDY ,9,216,4,500,284,1,8.0
12057,8686.0,KINGS CHOICE BISCUIT TIN,3,465,11,1200,735,1,22.0
12058,8687.0,METAL SIGN EMPIRE TEA,3,789,8,900,111,1,16.0
12059,8688.0,HOMEMADE JAM SCENTED CANDLES,1,427,14,1500,1073,1,28.0
12060,8689.0,SET OF 6 SOLDIER SKITTLES,9,566,7,800,234,1,14.0
12061,8690.0,FAWN BLUE HOT WATER BOTTLE,10,1196,12,1300,104,1,24.0
12062,8691.0,HAND WARMER RED RETROSPOT,5,397,6,700,303,1,12.0
12063,8692.0,HOT WATER BOTTLE BABUSHKA ,7,106,1,200,94,1,2.0
12064,8693.0,WHITE SKULL HOT WATER BOTTLE ,4,571,10,1100,529,1,20.0
12065,8694.0,RETROSPOT HEART HOT WATER BOTTLE,8,505,15,1600,1095,1,30.0
12066,8695.0,RED WOOLLY HOTTIE WHITE HEART.,9,280,23,2400,2120,1,46.0
12067,8696.0,SCOTTIE DOG HOT WATER BOTTLE,2,320,8,900,580,1,16.0
12068,8697.0,GREY HEART HOT WATER BOTTLE,8,118,16,1700,1582,1,32.0
12069,8698.0,HOT WATER BOTTLE BABUSHKA ,1,608,13,1400,792,1,26.0
12070,8699.0,PACK OF 6 BIRDY GIFT TAGS,3,2565,25,2600,35,1,50.0
12071,8700.0,CHILLI LIGHTS,4,414,5,600,186,1,10.0
12072,8701.0,PIGGY BANK RETROSPOT ,2,1155,24,2500,1345,1,48.0
12073,8702.0,CERAMIC STRAWBERRY MONEY BOX,8,244,4,500,256,1,8.0
12074,8703.0,CERAMIC STRAWBERRY CAKE MONEY BANK,4,1864,22,2300,436,1,44.0
12075,8704.0,CERAMIC CHERRY CAKE MONEY BANK,7,1104,25,2600,1496,1,50.0
12076,8705.0,CERAMIC HEART FAIRY CAKE MONEY BANK,9,165,2,300,135,1,4.0
12077,8706.0,CERAMIC PIRATE CHEST MONEY BANK,8,1399,23,2400,1001,1,46.0
12078,8707.0,DOORSTOP RETROSPOT HEART,6,171,4,500,329,1,8.0
12079,8708.0,GINGHAM HEART  DOORSTOP RED,8,1770,18,1900,130,1,36.0
12080,8709.0,RETROSPOT BABUSHKA DOORSTOP,6,1509,15,1600,91,1,30.0
12081,8710.0,SILK PURSE BABUSHKA RED,8,1710,23,2400,690,1,46.0
12082,8711.0,SILK PURSE BABUSHKA PINK,9,257,8,900,643,1,16.0
12083,8712.0,FAMILY PHOTO FRAME CORNICE,5,623,23,2400,1777,1,46.0
12084,8713.0,SWEETHEART WIRE WALL TIDY,8,1254,17,1800,546,1,34.0
12085,8714.0,JAM MAKING SET PRINTED,5,381,7,800,419,1,14.0
12086,8715.0,RED RETROSPOT OVEN GLOVE ,3,336,13,1400,1064,1,26.0
12087,8716.0,CREAM HEART CARD HOLDER,1,216,11,1200,984,1,22.0
12088,8717.0,NAMASTE SWAGAT INCENSE,8,118,1,200,82,1,2.0
12089,8718.0,CERAMIC STRAWBERRY DESIGN MUG,3,1072,23,2400,1328,1,46.0
12090,8719.0,BLACK HEART CARD HOLDER,10,1977,21,2200,223,1,42.0
12091,8720.0,CLASSICAL ROSE SMALL VASE,9,574,12,1300,726,1,24.0
12092,8721.0,HYACINTH BULB T-LIGHT CANDLES,6,494,16,1700,1206,1,32.0
12093,8722.0,CHRISTMAS CRAFT WHITE FAIRY ,7,281,17,1800,1519,1,34.0
12094,8723.0,CHRISTMAS CRAFT LITTLE FRIENDS,4,992,9,1000,8,1,18.0
12095,8724.0,COSY HOUR CIGAR BOX MATCHES ,6,324,14,1500,1176,1,28.0
12096,8725.0,RED TEA TOWEL CLASSIC DESIGN,1,1086,19,2000,914,1,38.0
12097,8726.0,HEART FILIGREE DOVE  SMALL,6,132,3,400,268,1,6.0
12098,8727.0,RETROSPOT CHILDRENS APRON,4,803,17,1800,997,1,34.0
12099,8728.0,COLOURING PENCILS BROWN TUBE,1,665,24,2500,1835,1,48.0
12100,8729.0,11 IVORY DINNER CANDLES SILVER FLOCK,4,145,2,300,155,1,4.0
12101,8730.0,HEART FILIGREE DOVE  SMALL,6,163,1,200,37,1,2.0
12102,8731.0,ZINC METAL HEART DECORATION,6,348,21,2200,1852,1,42.0
12103,8732.0,GREEN FERN NOTEBOOK,4,942,25,2600,1658,1,50.0
12104,8733.0,BLUE PAISLEY NOTEBOOK,2,420,25,2600,2180,1,50.0
12105,8734.0,CHRYSANTHEMUM NOTEBOOK,3,642,6,700,58,1,12.0
12106,8735.0,LARGE CHINESE STYLE SCISSOR,5,1788,18,1900,112,1,36.0
12107,8736.0,SMALL CHINESE STYLE SCISSOR,10,135,1,200,65,1,2.0
12108,8737.0,S/6 WOODEN SKITTLES IN COTTON BAG,4,1172,13,1400,228,1,26.0
12109,8738.0,TRADITIONAL WOODEN SKIPPING ROPE,10,895,18,1900,1005,1,36.0
12110,8739.0,SET OF 6 SOLDIER SKITTLES,3,214,2,300,86,1,4.0
12111,8740.0,11 TRADITIONAL SPINNING TOPS,2,100,0,100,0,1,0.0
12112,8741.0,ROTATING SILVER ANGELS T-LIGHT HLDR,6,434,20,2100,1666,1,40.0
12113,8742.0,BLACK LOVE BIRD CANDLE,8,241,2,300,59,1,4.0
12114,8743.0,RETROSPOT CHILDRENS APRON,10,1465,17,1800,335,1,34.0
12115,8744.0,HANGING GLASS ETCHED TEALIGHT,3,366,9,1000,634,1,18.0
12116,8745.0,HANGING GLASS ETCHED TEALIGHT,4,881,15,1600,719,1,30.0
12117,8746.0,BLUE NEW BAROQUE CANDLESTICK CANDLE,10,589,8,900,311,1,16.0
12118,8747.0,COOKING SET RETROSPOT,10,642,19,2000,1358,1,38.0
12119,8748.0,KINGS CHOICE GIANT TUBE MATCHES,5,393,14,1500,1107,1,28.0
12120,8749.0,COSY HOUR GIANT TUBE MATCHES,4,891,23,2400,1509,1,46.0
12121,8750.0,PLACE SETTING WHITE STAR,8,1036,10,1100,64,1,20.0
12122,8751.0,HYACINTH BULB T-LIGHT CANDLES,5,651,9,1000,349,1,18.0
12123,8752.0,S/15 SILVER GLASS BAUBLES IN BAG,3,724,7,800,76,1,14.0
12124,8753.0,FRENCH WC SIGN BLUE METAL,2,981,11,1200,219,1,22.0
12125,8754.0,KINGS CHOICE GIANT TUBE MATCHES,4,577,6,700,123,1,12.0
12126,8755.0,79 SWEETHEART FAIRY CAKE CASES,9,1633,16,1700,67,1,32.0
12127,8756.0,ASSORTED COLOUR BIRD ORNAMENT,7,100,0,100,0,1,0.0
12128,8757.0,FAIRY SOAP SOAP HOLDER,3,182,5,600,418,1,10.0
12129,8758.0,GREEN GIANT GARDEN THERMOMETER,9,352,7,800,448,1,14.0
12130,8759.0,IVORY GIANT GARDEN THERMOMETER,8,150,15,1600,1450,1,30.0
12131,8760.0,BLUE GIANT GARDEN THERMOMETER,8,258,7,800,542,1,14.0
12132,8761.0,PACK OF 60 PINK PAISLEY CAKE CASES,3,2473,24,2500,27,1,48.0
12133,8762.0,RETROSPOT HEART HOT WATER BOTTLE,7,100,0,100,0,1,0.0
12134,8763.0,CHICK GREY HOT WATER BOTTLE,4,100,0,100,0,1,0.0
12135,8764.0,VICTORIAN SEWING BOX SMALL ,1,321,22,2300,1979,1,44.0
12136,8765.0,VICTORIAN SEWING BOX MEDIUM,2,258,3,400,142,1,6.0
12137,8766.0,SET/10 RED POLKADOT PARTY CANDLES,4,1446,19,2000,554,1,38.0
12138,8767.0,WASHROOM METAL SIGN,8,239,2,300,61,1,4.0
12139,8768.0,BLACK SWEETHEART BRACELET,3,789,7,800,11,1,14.0
12140,8769.0,DIAMANTE HAIR GRIP PACK/2 BLACK DIA,7,305,17,1800,1495,1,34.0
12141,8770.0,BLACK DIAMANTE EXPANDABLE RING,7,176,12,1300,1124,1,24.0
12142,8771.0,DIAMANTE HAIR GRIP PACK/2 RUBY,9,2223,24,2500,277,1,48.0
12143,8772.0,DIAMANTE HAIR GRIP PACK/2 MONTANA,1,202,3,400,198,1,6.0
12144,8773.0,BLUE SWEETHEART BRACELET,4,100,0,100,0,1,0.0
12145,8774.0,PINK SWEETHEART BRACELET,6,505,23,2400,1895,1,46.0
12146,8775.0,PURPLE SWEETHEART BRACELET,2,855,15,1600,745,1,30.0
12147,8776.0,JUMBO BAG PINK POLKADOT,5,1460,25,2600,1140,1,50.0
12148,8777.0,JUMBO BAG RED RETROSPOT,2,801,24,2500,1699,1,48.0
12149,8778.0,ASSORTED COLOUR BIRD ORNAMENT,3,1169,13,1400,231,1,26.0
12150,8779.0,PAPER CHAIN KIT 50'S CHRISTMAS ,6,553,7,800,247,1,14.0
12151,8780.0,RIBBON REEL CHRISTMAS PRESENT ,7,394,6,700,306,1,12.0
12152,8781.0,FIRST AID TIN,3,212,2,300,88,1,4.0
12153,8782.0,MAKE YOUR OWN MONSOON CARD KIT,9,295,14,1500,1205,1,28.0
12154,8783.0,PACK OF 12 HEARTS DESIGN TISSUES ,6,630,8,900,270,1,16.0
12155,8784.0,PACK OF 12 RED RETROSPOT TISSUES ,3,132,4,500,368,1,8.0
12156,8785.0,SOLDIERS EGG CUP ,3,1607,21,2200,593,1,42.0
12157,8786.0,HEART IVORY TRELLIS SMALL,8,940,9,1000,60,1,18.0
12158,8787.0,HEART FILIGREE DOVE  SMALL,7,100,0,100,0,1,0.0
12159,8788.0,HEART FILIGREE DOVE LARGE,1,571,8,900,329,1,16.0
12160,8789.0,PACK 3 BOXES BIRD PANNETONE ,10,567,8,900,333,1,16.0
12161,8790.0,PACK 3 BOXES CHRISTMAS PANNETONE,8,1987,20,2100,113,1,40.0
12162,8791.0,SMALL POPCORN HOLDER,5,115,10,1100,985,1,20.0
12163,8792.0,PACK OF 60 PINK PAISLEY CAKE CASES,1,744,25,2600,1856,1,50.0
12164,8793.0,SET OF 6 SOLDIER SKITTLES,8,1868,18,1900,32,1,36.0
12165,8794.0,SWIRLY CIRCULAR RUBBERS IN BAG,9,717,22,2300,1583,1,44.0
12166,8795.0,VINTAGE PAISLEY STATIONERY SET,4,327,12,1300,973,1,24.0
12167,8796.0,PAPER CHAIN KIT VINTAGE CHRISTMAS,5,1908,23,2400,492,1,46.0
12168,8797.0,SET/10 BLUE POLKADOT PARTY CANDLES,1,100,0,100,0,1,0.0
12169,8798.0,RIBBON REEL SOCKS AND MITTENS,2,107,1,200,93,1,2.0
12170,8799.0,67 CAKE CASES VINTAGE CHRISTMAS,7,1909,19,2000,91,1,38.0
12171,8800.0,CHRISTMAS METAL TAGS ASSORTED ,6,539,23,2400,1861,1,46.0
12172,8801.0,CHRISTMAS TREE T-LIGHT HOLDER,6,798,22,2300,1502,1,44.0
12173,8802.0,STAR  T-LIGHT HOLDER ,3,454,7,800,346,1,14.0
12174,8803.0,HEART T-LIGHT HOLDER ,5,212,24,2500,2288,1,48.0
12175,8804.0,MINI FUNKY DESIGN TAPES,4,100,0,100,0,1,0.0
12176,8805.0,SET OF 6 T-LIGHTS SNOWMEN,10,396,16,1700,1304,1,32.0
12177,8806.0,STAR WOODEN CHRISTMAS DECORATION,4,1170,25,2600,1430,1,50.0
12178,8807.0,WOODEN HEART CHRISTMAS SCANDINAVIAN,9,239,7,800,561,1,14.0
12179,8808.0,CHRISTMAS RETROSPOT TREE WOOD,5,1372,16,1700,328,1,32.0
12180,8809.0,SET OF 6 T-LIGHTS SANTA,4,155,21,2200,2045,1,42.0
12181,8810.0,SET/9 CHRISTMAS T-LIGHTS SCENTED ,3,674,17,1800,1126,1,34.0
12182,8811.0,BLUE ROSE FABRIC MIRROR,5,416,18,1900,1484,1,36.0
12183,8812.0,THREE CANVAS LUGGAGE TAGS,1,806,17,1800,994,1,34.0
12184,8813.0,RETROSPOT PARTY BAG + STICKER SET,3,1271,16,1700,429,1,32.0
12185,8814.0,PLASTERS IN TIN VINTAGE PAISLEY ,8,1777,20,2100,323,1,40.0
12186,8815.0,RETROSPOT SMALL TUBE MATCHES,9,210,21,2200,1990,1,42.0
12187,8816.0,HAND WARMER SCOTTY DOG DESIGN,7,528,22,2300,1772,1,44.0
12188,8817.0,3D CHRISTMAS STAMPS STICKERS ,1,636,6,700,64,1,12.0
12189,8818.0,HAND WARMER SCOTTY DOG DESIGN,6,1117,24,2500,1383,1,48.0
12190,8819.0,HAND WARMER SCOTTY DOG DESIGN,3,735,25,2600,1865,1,50.0
12191,8820.0,CLOTHES PEGS RETROSPOT PACK 31,1,982,20,2100,1118,1,40.0
12192,8821.0,43 FOIL HEART CAKE CASES,3,457,12,1300,843,1,24.0
12193,8822.0,CHRISTMAS METAL TAGS ASSORTED ,6,1019,19,2000,981,1,38.0
12194,8823.0,PACK OF 6 SWEETIE GIFT BOXES,6,355,12,1300,945,1,24.0
12195,8824.0,PACK OF 72 RETROSPOT CAKE CASES,3,146,2,300,154,1,4.0
12196,8825.0,PACK OF 72 RETROSPOT CAKE CASES,8,123,1,200,77,1,2.0
12197,8826.0,PACK OF 6 BIRDY GIFT TAGS,2,960,9,1000,40,1,18.0
12198,8827.0,SET/10 RED POLKADOT PARTY CANDLES,10,100,0,100,0,1,0.0
12199,8828.0,SET/10 PINK POLKADOT PARTY CANDLES,5,658,6,700,42,1,12.0
12200,8829.0,SET OF 3 NOTEBOOKS IN PARCEL,10,1050,15,1600,550,1,30.0
12201,8830.0,STAR  T-LIGHT HOLDER ,4,200,1,200,0,1,2.0
12202,8831.0,CINAMMON SET OF 9 T-LIGHTS,10,198,17,1800,1602,1,34.0
12203,8832.0,ORANGE SCENTED SET/9 T-LIGHTS,1,204,5,600,396,1,10.0
12204,8833.0,RIBBON REEL STRIPES DESIGN ,4,519,20,2100,1581,1,40.0
12205,8834.0,SET OF 2 TINS JARDIN DE PROVENCE,1,185,20,2100,1915,1,40.0
12206,8835.0,MAKE YOUR OWN PLAYTIME CARD KIT,5,798,7,800,2,1,14.0
12207,8836.0,DINOSAURS  WRITING SET ,6,391,14,1500,1109,1,28.0
12208,8837.0,BALLOONS  WRITING SET ,2,1240,22,2300,1060,1,44.0
12209,8838.0,SKULLS WRITING SET ,6,512,5,600,88,1,10.0
12210,8839.0,VINTAGE PAISLEY STATIONERY SET,5,115,13,1400,1285,1,26.0
12211,8840.0,COSY SLIPPER SHOES SMALL  RED ,5,653,9,1000,347,1,18.0
12212,8841.0,DOORMAT BLACK FLOCK ,7,1491,16,1700,209,1,32.0
12213,8842.0,JUMBO  BAG BAROQUE BLACK WHITE,5,579,21,2200,1621,1,42.0
12214,8843.0,JAM MAKING SET WITH JARS,8,1061,20,2100,1039,1,40.0
12215,8844.0,ORANGE SCENTED SET/9 T-LIGHTS,2,870,10,1100,230,1,20.0
12216,8845.0,CINAMMON SET OF 9 T-LIGHTS,10,1143,20,2100,957,1,40.0
12217,8846.0,HAND WARMER SCOTTY DOG DESIGN,5,392,22,2300,1908,1,44.0
12218,8847.0,CHRISTMAS DECOUPAGE CANDLE,1,154,4,500,346,1,8.0
12219,8848.0,HEART T-LIGHT HOLDER ,2,1639,20,2100,461,1,40.0
12220,8849.0,GROW YOUR OWN BASIL IN ENAMEL MUG,9,321,12,1300,979,1,24.0
12221,8850.0,OFFICE MUG WARMER POLKADOT,7,528,13,1400,872,1,26.0
12222,8851.0,SMALL POPCORN HOLDER,2,1016,12,1300,284,1,24.0
12223,8852.0,JUMBO BAG DOLLY GIRL DESIGN,5,226,5,600,374,1,10.0
12224,8853.0,JAM MAKING SET WITH JARS,7,185,3,400,215,1,6.0
12225,8854.0,JAM MAKING SET PRINTED,1,573,7,800,227,1,14.0
12226,8855.0,SMALL GLASS HEART TRINKET POT,2,435,6,700,265,1,12.0
12227,8856.0,RED WOOLLY HOTTIE WHITE HEART.,9,895,10,1100,205,1,20.0
12228,8857.0,BLACK RECORD COVER FRAME,3,1034,12,1300,266,1,24.0
12229,8858.0,"RECORD FRAME 7"" SINGLE SIZE ",7,239,25,2600,2361,1,50.0
12230,8859.0,43 PENCILS TUBE RED RETROSPOT,5,2012,22,2300,288,1,44.0
12231,8860.0,43 PENCILS TUBE WOODLAND,1,1766,24,2500,734,1,48.0
12232,8861.0,SET OF 6 SOLDIER SKITTLES,6,379,15,1600,1221,1,30.0
12233,8862.0,ROCKING HORSE RED CHRISTMAS ,7,1264,12,1300,36,1,24.0
12234,8863.0,CHRISTMAS GINGHAM HEART,8,201,6,700,499,1,12.0
12235,8864.0,CHRISTMAS GINGHAM STAR,4,400,4,500,100,1,8.0
12236,8865.0,HAND WARMER UNION JACK,7,1343,15,1600,257,1,30.0
12237,8866.0,HAND WARMER RED RETROSPOT,5,2062,22,2300,238,1,44.0
12238,8867.0,REGENCY CAKESTAND 3 TIER,8,100,0,100,0,1,0.0
12239,8868.0,JUMBO SHOPPER VINTAGE RED PAISLEY,2,678,6,700,22,1,12.0
12240,8869.0,RIBBON REEL SNOWY VILLAGE,7,103,2,300,197,1,4.0
12241,8870.0,VINTAGE UNION JACK BUNTING,5,1048,10,1100,52,1,20.0
12242,8871.0,JAM MAKING SET WITH JARS,2,506,19,2000,1494,1,38.0
12243,8872.0,RIBBON REEL STRIPES DESIGN ,4,352,5,600,248,1,10.0
12244,8873.0,RETRO LONGBOARD IRONING BOARD COVER,4,432,7,800,368,1,14.0
12245,8874.0,3D DOG PICTURE PLAYING CARDS,3,1136,15,1600,464,1,30.0
12246,8875.0,RETROSPOT CIGAR BOX MATCHES ,5,676,17,1800,1124,1,34.0
12247,8876.0,SET/9 CHRISTMAS T-LIGHTS SCENTED ,9,296,15,1600,1304,1,30.0
12248,8877.0,ROTATING SILVER ANGELS T-LIGHT HLDR,3,545,5,600,55,1,10.0
12249,8878.0,ROTATING SILVER ANGELS T-LIGHT HLDR,1,2202,22,2300,98,1,44.0
12250,8879.0,SAVE THE PLANET COTTON TOTE BAG,1,100,0,100,0,1,0.0
12251,8880.0,SET OF 20 VINTAGE CHRISTMAS NAPKINS,6,167,2,300,133,1,4.0
12252,8881.0,PAPER BUNTING WHITE LACE,6,1882,22,2300,418,1,44.0
12253,8882.0,GENTLEMAN SHIRT REPAIR KIT ,6,857,17,1800,943,1,34.0
12254,8883.0,CARD I LOVE LONDON ,10,1373,21,2200,827,1,42.0
12255,8884.0,PAPER CHAIN KIT VINTAGE CHRISTMAS,6,464,8,900,436,1,16.0
12256,8885.0,MIRRORED WALL ART FOXY,9,1421,18,1900,479,1,36.0
12257,8886.0,MIRRORED WALL ART GENTS,2,1352,14,1500,148,1,28.0
12258,8887.0,AIRLINE BAG VINTAGE JET SET WHITE,4,1633,18,1900,267,1,36.0
12259,8888.0,JAM MAKING SET PRINTED,10,113,3,400,287,1,6.0
12260,8889.0,POTTING SHED SOW 'N' GROW SET,10,1718,17,1800,82,1,34.0
12261,8890.0,BABUSHKA LIGHTS STRING OF 17,5,1569,22,2300,731,1,44.0
12262,8891.0,REX CASH+CARRY JUMBO SHOPPER,10,127,2,300,173,1,4.0
12263,8892.0,AIRLINE BAG VINTAGE WORLD CHAMPION ,8,171,2,300,129,1,4.0
12264,8893.0,HAND WARMER BIRD DESIGN,10,2283,23,2400,117,1,46.0
12265,8894.0,CHRISTMAS CRAFT LITTLE FRIENDS,7,100,0,100,0,1,0.0
12266,8895.0,PINK HEARTS PAPER GARLAND,5,480,14,1500,1020,1,28.0
12267,8896.0,POTTING SHED SEED ENVELOPES,8,191,13,1400,1209,1,26.0
12268,8897.0,HI TEC ALPINE HAND WARMER,4,2113,23,2400,287,1,46.0
12269,8898.0,FELTCRAFT CHRISTMAS FAIRY,10,100,0,100,0,1,0.0
12270,8899.0,HI TEC ALPINE HAND WARMER,10,425,6,700,275,1,12.0
12271,8900.0,ROTATING SILVER ANGELS T-LIGHT HLDR,2,1191,12,1300,109,1,24.0
12272,8901.0,10 STRIPEY MICE FELTCRAFT,10,974,25,2600,1626,1,50.0
12273,8902.0,FELTCRAFT 6 FLOWER FRIENDS,3,1747,20,2100,353,1,40.0
12274,8903.0,CHRISTMAS CRAFT LITTLE FRIENDS,7,470,6,700,230,1,12.0
12275,8904.0,VINTAGE UNION JACK CUSHION COVER,9,592,6,700,108,1,12.0
12276,8905.0,POLYESTER FILLER PAD 45x45cm,2,185,9,1000,815,1,18.0
12277,8906.0,DOLLY GIRL LUNCH BOX,2,770,9,1000,230,1,18.0
12278,8907.0,PACK OF 12 LONDON TISSUES ,8,147,8,900,753,1,16.0
12279,8908.0,CARD DOLLY GIRL ,2,546,5,600,54,1,10.0
12280,8909.0,CARD BILLBOARD FONT,10,1511,18,1900,389,1,36.0
12281,8910.0,RAINY LADIES BIRTHDAY CARD,7,429,5,600,171,1,10.0
12282,8911.0,GREY HEART HOT WATER BOTTLE,10,1294,16,1700,406,1,32.0
12283,8912.0,RED WOOLLY HOTTIE WHITE HEART.,4,739,22,2300,1561,1,44.0
12284,8913.0,RED WHITE SCARF  HOT WATER BOTTLE,6,171,4,500,329,1,8.0
12285,8914.0, SET 2 TEA TOWELS I LOVE LONDON ,10,1321,20,2100,779,1,40.0
12286,8915.0,SET OF 2 TEA TOWELS APPLE AND PEARS,5,1403,18,1900,497,1,36.0
12287,8916.0,SET/2 RED RETROSPOT TEA TOWELS ,3,865,10,1100,235,1,20.0
12288,8917.0,LOVE BUILDING BLOCK WORD,7,843,18,1900,1057,1,36.0
12289,8918.0,HOME BUILDING BLOCK WORD,1,576,5,600,24,1,10.0
12290,8919.0,ASSORTED COLOUR BIRD ORNAMENT,1,100,0,100,0,1,0.0
12291,8920.0,LANTERN CREAM GAZEBO ,4,1153,13,1400,247,1,26.0
12292,8921.0,BLUE BIRDHOUSE DECORATION,5,100,0,100,0,1,0.0
12293,8922.0,WHITE HANGING HEART T-LIGHT HOLDER,5,277,3,400,123,1,6.0
12294,8923.0,REGENCY CAKESTAND 3 TIER,8,487,21,2200,1713,1,42.0
12295,8924.0,ANTIQUE SILVER TEA GLASS ENGRAVED,3,1293,12,1300,7,1,24.0
12296,8925.0,AGED GLASS SILVER T-LIGHT HOLDER,2,379,10,1100,721,1,20.0
12297,8926.0,JAM MAKING SET WITH JARS,6,505,5,600,95,1,10.0
12298,8927.0,HAND WARMER OWL DESIGN,5,243,18,1900,1657,1,36.0
12299,8928.0,SET OF 2 WOODEN MARKET CRATES,7,545,23,2400,1855,1,46.0
12300,8929.0,SET OF 6 T-LIGHTS TOADSTOOLS,3,354,6,700,346,1,12.0
12301,8930.0,HAND WARMER UNION JACK,10,1641,18,1900,259,1,36.0
12302,8931.0,HAND WARMER SCOTTY DOG DESIGN,9,1829,20,2100,271,1,40.0
12303,8932.0,CLASSIC FRENCH STYLE BASKET NATURAL,2,395,5,600,205,1,10.0
12304,8933.0,CRAZY DAISY HEART DECORATION,8,216,2,300,84,1,4.0
12305,8934.0,GIN + TONIC DIET METAL SIGN,1,159,3,400,241,1,6.0
12306,8935.0,IVORY GIANT GARDEN THERMOMETER,1,994,18,1900,906,1,36.0
12307,8936.0,CARD HOLDER GINGHAM HEART,8,1330,14,1500,170,1,28.0
12308,8937.0,SMALL STRIPES CHOCOLATE GIFT BAG ,7,1564,25,2600,1036,1,50.0
12309,8938.0,S/6 WOODEN SKITTLES IN COTTON BAG,4,1487,15,1600,113,1,30.0
12310,8939.0,HAND WARMER RED RETROSPOT,9,1598,20,2100,502,1,40.0
12311,8940.0,HAND WARMER UNION JACK,7,1173,16,1700,527,1,32.0
12312,8941.0,FRENCH WC SIGN BLUE METAL,1,326,8,900,574,1,16.0
12313,8942.0,PINK UNION JACK  LUGGAGE TAG,8,477,8,900,423,1,16.0
12314,8943.0,"TRAY, BREAKFAST IN BED",5,225,5,600,375,1,10.0
12315,8944.0,PIZZA PLATE IN BOX,7,1000,11,1200,200,1,22.0
12316,8945.0,HEART OF WICKER LARGE,2,262,9,1000,738,1,18.0
12317,8946.0,PINK HEART DOTS HOT WATER BOTTLE,10,267,5,600,333,1,10.0
12318,8947.0,PLACE SETTING WHITE HEART,8,760,9,1000,240,1,18.0
12319,8948.0,SET OF 4 NAPKIN CHARMS LEAVES   ,2,281,2,300,19,1,4.0
12320,8949.0,SET OF 4 NAPKIN CHARMS STARS   ,8,1318,23,2400,1082,1,46.0
12321,8950.0,SET OF 4 NAPKIN CHARMS CUTLERY,8,189,5,600,411,1,10.0
12322,8951.0,CARAVAN SQUARE TISSUE BOX,7,1210,20,2100,890,1,40.0
12323,8952.0,PLASTERS IN TIN SKULLS,7,264,3,400,136,1,6.0
12324,8953.0,PLASTERS IN TIN SPACEBOY,6,169,3,400,231,1,6.0
12325,8954.0,BUTTON BOX ,3,384,12,1300,916,1,24.0
12326,8955.0,PLASTERS IN TIN VINTAGE PAISLEY ,10,1791,17,1800,9,1,34.0
12327,8956.0,19 MESSAGE CARDS WITH ENVELOPES,1,225,2,300,75,1,4.0
12328,8957.0,SMALL RED BABUSHKA NOTEBOOK ,4,841,17,1800,959,1,34.0
12329,8958.0,CUPCAKE LACE PAPER SET 13,5,1859,21,2200,341,1,42.0
12330,8959.0,PACK 3 BOXES CHRISTMAS PANNETONE,4,159,1,200,41,1,2.0
12331,8960.0,HERB MARKER MINT,8,600,6,700,100,1,12.0
12332,8961.0,HERB MARKER ROSEMARY,3,139,1,200,61,1,2.0
12333,8962.0,HERB MARKER BASIL,9,1480,25,2600,1120,1,50.0
12334,8963.0,HERB MARKER CHIVES ,4,208,5,600,392,1,10.0
12335,8964.0,HERB MARKER PARSLEY,1,196,1,200,4,1,2.0
12336,8965.0,HERB MARKER THYME,1,1532,17,1800,268,1,34.0
12337,8966.0,WHITE HANGING HEART T-LIGHT HOLDER,5,173,3,400,227,1,6.0
12338,8967.0,METAL MERRY CHRISTMAS WREATH,9,399,17,1800,1401,1,34.0
12339,8968.0,WHITE CHRISTMAS GARLAND STARS TREES,5,1212,12,1300,88,1,24.0
12340,8969.0,RETROSPOT SMALL TUBE MATCHES,6,1482,21,2200,718,1,42.0
12341,8970.0,RETROSPOT GIANT TUBE MATCHES,8,448,13,1400,952,1,26.0
12342,8971.0,PLACE SETTING WHITE STAR,5,717,12,1300,583,1,24.0
12343,8972.0,GROW YOUR OWN BASIL IN ENAMEL MUG,3,1610,18,1900,290,1,36.0
12344,8973.0,43 FOIL STAR CAKE CASES ,10,440,20,2100,1660,1,40.0
12345,8974.0,43 FOIL HEART CAKE CASES,4,576,6,700,124,1,12.0
12346,8975.0,PACK OF 6 SWEETIE GIFT BOXES,1,372,6,700,328,1,12.0
12347,8976.0,PACK OF 6 HANDBAG GIFT BOXES,10,1367,14,1500,133,1,28.0
12348,8977.0,GARLAND WOODEN HAPPY EASTER,9,105,13,1400,1295,1,26.0
12349,8978.0,CALENDAR PAPER CUT DESIGN,4,241,5,600,359,1,10.0
12350,8979.0,CALENDAR IN SEASON DESIGN,3,2020,25,2600,580,1,50.0
12351,8980.0,SMALL POPCORN HOLDER,6,1044,21,2200,1156,1,42.0
12352,8981.0,BLUE PAISLEY TISSUE BOX,4,592,15,1600,1008,1,30.0
12353,8982.0,HEART OF WICKER SMALL,1,1825,18,1900,75,1,36.0
12354,8983.0,SKULLS SQUARE TISSUE BOX,2,356,4,500,144,1,8.0
12355,8984.0,SKULLS SQUARE TISSUE BOX,10,610,9,1000,390,1,18.0
12356,8985.0,WHITE HANGING HEART T-LIGHT HOLDER,5,302,5,600,298,1,10.0
12357,8986.0,WHITE METAL LANTERN,2,267,3,400,133,1,6.0
12358,8987.0,CREAM CUPID HEARTS COAT HANGER,8,426,11,1200,774,1,22.0
12359,8988.0,KNITTED UNION FLAG HOT WATER BOTTLE,9,1839,21,2200,361,1,42.0
12360,8989.0,RED WOOLLY HOTTIE WHITE HEART.,8,1286,24,2500,1214,1,48.0
12361,8990.0,SET 7 BABUSHKA NESTING BOXES,7,114,6,700,586,1,12.0
12362,8991.0,GLASS STAR FROSTED T-LIGHT HOLDER,2,1827,25,2600,773,1,50.0
12363,8992.0,HAND WARMER UNION JACK,4,1950,22,2300,350,1,44.0
12364,8993.0,HAND WARMER RED POLKA DOT,7,419,6,700,281,1,12.0
12365,8994.0,ASSORTED COLOUR BIRD ORNAMENT,1,235,2,300,65,1,4.0
12366,8995.0,POPPY'S PLAYHOUSE BEDROOM ,7,1515,22,2300,785,1,44.0
12367,8996.0,POPPY'S PLAYHOUSE KITCHEN,10,123,5,600,477,1,10.0
12368,8997.0,FELTCRAFT PRINCESS CHARLOTTE DOLL,6,1650,18,1900,250,1,36.0
12369,8998.0,IVORY KNITTED MUG COSY ,9,2494,24,2500,6,1,48.0
12370,8999.0,BOX OF 6 ASSORTED COLOUR TEASPOONS,8,454,17,1800,1346,1,34.0
12371,9000.0,BOX OF VINTAGE JIGSAW BLOCKS ,3,1147,20,2100,953,1,40.0
12372,9001.0,BOX OF VINTAGE ALPHABET BLOCKS,6,1653,24,2500,847,1,48.0
12373,9002.0,HOME BUILDING BLOCK WORD,2,1112,14,1500,388,1,28.0
12374,9003.0,LOVE BUILDING BLOCK WORD,10,233,13,1400,1167,1,26.0
12375,9004.0,RECIPE BOX WITH METAL HEART,4,554,5,600,46,1,10.0
12376,9005.0,DOORMAT NEW ENGLAND,10,264,14,1500,1236,1,28.0
12377,9006.0,JAM MAKING SET WITH JARS,8,116,6,700,584,1,12.0
12378,9007.0,RED COAT RACK PARIS FASHION,7,1291,14,1500,209,1,28.0
12379,9008.0,YELLOW COAT RACK PARIS FASHION,7,110,21,2200,2090,1,42.0
12380,9009.0,BLUE COAT RACK PARIS FASHION,3,392,10,1100,708,1,20.0
12381,9010.0,BATH BUILDING BLOCK WORD,10,162,5,600,438,1,10.0
12382,9011.0,ALARM CLOCK BAKELIKE PINK,6,609,9,1000,391,1,18.0
12383,9012.0,ALARM CLOCK BAKELIKE RED ,6,1581,19,2000,419,1,38.0
12384,9013.0,ALARM CLOCK BAKELIKE GREEN,3,357,3,400,43,1,6.0
12385,9014.0,PANDA AND BUNNIES STICKER SHEET,5,429,7,800,371,1,14.0
12386,9015.0,STARS GIFT TAPE ,5,159,24,2500,2341,1,48.0
12387,9016.0,INFLATABLE POLITICAL GLOBE ,1,1098,11,1200,102,1,22.0
12388,9017.0,VINTAGE HEADS AND TAILS CARD GAME ,6,888,21,2200,1312,1,42.0
12389,9018.0,SET/2 RED RETROSPOT TEA TOWELS ,7,208,3,400,192,1,6.0
12390,9019.0,ROUND SNACK BOXES SET OF4 WOODLAND ,2,715,15,1600,885,1,30.0
12391,9020.0,SPACEBOY LUNCH BOX ,3,106,1,200,94,1,2.0
12392,9021.0,LUNCH BOX I LOVE LONDON,1,136,1,200,64,1,2.0
12393,9022.0,CIRCUS PARADE LUNCH BOX ,7,1520,16,1700,180,1,32.0
12394,9023.0,CHARLOTTE BAG DOLLY GIRL DESIGN,2,678,6,700,22,1,12.0
12395,9024.0,RED TOADSTOOL LED NIGHT LIGHT,1,1134,14,1500,366,1,28.0
12396,9025.0, SET 2 TEA TOWELS I LOVE LONDON ,5,447,23,2400,1953,1,46.0
12397,9026.0,VINTAGE SEASIDE JIGSAW PUZZLES,4,209,7,800,591,1,14.0
12398,9027.0,MINI JIGSAW CIRCUS PARADE ,9,602,9,1000,398,1,18.0
12399,9028.0,MINI JIGSAW SPACEBOY,9,1968,24,2500,532,1,48.0
12400,9029.0,MINI PAINT SET VINTAGE ,2,833,12,1300,467,1,24.0
12401,9030.0,POSTAGE,3,100,0,100,0,1,0.0
12402,9031.0,PAPER CHAIN KIT 50'S CHRISTMAS ,7,297,3,400,103,1,6.0
12403,9032.0,HAND WARMER RED POLKA DOT,1,534,6,700,166,1,12.0
12404,9033.0,HAND WARMER UNION JACK,4,544,9,1000,456,1,18.0
12405,9034.0,WHITE HANGING HEART T-LIGHT HOLDER,7,394,19,2000,1606,1,38.0
12406,9035.0,WHITE METAL LANTERN,2,201,7,800,599,1,14.0
12407,9036.0,CREAM CUPID HEARTS COAT HANGER,1,135,8,900,765,1,16.0
12408,9037.0,EDWARDIAN PARASOL RED,10,416,12,1300,884,1,24.0
12409,9038.0,RETRO COFFEE MUGS ASSORTED,6,244,8,900,656,1,16.0
12410,9039.0,SAVE THE PLANET MUG,4,856,23,2400,1544,1,46.0
12411,9040.0,VINTAGE BILLBOARD DRINK ME MUG,7,100,0,100,0,1,0.0
12412,9041.0,VINTAGE BILLBOARD LOVE/HATE MUG,7,818,24,2500,1682,1,48.0
12413,9042.0,WOOD 2 DRAWER CABINET WHITE FINISH,10,784,10,1100,316,1,20.0
12414,9043.0,WOOD S/3 CABINET ANT WHITE FINISH,9,100,0,100,0,1,0.0
12415,9044.0,WOODEN PICTURE FRAME WHITE FINISH,5,619,15,1600,981,1,30.0
12416,9045.0,WOODEN FRAME ANTIQUE WHITE ,2,231,23,2400,2169,1,46.0
12417,9046.0,KNITTED UNION FLAG HOT WATER BOTTLE,3,129,3,400,271,1,6.0
12418,9047.0,RED WOOLLY HOTTIE WHITE HEART.,5,166,15,1600,1434,1,30.0
12419,9048.0,SET 7 BABUSHKA NESTING BOXES,2,1054,11,1200,146,1,22.0
12420,9049.0,GLASS STAR FROSTED T-LIGHT HOLDER,6,100,0,100,0,1,0.0
12421,9050.0,VICTORIAN SEWING BOX LARGE,7,1273,18,1900,627,1,36.0
12422,9051.0,WHITE HANGING HEART T-LIGHT HOLDER,9,100,0,100,0,1,0.0
12423,9052.0,WHITE METAL LANTERN,1,479,4,500,21,1,8.0
12424,9053.0,CREAM CUPID HEARTS COAT HANGER,5,1353,25,2600,1247,1,50.0
12425,9054.0,EDWARDIAN PARASOL RED,2,2258,22,2300,42,1,44.0
12426,9055.0,RETRO COFFEE MUGS ASSORTED,8,100,0,100,0,1,0.0
12427,9056.0,SAVE THE PLANET MUG,3,303,9,1000,697,1,18.0
12428,9057.0,VINTAGE BILLBOARD DRINK ME MUG,2,2178,21,2200,22,1,42.0
12429,9058.0,VINTAGE BILLBOARD LOVE/HATE MUG,4,646,21,2200,1554,1,42.0
12430,9059.0,WOOD 2 DRAWER CABINET WHITE FINISH,2,310,12,1300,990,1,24.0
12431,9060.0,WOOD S/3 CABINET ANT WHITE FINISH,8,1335,21,2200,865,1,42.0
12432,9061.0,WOODEN PICTURE FRAME WHITE FINISH,9,189,7,800,611,1,14.0
12433,9062.0,WOODEN FRAME ANTIQUE WHITE ,8,1492,20,2100,608,1,40.0
12434,9063.0,KNITTED UNION FLAG HOT WATER BOTTLE,5,708,7,800,92,1,14.0
12435,9064.0,RED WOOLLY HOTTIE WHITE HEART.,5,1318,13,1400,82,1,26.0
12436,9065.0,SET 7 BABUSHKA NESTING BOXES,7,2081,23,2400,319,1,46.0
12437,9066.0,GLASS STAR FROSTED T-LIGHT HOLDER,8,226,3,400,174,1,6.0
12438,9067.0,HOT WATER BOTTLE TEA AND SYMPATHY,9,668,16,1700,1032,1,32.0
12439,9068.0,RED HANGING HEART T-LIGHT HOLDER,10,611,6,700,89,1,12.0
12440,9069.0,HAND WARMER RED POLKA DOT,4,1069,23,2400,1331,1,46.0
12441,9070.0,HAND WARMER UNION JACK,10,841,12,1300,459,1,24.0
12442,9071.0,JUMBO BAG PINK POLKADOT,7,1561,20,2100,539,1,40.0
12443,9072.0,JUMBO  BAG BAROQUE BLACK WHITE,2,100,0,100,0,1,0.0
12444,9073.0,JUMBO BAG CHARLIE AND LOLA TOYS,8,1539,17,1800,261,1,34.0
12445,9074.0,STRAWBERRY CHARLOTTE BAG,2,136,5,600,464,1,10.0
12446,9075.0,RED 3 PIECE RETROSPOT CUTLERY SET,4,576,8,900,324,1,16.0
12447,9076.0,BLUE 3 PIECE POLKADOT CUTLERY SET,8,100,0,100,0,1,0.0
12448,9077.0,SET/6 RED SPOTTY PAPER PLATES,9,419,24,2500,2081,1,48.0
12449,9078.0,LUNCH BAG RED RETROSPOT,4,1101,22,2300,1199,1,44.0
12450,9079.0,STRAWBERRY LUNCH BOX WITH CUTLERY,1,222,13,1400,1178,1,26.0
12451,9080.0,LUNCH BOX WITH CUTLERY RETROSPOT ,10,802,19,2000,1198,1,38.0
12452,9081.0,PACK OF 72 RETROSPOT CAKE CASES,2,594,5,600,6,1,10.0
12453,9082.0,PACK OF 60 DINOSAUR CAKE CASES,4,1482,17,1800,318,1,34.0
12454,9083.0,PACK OF 60 PINK PAISLEY CAKE CASES,9,358,10,1100,742,1,20.0
12455,9084.0,68 TEATIME FAIRY CAKE CASES,8,1637,16,1700,63,1,32.0
12456,9085.0,TOMATO CHARLIE+LOLA COASTER SET,1,1020,17,1800,780,1,34.0
12457,9086.0,CHARLIE & LOLA WASTEPAPER BIN FLORA,5,122,1,200,78,1,2.0
12458,9087.0,RED CHARLIE+LOLA PERSONAL DOORSIGN,9,429,8,900,471,1,16.0
12459,9088.0,JUMBO STORAGE BAG SUKI,7,1259,19,2000,741,1,38.0
12460,9089.0,JUMBO BAG PINK VINTAGE PAISLEY,6,1250,17,1800,550,1,34.0
12461,9090.0,JAM MAKING SET PRINTED,1,987,21,2200,1213,1,42.0
12462,9091.0,RETROSPOT TEA SET CERAMIC 11 PC ,7,193,1,200,7,1,2.0
12463,9092.0,GIRLY PINK TOOL SET,3,461,18,1900,1439,1,36.0
12464,9093.0,JUMBO SHOPPER VINTAGE RED PAISLEY,9,817,14,1500,683,1,28.0
12465,9094.0,"AIRLINE LOUNGE,METAL SIGN",9,112,6,700,588,1,12.0
12466,9095.0,WHITE SPOT RED CERAMIC DRAWER KNOB,4,548,17,1800,1252,1,34.0
12467,9096.0,RED DRAWER KNOB ACRYLIC EDWARDIAN,10,539,8,900,361,1,16.0
12468,9097.0,CLEAR DRAWER KNOB ACRYLIC EDWARDIAN,9,217,2,300,83,1,4.0
12469,9098.0,PHOTO CLIP LINE,10,2072,21,2200,128,1,42.0
12470,9099.0,FELT EGG COSY CHICKEN,6,123,1,200,77,1,2.0
12471,9100.0,PIGGY BANK RETROSPOT ,4,1979,20,2100,121,1,40.0
12472,9101.0,SKULL SHOULDER BAG,2,1671,19,2000,329,1,38.0
12473,9102.0,YOU'RE CONFUSING ME METAL SIGN ,3,586,6,700,114,1,12.0
12474,9103.0,COOK WITH WINE METAL SIGN ,10,981,24,2500,1519,1,48.0
12475,9104.0,GIN + TONIC DIET METAL SIGN,10,942,21,2200,1258,1,42.0
12476,9105.0,YELLOW BREAKFAST CUP AND SAUCER,7,857,25,2600,1743,1,50.0
12477,9106.0,PINK BREAKFAST CUP AND SAUCER ,4,274,8,900,626,1,16.0
12478,9107.0,PAPER CHAIN KIT 50'S CHRISTMAS ,1,100,0,100,0,1,0.0
12479,9108.0,PAPER CHAIN KIT RETROSPOT,7,1435,23,2400,965,1,46.0
12480,9109.0,SMALL HEART FLOWERS HOOK ,6,1234,12,1300,66,1,24.0
12481,9110.0,PHOTO CLIP LINE,10,574,5,600,26,1,10.0
12482,9111.0,TEA TIME DES TEA COSY,1,1010,17,1800,790,1,34.0
12483,9112.0,FELT EGG COSY WHITE RABBIT ,5,2262,22,2300,38,1,44.0
12484,9113.0,ZINC WILLIE WINKIE  CANDLE STICK,3,310,10,1100,790,1,20.0
12485,9114.0,CERAMIC CHERRY CAKE MONEY BANK,10,784,13,1400,616,1,26.0
12486,9115.0,RETROSPOT LARGE MILK JUG,5,819,15,1600,781,1,30.0
12487,9116.0,SET OF 6 FUNKY BEAKERS,7,1028,11,1200,172,1,22.0
12488,9117.0,EDWARDIAN PARASOL BLACK,1,2259,25,2600,341,1,50.0
12489,9118.0,EDWARDIAN PARASOL NATURAL,6,123,1,200,77,1,2.0
12490,9119.0,CERAMIC STRAWBERRY CAKE MONEY BANK,1,183,2,300,117,1,4.0
12491,9120.0,BLUE OWL SOFT TOY,7,1332,13,1400,68,1,26.0
12492,9121.0,BALLOON ART MAKE YOUR OWN FLOWERS,9,167,5,600,433,1,10.0
12493,9122.0,RED TOADSTOOL LED NIGHT LIGHT,4,322,19,2000,1678,1,38.0
12494,9123.0,GLASS CLOCHE SMALL,2,293,11,1200,907,1,22.0
12495,9124.0,GUMBALL MONOCHROME COAT RACK,8,503,10,1100,597,1,20.0
12496,9125.0,DOORMAT FANCY FONT HOME SWEET HOME,10,240,3,400,160,1,6.0
12497,9126.0,Discount,8,112,3,400,288,1,6.0
12498,9127.0,INFLATABLE POLITICAL GLOBE ,7,1741,24,2500,759,1,48.0
12499,9128.0,VINTAGE SNAKES & LADDERS,7,235,25,2600,2365,1,50.0
12500,9129.0,CHOCOLATE CALCULATOR,7,467,4,500,33,1,8.0
12501,9130.0,JUMBO SHOPPER VINTAGE RED PAISLEY,4,1144,11,1200,56,1,22.0
12502,9131.0,RECYCLING BAG RETROSPOT ,5,136,1,200,64,1,2.0
12503,9132.0,TOY TIDY PINK POLKADOT,7,109,1,200,91,1,2.0
12504,9133.0,ANTIQUE GLASS DRESSING TABLE POT,9,463,20,2100,1637,1,40.0
12505,9134.0,ALARM CLOCK BAKELIKE GREEN,6,100,0,100,0,1,0.0
12506,9135.0,IVORY GIANT GARDEN THERMOMETER,5,576,18,1900,1324,1,36.0
12507,9136.0,11 TIER CAKE TIN GREEN AND CREAM,1,100,2,300,200,1,4.0
12508,9137.0,11 TIER CAKE TIN RED AND CREAM,6,905,20,2100,1195,1,40.0
12509,9138.0,SET 3 WICKER OVAL BASKETS W LIDS,2,613,25,2600,1987,1,50.0
12510,9139.0,SET OF 3 COLOURED  FLYING DUCKS,1,419,4,500,81,1,8.0
12511,9140.0,WOOD BLACK BOARD ANT WHITE FINISH,6,115,16,1700,1585,1,32.0
12512,9141.0,COLOUR GLASS T-LIGHT HOLDER HANGING,8,722,11,1200,478,1,22.0
12513,9142.0,HANGING METAL HEART LANTERN,10,217,16,1700,1483,1,32.0
12514,9143.0,HANGING MEDINA LANTERN SMALL,6,133,1,200,67,1,2.0
12515,9144.0,NATURAL SLATE HEART CHALKBOARD ,8,100,0,100,0,1,0.0
12516,9145.0,HEART OF WICKER SMALL,4,710,13,1400,690,1,26.0
12517,9146.0,HEART OF WICKER LARGE,8,225,2,300,75,1,4.0
12518,9147.0,WHITE LOVEBIRD LANTERN,4,322,18,1900,1578,1,36.0
12519,9148.0,CLASSIC METAL BIRDCAGE PLANT HOLDER,4,271,3,400,129,1,6.0
12520,9149.0,CREAM HEART CARD HOLDER,5,1592,25,2600,1008,1,50.0
12521,9150.0,ENAMEL FLOWER JUG CREAM,4,251,13,1400,1149,1,26.0
12522,9151.0,ENAMEL FIRE BUCKET CREAM,6,893,21,2200,1307,1,42.0
12523,9152.0,ENAMEL BREAD BIN CREAM,7,641,10,1100,459,1,20.0
12524,9153.0,SET 3 WICKER OVAL BASKETS W LIDS,2,770,7,800,30,1,14.0
12525,9154.0,JAM MAKING SET PRINTED,2,1653,21,2200,547,1,42.0
12526,9155.0,JAM MAKING SET WITH JARS,10,379,11,1200,821,1,22.0
12527,9156.0,JUMBO BAG DOLLY GIRL DESIGN,2,926,10,1100,174,1,20.0
12528,9157.0,TRADITIONAL CHRISTMAS RIBBONS,5,1633,16,1700,67,1,32.0
12529,9158.0,ORGANISER WOOD ANTIQUE WHITE ,10,116,1,200,84,1,2.0
12530,9159.0,LUNCH BAG DOLLY GIRL DESIGN,10,1915,22,2300,385,1,44.0
12531,9160.0,WHITE WIRE EGG HOLDER,7,521,9,1000,479,1,18.0
12532,9161.0,JUMBO  BAG BAROQUE BLACK WHITE,3,1205,15,1600,395,1,30.0
12533,9162.0,JUMBO BAG RED RETROSPOT,5,1925,23,2400,475,1,46.0
12534,9163.0,CHILLI LIGHTS,10,892,10,1100,208,1,20.0
12535,9164.0,LIGHT GARLAND BUTTERFILES PINK,2,1105,22,2300,1195,1,44.0
12536,9165.0,WOODEN OWLS LIGHT GARLAND ,6,275,10,1100,825,1,20.0
12537,9166.0,FAIRY TALE COTTAGE NIGHTLIGHT,7,632,7,800,168,1,14.0
12538,9167.0,RED TOADSTOOL LED NIGHT LIGHT,9,375,4,500,125,1,8.0
12539,9168.0,HOME BUILDING BLOCK WORD,2,1478,20,2100,622,1,40.0
12540,9169.0,LOVE BUILDING BLOCK WORD,6,231,11,1200,969,1,22.0
12541,9170.0,DOORMAT FANCY FONT HOME SWEET HOME,2,141,3,400,259,1,6.0
12542,9171.0,HOME SMALL WOOD LETTERS,4,903,11,1200,297,1,22.0
12543,9172.0,GINGHAM HEART  DOORSTOP RED,2,2459,24,2500,41,1,48.0
12544,9173.0,FIVE HEART HANGING DECORATION,2,2393,25,2600,207,1,50.0
12545,9174.0,HANGING METAL HEART LANTERN,1,452,9,1000,548,1,18.0
12546,9175.0,ASSORTED BOTTLE TOP  MAGNETS ,3,429,6,700,271,1,12.0
12547,9176.0,FRIDGE MAGNETS US DINER ASSORTED,10,828,9,1000,172,1,18.0
12548,9177.0,HOMEMADE JAM SCENTED CANDLES,5,143,2,300,157,1,4.0
12549,9178.0,FRIDGE MAGNETS LES ENFANTS ASSORTED,10,1046,13,1400,354,1,26.0
12550,9179.0,ROSE CARAVAN DOORSTOP,4,100,0,100,0,1,0.0
12551,9180.0,HEART OF WICKER SMALL,1,1608,18,1900,292,1,36.0
12552,9181.0,13 HOOK HANGER MAGIC TOADSTOOL,3,406,7,800,394,1,14.0
12553,9182.0,CHRISTMAS LIGHTS 10 REINDEER,10,283,3,400,117,1,6.0
12554,9183.0,VINTAGE UNION JACK CUSHION COVER,3,199,2,300,101,1,4.0
12555,9184.0,VINTAGE HEADS AND TAILS CARD GAME ,1,563,25,2600,2037,1,50.0
12556,9185.0,SET OF 3 COLOURED  FLYING DUCKS,1,2515,25,2600,85,1,50.0
12557,9186.0,SET OF 3 GOLD FLYING DUCKS,1,388,18,1900,1512,1,36.0
12558,9187.0,RED RETROSPOT UMBRELLA,4,232,10,1100,868,1,20.0
12559,9188.0,BLACK/BLUE POLKADOT UMBRELLA,8,1939,21,2200,261,1,42.0
12560,9189.0,RED DINER WALL CLOCK,3,110,21,2200,2090,1,42.0
12561,9190.0,ALARM CLOCK BAKELIKE GREEN,9,352,5,600,248,1,10.0
12562,9191.0,ALARM CLOCK BAKELIKE RED ,1,1460,14,1500,40,1,28.0
12563,9192.0,BLUE DINER WALL CLOCK,3,240,11,1200,960,1,22.0
12564,9193.0,IVORY DINER WALL CLOCK,2,1444,21,2200,756,1,42.0
12565,9194.0,LARGE HEART MEASURING SPOONS,2,132,1,200,68,1,2.0
12566,9195.0,SMALL HEART MEASURING SPOONS,7,636,21,2200,1564,1,42.0
12567,9196.0,CHRISTMAS LIGHTS 10 REINDEER,9,929,22,2300,1371,1,44.0
12568,9197.0,JAM MAKING SET WITH JARS,10,923,12,1300,377,1,24.0
12569,9198.0,JAM MAKING SET PRINTED,5,133,1,200,67,1,2.0
12570,9199.0,JAM JAR WITH PINK LID,5,974,20,2100,1126,1,40.0
12571,9200.0,JAM JAR WITH GREEN LID,4,559,9,1000,441,1,18.0
12572,9201.0,ROSE COTTAGE KEEPSAKE BOX ,3,154,3,400,246,1,6.0
12573,9202.0,HANGING HEART ZINC T-LIGHT HOLDER,4,1553,21,2200,647,1,42.0
12574,9203.0,PAPER CHAIN KIT VINTAGE CHRISTMAS,1,774,22,2300,1526,1,44.0
12575,9204.0,DISCO BALL CHRISTMAS DECORATION,4,296,19,2000,1704,1,38.0
12576,9205.0,WHITE HANGING HEART T-LIGHT HOLDER,3,256,22,2300,2044,1,44.0
12577,9206.0,SMALL POPCORN HOLDER,4,329,14,1500,1171,1,28.0
12578,9207.0,LARGE POPCORN HOLDER ,8,942,20,2100,1158,1,40.0
12579,9208.0,RETROSPOT LARGE MILK JUG,9,1791,24,2500,709,1,48.0
12580,9209.0,SET/20 RED RETROSPOT PAPER NAPKINS ,9,183,1,200,17,1,2.0
12581,9210.0,SET/6 RED SPOTTY PAPER PLATES,8,1175,19,2000,825,1,38.0
12582,9211.0,SET/6 RED SPOTTY PAPER CUPS,9,194,1,200,6,1,2.0
12583,9212.0,POLKADOT RAIN HAT ,5,128,11,1200,1072,1,22.0
12584,9213.0,DELUXE SEWING KIT ,4,1081,17,1800,719,1,34.0
12585,9214.0,RETROSPOT HEART HOT WATER BOTTLE,7,166,7,800,634,1,14.0
12586,9215.0,KNITTED UNION FLAG HOT WATER BOTTLE,8,243,5,600,357,1,10.0
12587,9216.0,ENGLISH ROSE HOT WATER BOTTLE,8,468,19,2000,1532,1,38.0
12588,9217.0,PHOTO CUBE,8,175,14,1500,1325,1,28.0
12589,9218.0,HOMEMADE JAM SCENTED CANDLES,9,174,4,500,326,1,8.0
12590,9219.0,JUMBO BAG RED RETROSPOT,10,505,18,1900,1395,1,36.0
12591,9220.0,PLASTERS IN TIN CIRCUS PARADE ,9,399,3,400,1,1,6.0
12592,9221.0,PACK OF 12 PINK PAISLEY TISSUES ,4,123,2,300,177,1,4.0
12593,9222.0,PACK OF 12 BLUE PAISLEY TISSUES ,5,1616,20,2100,484,1,40.0
12594,9223.0,PACK OF 12 RED RETROSPOT TISSUES ,7,414,7,800,386,1,14.0
12595,9224.0,CHICK GREY HOT WATER BOTTLE,10,1045,12,1300,255,1,24.0
12596,9225.0,PLASTERS IN TIN VINTAGE PAISLEY ,9,472,18,1900,1428,1,36.0
12597,9226.0,PLASTERS IN TIN SKULLS,5,112,11,1200,1088,1,22.0
12598,9227.0,11 STRIPEY MICE FELTCRAFT,2,287,20,2100,1813,1,40.0
12599,9228.0,SET OF 6 SOLDIER SKITTLES,9,1695,18,1900,205,1,36.0
12600,9229.0,TRADITIONAL WOODEN SKIPPING ROPE,3,566,13,1400,834,1,26.0
12601,9230.0,WOODEN BOX OF DOMINOES,9,1236,23,2400,1164,1,46.0
12602,9231.0,RUSTIC  SEVENTEEN DRAWER SIDEBOARD,4,357,9,1000,643,1,18.0
12603,9232.0,PARTY CONES CARNIVAL ASSORTED,2,2159,24,2500,341,1,48.0
12604,9233.0,PARTY CONES CANDY ASSORTED,10,1351,14,1500,149,1,28.0
12605,9234.0,PICNIC BASKET WICKER SMALL,8,141,3,400,259,1,6.0
12606,9235.0,ASSORTED COLOUR BIRD ORNAMENT,10,932,17,1800,868,1,34.0
12607,9236.0,STAR DECORATION PAINTED ZINC ,1,151,2,300,149,1,4.0
12608,9237.0,RETROSPOT LAMP,9,373,6,700,327,1,12.0
12609,9238.0,"FANCY FONT BIRTHDAY CARD, ",8,686,7,800,114,1,14.0
12610,9239.0,HAND WARMER UNION JACK,6,732,22,2300,1568,1,44.0
12611,9240.0,HAND WARMER SCOTTY DOG DESIGN,7,1333,23,2400,1067,1,46.0
12612,9241.0,HAND WARMER OWL DESIGN,5,183,1,200,17,1,2.0
12613,9242.0,HAND WARMER RED RETROSPOT,3,789,7,800,11,1,14.0
12614,9243.0,RETROSPOT HEART HOT WATER BOTTLE,8,1541,20,2100,559,1,40.0
12615,9244.0,DOG BOWL CHASING BALL DESIGN,4,1631,21,2200,569,1,42.0
12616,9245.0,CLOTHES PEGS RETROSPOT PACK 32,10,1283,19,2000,717,1,38.0
12617,9246.0,HAND OVER THE CHOCOLATE   SIGN ,7,503,22,2300,1797,1,44.0
12618,9247.0,WHITE HANGING HEART T-LIGHT HOLDER,2,1758,22,2300,542,1,44.0
12619,9248.0,TRAVEL SEWING KIT,3,424,13,1400,976,1,26.0
12620,9249.0,BLACK HEART CARD HOLDER,1,380,5,600,220,1,10.0
12621,9250.0,ASSORTED COLOUR BIRD ORNAMENT,3,237,12,1300,1063,1,24.0
12622,9251.0,PACK OF 60 PINK PAISLEY CAKE CASES,6,397,7,800,403,1,14.0
12623,9252.0,68 TEATIME FAIRY CAKE CASES,4,1527,18,1900,373,1,36.0
12624,9253.0,PACK OF 72 RETROSPOT CAKE CASES,9,608,17,1800,1192,1,34.0
12625,9254.0,CHICK GREY HOT WATER BOTTLE,3,140,7,800,660,1,14.0
12626,9255.0,SMALL GLASS HEART TRINKET POT,2,382,3,400,18,1,6.0
12627,9256.0,ALARM CLOCK BAKELIKE IVORY,9,843,21,2200,1357,1,42.0
12628,9257.0,ALARM CLOCK BAKELIKE RED ,1,1563,15,1600,37,1,30.0
12629,9258.0,ALARM CLOCK BAKELIKE ORANGE,10,117,2,300,183,1,4.0
12630,9259.0,ALARM CLOCK BAKELIKE GREEN,1,1038,17,1800,762,1,34.0
12631,9260.0,HOT WATER BOTTLE TEA AND SYMPATHY,2,104,1,200,96,1,2.0
12632,9261.0,HAND WARMER BIRD DESIGN,3,151,2,300,149,1,4.0
12633,9262.0,HAND WARMER SCOTTY DOG DESIGN,5,1185,21,2200,1015,1,42.0
12634,9263.0,WHITE HANGING HEART T-LIGHT HOLDER,10,163,1,200,37,1,2.0
12635,9264.0,WHITE METAL LANTERN,1,733,13,1400,667,1,26.0
12636,9265.0,CREAM CUPID HEARTS COAT HANGER,6,197,4,500,303,1,8.0
12637,9266.0,EDWARDIAN PARASOL BLACK,6,743,9,1000,257,1,18.0
12638,9267.0,EDWARDIAN PARASOL RED,9,1011,19,2000,989,1,38.0
12639,9268.0,RETRO COFFEE MUGS ASSORTED,2,145,1,200,55,1,2.0
12640,9269.0,SAVE THE PLANET MUG,10,210,2,300,90,1,4.0
12641,9270.0,VINTAGE BILLBOARD DRINK ME MUG,1,248,5,600,352,1,10.0
12642,9271.0,VINTAGE BILLBOARD LOVE/HATE MUG,7,1299,17,1800,501,1,34.0
12643,9272.0,WOOD 2 DRAWER CABINET WHITE FINISH,1,324,17,1800,1476,1,34.0
12644,9273.0,WOOD S/3 CABINET ANT WHITE FINISH,3,287,6,700,413,1,12.0
12645,9274.0,WOODEN PICTURE FRAME WHITE FINISH,4,464,10,1100,636,1,20.0
12646,9275.0,WOODEN FRAME ANTIQUE WHITE ,5,132,22,2300,2168,1,44.0
12647,9276.0,KNITTED UNION FLAG HOT WATER BOTTLE,10,1287,21,2200,913,1,42.0
12648,9277.0,RED WOOLLY HOTTIE WHITE HEART.,3,133,2,300,167,1,4.0
12649,9278.0,SET 7 BABUSHKA NESTING BOXES,5,100,0,100,0,1,0.0
12650,9279.0,IVORY EMBROIDERED QUILT ,1,864,24,2500,1636,1,48.0
12651,9280.0,GLASS STAR FROSTED T-LIGHT HOLDER,4,846,24,2500,1654,1,48.0
12652,9281.0,SET OF 3 BLACK FLYING DUCKS,4,231,19,2000,1769,1,38.0
12653,9282.0,SET OF 3 COLOURED  FLYING DUCKS,6,133,1,200,67,1,2.0
12654,9283.0,PACK OF 12 RED RETROSPOT TISSUES ,1,175,4,500,325,1,8.0
12655,9284.0,RED RETROSPOT MUG,3,132,6,700,568,1,12.0
12656,9285.0,BABUSHKA LIGHTS STRING OF 18,2,150,2,300,150,1,4.0
12657,9286.0,PIGGY BANK RETROSPOT ,10,473,20,2100,1627,1,40.0
12658,9287.0,SET 7 BABUSHKA NESTING BOXES,5,650,12,1300,650,1,24.0
12659,9288.0,DOORMAT FAIRY CAKE,1,1408,25,2600,1192,1,50.0
12660,9289.0,HAND WARMER RED RETROSPOT,4,961,10,1100,139,1,20.0
12661,9290.0,HAND WARMER SCOTTY DOG DESIGN,8,1441,25,2600,1159,1,50.0
12662,9291.0,HAND WARMER OWL DESIGN,7,347,3,400,53,1,6.0
12663,9292.0,STRAWBERRY CERAMIC TRINKET BOX,4,745,9,1000,255,1,18.0
12664,9293.0,PINK DOUGHNUT TRINKET POT ,4,505,6,700,195,1,12.0
12665,9294.0,SILK PURSE BABUSHKA PINK,3,308,15,1600,1292,1,30.0
12666,9295.0,HOT WATER BOTTLE TEA AND SYMPATHY,4,427,6,700,273,1,12.0
12667,9296.0,HOT WATER BOTTLE I AM SO POORLY,5,153,12,1300,1147,1,24.0
12668,9297.0,CHOCOLATE HOT WATER BOTTLE,6,868,22,2300,1432,1,44.0
12669,9298.0,WHITE SKULL HOT WATER BOTTLE ,2,537,12,1300,763,1,24.0
12670,9299.0,SCOTTIE DOG HOT WATER BOTTLE,2,166,5,600,434,1,10.0
12671,9300.0,HAND WARMER RED POLKA DOT,9,264,15,1600,1336,1,30.0
12672,9301.0,HAND WARMER UNION JACK,5,415,18,1900,1485,1,36.0
12673,9302.0,HOMEMADE JAM SCENTED CANDLES,1,766,19,2000,1234,1,38.0
12674,9303.0,BIRD HOUSE HOT WATER BOTTLE,8,293,2,300,7,1,4.0
12675,9304.0,BOUDOIR SQUARE TISSUE BOX,4,1351,25,2600,1249,1,50.0
12676,9305.0,SKULLS SQUARE TISSUE BOX,10,807,14,1500,693,1,28.0
12677,9306.0,PHOTO FRAME CORNICE,6,120,11,1200,1080,1,22.0
12678,9307.0,SILK PURSE BABUSHKA RED,7,250,2,300,50,1,4.0
12679,9308.0,PICTURE DOMINOES,8,170,1,200,30,1,2.0
12680,9309.0,S/6 SEW ON CROCHET FLOWERS,9,146,23,2400,2254,1,46.0
12681,9310.0,SCANDINAVIAN REDS RIBBONS,2,322,24,2500,2178,1,48.0
12682,9311.0,BALLOONS  WRITING SET ,9,2071,20,2100,29,1,40.0
12683,9312.0,JAM MAKING SET PRINTED,1,113,3,400,287,1,6.0
12684,9313.0,LAVENDER INCENSE IN TIN,10,1285,14,1500,215,1,28.0
12685,9314.0,TV DINNER TRAY VINTAGE PAISLEY,5,100,0,100,0,1,0.0
12686,9315.0,SET OF 4 ENGLISH ROSE PLACEMATS,1,1560,19,2000,440,1,38.0
12687,9316.0,SET OF 4 ENGLISH ROSE COASTERS,7,405,4,500,95,1,8.0
12688,9317.0,TRIPLE PHOTO FRAME CORNICE ,7,132,5,600,468,1,10.0
12689,9318.0,FAMILY PHOTO FRAME CORNICE,2,871,8,900,29,1,16.0
12690,9319.0,MIRRORED DISCO BALL ,7,329,3,400,71,1,6.0
12691,9320.0,DISCO BALL ROTATOR BATTERY OPERATED,8,313,8,900,587,1,16.0
12692,9321.0,SILVER LOOKING MIRROR,9,520,8,900,380,1,16.0
12693,9322.0,LADIES & GENTLEMEN METAL SIGN,2,125,4,500,375,1,8.0
12694,9323.0,METAL SIGN HER DINNER IS SERVED ,6,1075,22,2300,1225,1,44.0
12695,9324.0,YOU'RE CONFUSING ME METAL SIGN ,2,177,6,700,523,1,12.0
12696,9325.0,DOORMAT TOPIARY,8,1707,25,2600,893,1,50.0
12697,9326.0,BATHROOM METAL SIGN,2,193,9,1000,807,1,18.0
12698,9327.0,KITCHEN METAL SIGN,1,268,2,300,32,1,4.0
12699,9328.0,TOILET METAL SIGN,4,275,10,1100,825,1,20.0
12700,9329.0,METAL SIGN TAKE IT OR LEAVE IT ,3,269,2,300,31,1,4.0
12701,9330.0,I'M ON HOLIDAY METAL SIGN,4,507,8,900,393,1,16.0
12702,9331.0,GROW YOUR OWN BASIL IN ENAMEL MUG,8,282,11,1200,918,1,22.0
12703,9332.0,SET/10 PINK POLKADOT PARTY CANDLES,3,881,19,2000,1119,1,38.0
12704,9333.0,SET 20 NAPKINS FAIRY CAKES DESIGN ,5,132,4,500,368,1,8.0
12705,9334.0,68 TEATIME FAIRY CAKE CASES,7,131,3,400,269,1,6.0
12706,9335.0,SET OF 6 T-LIGHTS SNOWMEN,6,1429,14,1500,71,1,28.0
12707,9336.0,SET OF 6 T-LIGHTS SANTA,10,385,6,700,315,1,12.0
12708,9337.0,SET OF 9 HEART SHAPED BALLOONS,8,770,12,1300,530,1,24.0
12709,9338.0,SANDWICH BATH SPONGE,6,971,9,1000,29,1,18.0
12710,9339.0,APPLE BATH SPONGE,4,505,5,600,95,1,10.0
12711,9340.0,STRAWBERRY BATH SPONGE ,9,144,10,1100,956,1,20.0
12712,9341.0,BLACK PIRATE TREASURE CHEST,4,238,4,500,262,1,8.0
12713,9342.0,STAR PORTABLE TABLE LIGHT ,10,689,9,1000,311,1,18.0
12714,9343.0,SNOWFLAKE PORTABLE TABLE LIGHT ,8,1162,13,1400,238,1,26.0
12715,9344.0,PINK OVAL JEWELLED MIRROR,9,1422,23,2400,978,1,46.0
12716,9345.0,RETROSPOT CIGAR BOX MATCHES ,9,179,2,300,121,1,4.0
12717,9346.0,COSY HOUR GIANT TUBE MATCHES,4,912,14,1500,588,1,28.0
12718,9347.0,JAZZ HEARTS PURSE NOTEBOOK,9,1577,21,2200,623,1,42.0
12719,9348.0,LUNCH BAG DOLLY GIRL DESIGN,3,100,0,100,0,1,0.0
12720,9349.0,WHITE HANGING HEART T-LIGHT HOLDER,2,277,3,400,123,1,6.0
12721,9350.0,CANDLEHOLDER PINK HANGING HEART,10,243,3,400,157,1,6.0
12722,9351.0,WOOD 2 DRAWER CABINET WHITE FINISH,6,713,11,1200,487,1,22.0
12723,9352.0,ASSORTED COLOUR MINI CASES,8,191,9,1000,809,1,18.0
12724,9353.0,LUNCH BAG RED RETROSPOT,4,755,12,1300,545,1,24.0
12725,9354.0,LUNCH BAG SPACEBOY DESIGN ,1,1597,21,2200,603,1,42.0
12726,9355.0,LUNCH BAG WOODLAND,5,1469,19,2000,531,1,38.0
12727,9356.0,LUNCH BAG PINK POLKADOT,4,312,11,1200,888,1,22.0
12728,9357.0,GUMBALL COAT RACK,5,598,10,1100,502,1,20.0
12729,9358.0,BLUE NEW BAROQUE CANDLESTICK CANDLE,5,915,15,1600,685,1,30.0
12730,9359.0,PINK NEW BAROQUECANDLESTICK CANDLE,6,1900,22,2300,400,1,44.0
12731,9360.0,FAIRY CAKE FLANNEL ASSORTED COLOUR,4,1045,12,1300,255,1,24.0
12732,9361.0,BREAD BIN DINER STYLE PINK,7,450,13,1400,950,1,26.0
12733,9362.0,JUMBO BAG CHARLIE AND LOLA TOYS,6,462,21,2200,1738,1,42.0
12734,9363.0,TEA TIME TABLE CLOTH,5,595,10,1100,505,1,20.0
12735,9364.0,ENGLISH ROSE HOT WATER BOTTLE,10,343,4,500,157,1,8.0
12736,9365.0,ENAMEL FIRE BUCKET CREAM,1,272,18,1900,1628,1,36.0
12737,9366.0,PICNIC BASKET WICKER SMALL,7,191,1,200,9,1,2.0
12738,9367.0,PAPER CHAIN KIT 50'S CHRISTMAS ,2,259,3,400,141,1,6.0
12739,9368.0,PAPER CHAIN KIT VINTAGE CHRISTMAS,1,319,23,2400,2081,1,46.0
12740,9369.0,HOT WATER BOTTLE BABUSHKA ,3,350,8,900,550,1,16.0
12741,9370.0,HAND WARMER BIRD DESIGN,3,1100,15,1600,500,1,30.0
12742,9371.0,POSTAGE,9,1548,21,2200,652,1,42.0
12743,9372.0,HEART IVORY TRELLIS SMALL,7,859,9,1000,141,1,18.0
12744,9373.0,CLEAR DRAWER KNOB ACRYLIC EDWARDIAN,8,1943,21,2200,257,1,42.0
12745,9374.0,PINK DRAWER KNOB ACRYLIC EDWARDIAN,7,2410,24,2500,90,1,48.0
12746,9375.0,GREEN DRAWER KNOB ACRYLIC EDWARDIAN,1,1982,22,2300,318,1,44.0
12747,9376.0,BLUE DRAWER KNOB ACRYLIC EDWARDIAN,5,235,4,500,265,1,8.0
12748,9377.0,HEART OF WICKER SMALL,10,1079,18,1900,821,1,36.0
12749,9378.0,SMALL POPCORN HOLDER,4,1033,13,1400,367,1,26.0
12750,9379.0,SET 6 FOOTBALL CELEBRATION CANDLES,9,489,21,2200,1711,1,42.0
12751,9380.0,SET OF 6 GIRLS CELEBRATION CANDLES,9,596,5,600,4,1,10.0
12752,9381.0,ROMANTIC PINKS RIBBONS ,5,1139,16,1700,561,1,32.0
12753,9382.0,BRIGHT BLUES RIBBONS ,5,906,10,1100,194,1,20.0
12754,9383.0,SCANDINAVIAN REDS RIBBONS,2,1811,21,2200,389,1,42.0
12755,9384.0,CHOCOLATE BOX RIBBONS ,9,996,9,1000,4,1,18.0
12756,9385.0,PARTY INVITES FOOTBALL,10,1551,20,2100,549,1,40.0
12757,9386.0,PARTY INVITES JAZZ HEARTS,3,331,10,1100,769,1,20.0
12758,9387.0,PARTY INVITES SPACEMAN,2,139,12,1300,1161,1,24.0
12759,9388.0,SET OF 3 BUTTERFLY COOKIE CUTTERS,6,1108,17,1800,692,1,34.0
12760,9389.0,SET OF 3 HEART COOKIE CUTTERS,8,305,5,600,295,1,10.0
12761,9390.0,11 PIECE SPACEBOY COOKIE CUTTER SET,2,1278,15,1600,322,1,30.0
12762,9391.0,PACK OF 72 SKULL CAKE CASES,9,670,10,1100,430,1,20.0
12763,9392.0,PACK OF 60 SPACEBOY CAKE CASES,4,1156,17,1800,644,1,34.0
12764,9393.0,PACK OF 72 RETROSPOT CAKE CASES,10,119,5,600,481,1,10.0
12765,9394.0,80 SWEETHEART FAIRY CAKE CASES,10,245,17,1800,1555,1,34.0
12766,9395.0,PACK OF 60 DINOSAUR CAKE CASES,3,1704,24,2500,796,1,48.0
12767,9396.0,LUNCH BAG SUKI  DESIGN ,9,1376,20,2100,724,1,40.0
12768,9397.0,LUNCH BAG CARS BLUE,7,100,0,100,0,1,0.0
12769,9398.0,LUNCH BAG  BLACK SKULL.,2,100,0,100,0,1,0.0
12770,9399.0,HEART IVORY TRELLIS LARGE,7,575,23,2400,1825,1,46.0
12771,9400.0,SET/5 RED RETROSPOT LID GLASS BOWLS,6,248,11,1200,952,1,22.0
12772,9401.0,WHITE HANGING HEART T-LIGHT HOLDER,5,1210,16,1700,490,1,32.0
12773,9402.0,WHITE METAL LANTERN,8,1365,25,2600,1235,1,50.0
12774,9403.0,CREAM CUPID HEARTS COAT HANGER,8,1527,21,2200,673,1,42.0
12775,9404.0,EDWARDIAN PARASOL RED,3,855,22,2300,1445,1,44.0
12776,9405.0,RETRO COFFEE MUGS ASSORTED,8,417,13,1400,983,1,26.0
12777,9406.0,SAVE THE PLANET MUG,3,473,8,900,427,1,16.0
12778,9407.0,VINTAGE BILLBOARD DRINK ME MUG,10,1197,20,2100,903,1,40.0
12779,9408.0,VINTAGE BILLBOARD LOVE/HATE MUG,3,474,22,2300,1826,1,44.0
12780,9409.0,WOOD 2 DRAWER CABINET WHITE FINISH,8,760,14,1500,740,1,28.0
12781,9410.0,WOOD S/3 CABINET ANT WHITE FINISH,4,289,3,400,111,1,6.0
12782,9411.0,WOODEN PICTURE FRAME WHITE FINISH,8,587,15,1600,1013,1,30.0
12783,9412.0,WOODEN FRAME ANTIQUE WHITE ,1,1206,23,2400,1194,1,46.0
12784,9413.0,KNITTED UNION FLAG HOT WATER BOTTLE,9,168,4,500,332,1,8.0
12785,9414.0,RED WOOLLY HOTTIE WHITE HEART.,3,1203,17,1800,597,1,34.0
12786,9415.0,SET 7 BABUSHKA NESTING BOXES,8,1169,14,1500,331,1,28.0
12787,9416.0,IVORY EMBROIDERED QUILT ,1,498,24,2500,2002,1,48.0
12788,9417.0,GLASS STAR FROSTED T-LIGHT HOLDER,1,366,4,500,134,1,8.0
12789,9418.0,HAND WARMER RED POLKA DOT,8,177,1,200,23,1,2.0
12790,9419.0,HAND WARMER UNION JACK,10,199,5,600,401,1,10.0
12791,9420.0,MAGIC DRAWING SLATE DINOSAUR,9,335,9,1000,665,1,18.0
12792,9421.0,MAGIC DRAWING SLATE BAKE A CAKE ,6,1151,18,1900,749,1,36.0
12793,9422.0,20 PENCILS TALL TUBE SKULLS,7,398,6,700,302,1,12.0
12794,9423.0,CHOCOLATE CALCULATOR,1,898,17,1800,902,1,34.0
12795,9424.0,RED  HARMONICA IN BOX ,1,1915,19,2000,85,1,38.0
12796,9425.0,BLUE HARMONICA IN BOX ,3,1089,17,1800,711,1,34.0
12797,9426.0,SKULLS  WATER TRANSFER TATTOOS ,6,167,1,200,33,1,2.0
12798,9427.0,PACK 3 BOXES BIRD PANNETONE ,4,2260,25,2600,340,1,50.0
12799,9428.0,HOT WATER BOTTLE TEA AND SYMPATHY,4,358,3,400,42,1,6.0
12800,9429.0,RED WOOLLY HOTTIE WHITE HEART.,10,100,0,100,0,1,0.0
12801,9430.0,WHITE SKULL HOT WATER BOTTLE ,9,259,14,1500,1241,1,28.0
12802,9431.0,11 PIECE SPACEBOY COOKIE CUTTER SET,2,2200,23,2400,200,1,46.0
12803,9432.0,SET OF 20 KIDS COOKIE CUTTERS,3,1174,25,2600,1426,1,50.0
12804,9433.0,18 COLOUR SPACEBOY PEN,4,445,23,2400,1955,1,46.0
12805,9434.0,VICTORIAN GLASS HANGING T-LIGHT,8,632,6,700,68,1,12.0
12806,9435.0,SINGLE HEART ZINC T-LIGHT HOLDER,9,666,21,2200,1534,1,42.0
12807,9436.0,RED HANGING HEART T-LIGHT HOLDER,4,2437,25,2600,163,1,50.0
12808,9437.0,HANGING METAL STAR LANTERN,5,1568,19,2000,432,1,38.0
12809,9438.0,SILVER HANGING T-LIGHT HOLDER,8,608,11,1200,592,1,22.0
12810,9439.0,DOORMAT RED RETROSPOT,6,263,13,1400,1137,1,26.0
12811,9440.0,DOORMAT HEARTS,8,122,1,200,78,1,2.0
12812,9441.0,NATURAL SLATE RECTANGLE CHALKBOARD,10,728,13,1400,672,1,26.0
12813,9442.0,LOVEBIRD HANGING DECORATION WHITE ,7,146,2,300,154,1,4.0
12814,9443.0,ASSORTED COLOUR BIRD ORNAMENT,9,655,20,2100,1445,1,40.0
12815,9444.0,HOME BUILDING BLOCK WORD,4,386,5,600,214,1,10.0
12816,9445.0,LOVE BUILDING BLOCK WORD,1,953,19,2000,1047,1,38.0
12817,9446.0,PHOTO FRAME CORNICE,10,179,5,600,421,1,10.0
12818,9447.0,PENS ASSORTED FUNNY FACE,3,100,0,100,0,1,0.0
12819,9448.0,CARD CIRCUS PARADE,9,1261,20,2100,839,1,40.0
12820,9449.0,WRAP COWBOYS  ,8,600,22,2300,1700,1,44.0
12821,9450.0,AIRLINE BAG VINTAGE TOKYO 86,7,1726,24,2500,774,1,48.0
12822,9451.0,RED RETROSPOT UMBRELLA,8,571,24,2500,1929,1,48.0
12823,9452.0,BLACK/BLUE POLKADOT UMBRELLA,10,975,12,1300,325,1,24.0
12824,9453.0,RED 3 PIECE RETROSPOT CUTLERY SET,6,130,2,300,170,1,4.0
12825,9454.0,PACK OF 72 RETROSPOT CAKE CASES,9,2150,25,2600,450,1,50.0
12826,9455.0,SET OF 72 RETROSPOT PAPER  DOILIES,1,150,7,800,650,1,14.0
12827,9456.0,BLUE COAT RACK PARIS FASHION,9,1454,17,1800,346,1,34.0
12828,9457.0,PLASTERS IN TIN SKULLS,8,1139,15,1600,461,1,30.0
12829,9458.0,SLEEPING CAT ERASERS,3,100,0,100,0,1,0.0
12830,9459.0,CARD BIRTHDAY COWBOY,8,115,2,300,185,1,4.0
12831,9460.0,PACK 3 BOXES CHRISTMAS PANNETONE,9,757,7,800,43,1,14.0
12832,9461.0,ROTATING SILVER ANGELS T-LIGHT HLDR,10,126,7,800,674,1,14.0
12833,9462.0,COSY HOUR GIANT TUBE MATCHES,1,1298,17,1800,502,1,34.0
12834,9463.0,RIBBON REEL MAKING SNOWMEN ,3,515,8,900,385,1,16.0
12835,9464.0,MINI PAINT SET VINTAGE ,8,1871,25,2600,729,1,50.0
12836,9465.0,12 TRADITIONAL SPINNING TOPS,6,921,13,1400,479,1,26.0
12837,9466.0,SET OF 6 SOLDIER SKITTLES,4,635,8,900,265,1,16.0
12838,9467.0,BAG 500g SWIRLY MARBLES,4,618,9,1000,382,1,18.0
12839,9468.0,13 STRAND GLASS NECKLACE CRYSTAL,2,1892,25,2600,708,1,50.0
12840,9469.0,WHITE SKULL HOT WATER BOTTLE ,9,1937,19,2000,63,1,38.0
12841,9470.0,SCOTTIE DOG HOT WATER BOTTLE,8,576,5,600,24,1,10.0
12842,9471.0,SQUARECUSHION COVER PINK UNION FLAG,5,363,11,1200,837,1,22.0
12843,9472.0,SPACEBOY CHILDRENS EGG CUP,1,260,4,500,240,1,8.0
12844,9473.0,CHILDREN'S SPACEBOY MUG,3,268,15,1600,1332,1,30.0
12845,9474.0,HAND WARMER SCOTTY DOG DESIGN,7,162,1,200,38,1,2.0
12846,9475.0,FELTCRAFT CUSHION OWL,4,546,5,600,54,1,10.0
12847,9476.0,BLACK CANDELABRA T-LIGHT HOLDER,2,1199,11,1200,1,1,22.0
12848,9477.0,TOY TIDY DOLLY GIRL DESIGN,8,1486,18,1900,414,1,36.0
12849,9478.0,SET 12 LAVENDER  BOTANICAL T-LIGHTS,6,197,10,1100,903,1,20.0
12850,9479.0,UNION JACK FLAG LUGGAGE TAG,5,128,9,1000,872,1,18.0
12851,9480.0,RED HEART LUGGAGE TAG,7,1529,23,2400,871,1,46.0
12852,9481.0,RED GLASS TASSLE BAG CHARM,7,314,6,700,386,1,12.0
12853,9482.0,CLEAR ACRYLIC FACETED BANGLE,1,108,1,200,92,1,2.0
12854,9483.0,13 STRAND GLASS NECKLACE CRYSTAL,1,188,1,200,12,1,2.0
12855,9484.0,DOORMAT UNION JACK GUNS AND ROSES,4,498,8,900,402,1,16.0
12856,9485.0,VANILLA SCENT CANDLE JEWELLED BOX,9,854,9,1000,146,1,18.0
12857,9486.0,FULL ENGLISH BREAKFAST PLATE,10,212,12,1300,1088,1,24.0
12858,9487.0,BLACK CANDELABRA T-LIGHT HOLDER,10,1568,17,1800,232,1,34.0
12859,9488.0,MAGIC DRAWING SLATE CIRCUS PARADE  ,6,379,4,500,121,1,8.0
12860,9489.0,CHRISTMAS HANGING HEART WITH BELL,9,496,14,1500,1004,1,28.0
12861,9490.0,CAKE STAND VICTORIAN FILIGREE MED,3,148,1,200,52,1,2.0
12862,9491.0,PAISLEY PATTERN  STICKERS,3,709,21,2200,1491,1,42.0
12863,9492.0,FLOWERS  STICKERS,3,270,7,800,530,1,14.0
12864,9493.0,PINK NEW BAROQUECANDLESTICK CANDLE,3,105,6,700,595,1,12.0
12865,9494.0,BLUE NEW BAROQUE CANDLESTICK CANDLE,5,1752,22,2300,548,1,44.0
12866,9495.0,JUMBO STORAGE BAG SUKI,1,498,13,1400,902,1,26.0
12867,9496.0,BLACK LOVE BIRD CANDLE,3,325,3,400,75,1,6.0
12868,9497.0,PARTY TIME PENCIL ERASERS,4,234,11,1200,966,1,22.0
12869,9498.0,DISCO BALL CHRISTMAS DECORATION,10,1091,19,2000,909,1,38.0
12870,9499.0,PINK B'FLY C/COVER W BOBBLES,2,385,13,1400,1015,1,26.0
12871,9500.0,PINK UNION JACK  LUGGAGE TAG,8,100,0,100,0,1,0.0
12872,9501.0,14 RIBBONS ELEGANT CHRISTMAS ,10,100,4,500,400,1,8.0
12873,9502.0,UNION JACK FLAG LUGGAGE TAG,4,1861,18,1900,39,1,36.0
12874,9503.0,AGED GLASS SILVER T-LIGHT HOLDER,9,243,3,400,157,1,6.0
12875,9504.0,BOOM BOX SPEAKER GIRLS,3,260,3,400,140,1,6.0
12876,9505.0,14 RIBBONS SHIMMERING PINKS ,9,1110,17,1800,690,1,34.0
12877,9506.0, SET 2 TEA TOWELS I LOVE LONDON ,2,1043,17,1800,757,1,34.0
12878,9507.0,JUMBO BAG OWLS,8,550,14,1500,950,1,28.0
12879,9508.0,SANDWICH BATH SPONGE,9,274,25,2600,2326,1,50.0
12880,9509.0,OWL DOORSTOP,9,1260,16,1700,440,1,32.0
12881,9510.0,13 STRAND GLASS NECKLACE CRYSTAL,2,1262,14,1500,238,1,28.0
12882,9511.0,HAND WARMER UNION JACK,10,166,11,1200,1034,1,22.0
12883,9512.0,HAND WARMER SCOTTY DOG DESIGN,1,1944,19,2000,56,1,38.0
12884,9513.0,LARGE POPCORN HOLDER ,4,605,20,2100,1495,1,40.0
12885,9514.0,PAINTED METAL STAR WITH HOLLY BELLS,7,428,11,1200,772,1,22.0
12886,9515.0,PAINTED METAL HEART WITH HOLLY BELL,7,1536,21,2200,664,1,42.0
12887,9516.0,ANGEL DECORATION STARS ON DRESS,8,506,18,1900,1394,1,36.0
12888,9517.0,SMALL POPCORN HOLDER,1,267,6,700,433,1,12.0
12889,9518.0,JUMBO BAG RED RETROSPOT,2,100,0,100,0,1,0.0
12890,9519.0,JUMBO BAG STRAWBERRY,9,454,6,700,246,1,12.0
12891,9520.0,STRAWBERRY SHOPPER BAG,3,328,7,800,472,1,14.0
12892,9521.0,STRAWBERRY CHARLOTTE BAG,7,152,1,200,48,1,2.0
12893,9522.0, SET 2 TEA TOWELS I LOVE LONDON ,7,298,16,1700,1402,1,32.0
12894,9523.0,PACK OF 12 RED RETROSPOT TISSUES ,1,534,5,600,66,1,10.0
12895,9524.0,SCOTTIE DOG HOT WATER BOTTLE,7,451,21,2200,1749,1,42.0
12896,9525.0,CHOCOLATE HOT WATER BOTTLE,6,1062,22,2300,1238,1,44.0
12897,9526.0,LUNCH BAG CARS BLUE,7,263,8,900,637,1,16.0
12898,9527.0,LUNCH BAG SPACEBOY DESIGN ,9,296,3,400,104,1,6.0
12899,9528.0,ROUND SNACK BOXES SET OF4 WOODLAND ,6,649,13,1400,751,1,26.0
12900,9529.0,LUNCH BAG DOLLY GIRL DESIGN,1,1410,24,2500,1090,1,48.0
12901,9530.0,LUNCH BAG SUKI  DESIGN ,3,146,10,1100,954,1,20.0
12902,9531.0,LUNCH BAG  BLACK SKULL.,6,510,15,1600,1090,1,30.0
12903,9532.0,ROUND SNACK BOXES SET OF 4 FRUITS ,9,1993,22,2300,307,1,44.0
12904,9533.0,ROUND SNACK BOXES SET OF 4 SKULLS,3,159,1,200,41,1,2.0
12905,9534.0,DOLLY GIRL LUNCH BOX,9,223,9,1000,777,1,18.0
12906,9535.0,SPACEBOY LUNCH BOX ,3,1509,22,2300,791,1,44.0
12907,9536.0,GREEN POLKADOT PLATE ,5,841,8,900,59,1,16.0
12908,9537.0,BLUE POLKADOT PLATE ,3,396,6,700,304,1,12.0
12909,9538.0,RED RETROSPOT PLATE ,8,729,18,1900,1171,1,36.0
12910,9539.0,PINK  POLKADOT PLATE ,9,1656,20,2100,444,1,40.0
12911,9540.0,ROUND SNACK BOXES SET OF 4 SKULLS,2,1065,17,1800,735,1,34.0
12912,9541.0,FELTCRAFT DOLL MOLLY,8,1482,18,1900,418,1,36.0
12913,9542.0,FELTCRAFT CHRISTMAS FAIRY,4,1110,24,2500,1390,1,48.0
12914,9543.0,TRAVEL SEWING KIT,2,680,6,700,20,1,12.0
12915,9544.0,SET OF 3 NOTEBOOKS IN PARCEL,8,2050,21,2200,150,1,42.0
12916,9545.0,RED RETROSPOT TAPE,3,455,9,1000,545,1,18.0
12917,9546.0,COSY SLIPPER SHOES SMALL  RED ,3,1692,17,1800,108,1,34.0
12918,9547.0,14 RIBBONS RUSTIC CHARM,4,192,5,600,408,1,10.0
12919,9548.0,SCANDINAVIAN REDS RIBBONS,6,155,11,1200,1045,1,22.0
12920,9549.0,JAM MAKING SET PRINTED,1,864,12,1300,436,1,24.0
12921,9550.0,20 DAISY PEGS IN WOOD BOX,1,1092,22,2300,1208,1,44.0
12922,9551.0,HOT WATER BOTTLE BABUSHKA ,10,334,11,1200,866,1,22.0
12923,9552.0,FELTCRAFT PRINCESS CHARLOTTE DOLL,1,1394,14,1500,106,1,28.0
12924,9553.0,FELTCRAFT CHRISTMAS FAIRY,1,131,8,900,769,1,16.0
12925,9554.0,FELTCRAFT PRINCESS CHARLOTTE DOLL,3,612,15,1600,988,1,30.0
12926,9555.0,14 RIBBONS RUSTIC CHARM,6,270,6,700,430,1,12.0
12927,9556.0,COSY SLIPPER SHOES SMALL  RED ,3,2010,22,2300,290,1,44.0
12928,9557.0,SCANDINAVIAN REDS RIBBONS,4,888,10,1100,212,1,20.0
12929,9558.0,13 HOOK HANGER RED MAGIC TOADSTOOL,1,789,8,900,111,1,16.0
12930,9559.0,CHRISTMAS CRAFT TREE TOP ANGEL,7,720,20,2100,1380,1,40.0
12931,9560.0,CHRISTMAS CRAFT LITTLE FRIENDS,8,501,6,700,199,1,12.0
12932,9561.0,13 HOOK HANGER RED MAGIC TOADSTOOL,8,950,10,1100,150,1,20.0
12933,9562.0,14 RIBBONS RUSTIC CHARM,2,201,8,900,699,1,16.0
12934,9563.0,20 DAISY PEGS IN WOOD BOX,6,190,3,400,210,1,6.0
12935,9564.0,SET OF 3 NOTEBOOKS IN PARCEL,1,155,4,500,345,1,8.0
12936,9565.0,13 HOOK HANGER MAGIC TOADSTOOL,5,187,9,1000,813,1,18.0
12937,9566.0,SCANDINAVIAN REDS RIBBONS,9,184,1,200,16,1,2.0
12938,9567.0,RED TOADSTOOL LED NIGHT LIGHT,10,2030,21,2200,170,1,42.0
12939,9568.0,13 HOOK HANGER RED MAGIC TOADSTOOL,3,1940,19,2000,60,1,38.0
12940,9569.0,COSY SLIPPER SHOES SMALL GREEN,7,216,13,1400,1184,1,26.0
12941,9570.0,COSY SLIPPER SHOES SMALL  RED ,6,833,14,1500,667,1,28.0
12942,9571.0,FELTCRAFT DOLL ROSIE,8,110,9,1000,890,1,18.0
12943,9572.0,FELTCRAFT DOLL MOLLY,5,564,6,700,136,1,12.0
12944,9573.0,FELTCRAFT DOLL EMILY,10,1594,24,2500,906,1,48.0
12945,9574.0,FELTCRAFT PRINCESS CHARLOTTE DOLL,6,763,20,2100,1337,1,40.0
12946,9575.0,FELTCRAFT PRINCESS OLIVIA DOLL,8,299,9,1000,701,1,18.0
12947,9576.0,REX CASH+CARRY JUMBO SHOPPER,8,107,14,1500,1393,1,28.0
12948,9577.0,FELTCRAFT DOLL MOLLY,10,100,0,100,0,1,0.0
12949,9578.0,FELTCRAFT CUSHION OWL,4,1438,22,2300,862,1,44.0
12950,9579.0,CHRISTMAS CRAFT TREE TOP ANGEL,4,1394,16,1700,306,1,32.0
12951,9580.0,CHRISTMAS CRAFT LITTLE FRIENDS,3,1938,25,2600,662,1,50.0
12952,9581.0,FELTCRAFT CUSHION RABBIT,5,813,13,1400,587,1,26.0
12953,9582.0,FELTCRAFT CUSHION BUTTERFLY,8,2009,25,2600,591,1,50.0
12954,9583.0,20 DAISY PEGS IN WOOD BOX,2,672,12,1300,628,1,24.0
12955,9584.0,PAPER CHAIN KIT 50'S CHRISTMAS ,7,1125,21,2200,1075,1,42.0
12956,9585.0,FELTCRAFT CUSHION BUTTERFLY,7,445,14,1500,1055,1,28.0
12957,9586.0,20 DAISY PEGS IN WOOD BOX,4,1382,22,2300,918,1,44.0
12958,9587.0,ROSE COTTAGE KEEPSAKE BOX ,3,1756,24,2500,744,1,48.0
12959,9588.0,TOTE BAG I LOVE LONDON,6,2261,23,2400,139,1,46.0
12960,9589.0,20 DAISY PEGS IN WOOD BOX,3,483,4,500,17,1,8.0
12961,9590.0,TOTE BAG I LOVE LONDON,2,1889,18,1900,11,1,36.0
12962,9591.0,FOLDING UMBRELLA PINKWHITE POLKADOT,6,577,16,1700,1123,1,32.0
12963,9592.0,FOLDING UMBRELLA CREAM POLKADOT,6,1164,11,1200,36,1,22.0
12964,9593.0,FOLDING UMBRELLA WHITE/RED POLKADOT,8,1257,16,1700,443,1,32.0
12965,9594.0,SET 10 LIGHTS NIGHT OWL,4,182,9,1000,818,1,18.0
12966,9595.0,SMALL POPCORN HOLDER,10,1308,13,1400,92,1,26.0
12967,9596.0, SET 2 TEA TOWELS I LOVE LONDON ,5,688,13,1400,712,1,26.0
12968,9597.0,FOLDING UMBRELLA RED/WHITE POLKADOT,10,211,16,1700,1489,1,32.0
12969,9598.0,BABUSHKA LIGHTS STRING OF 18,4,1572,25,2600,1028,1,50.0
12970,9599.0,LUNCH BAG RED RETROSPOT,9,245,2,300,55,1,4.0
12971,9600.0,S/4 VALENTINE DECOUPAGE HEART BOX,4,1315,13,1400,85,1,26.0
12972,9601.0,FOLDING UMBRELLA CREAM POLKADOT,4,1730,18,1900,170,1,36.0
12973,9602.0, SET 2 TEA TOWELS I LOVE LONDON ,3,192,1,200,8,1,2.0
12974,9603.0,FOLDING UMBRELLA RED/WHITE POLKADOT,5,1979,21,2200,221,1,42.0
12975,9604.0,SOLDIERS EGG CUP ,7,554,24,2500,1946,1,48.0
12976,9605.0,S/4 VALENTINE DECOUPAGE HEART BOX,8,712,21,2200,1488,1,42.0
12977,9606.0,RED RETROSPOT MINI CASES,10,536,11,1200,664,1,22.0
12978,9607.0,,7,214,10,1100,886,1,20.0
12979,9608.0,68 CAKE CASES VINTAGE CHRISTMAS,5,180,10,1100,920,1,20.0
12980,9609.0,PAPER CHAIN KIT VINTAGE CHRISTMAS,4,2038,23,2400,362,1,46.0
12981,9610.0,RIBBON REEL CHRISTMAS SOCK BAUBLE,4,183,6,700,517,1,12.0
12982,9611.0,RIBBON REEL SNOWY VILLAGE,1,1947,20,2100,153,1,40.0
12983,9612.0,RIBBON REEL MAKING SNOWMEN ,8,714,13,1400,686,1,26.0
12984,9613.0,SET OF 20 VINTAGE CHRISTMAS NAPKINS,5,1926,25,2600,674,1,50.0
12985,9614.0,TURQUOISE CHRISTMAS TREE ,3,541,23,2400,1859,1,46.0
12986,9615.0,RED STAR CARD HOLDER,10,1688,18,1900,212,1,36.0
12987,9616.0,WICKER WREATH SMALL,8,107,1,200,93,1,2.0
12988,9617.0,HEART OF WICKER LARGE,3,174,1,200,26,1,2.0
12989,9618.0,ADVENT CALENDAR GINGHAM SACK,9,2005,24,2500,495,1,48.0
12990,9619.0,HEART OF WICKER SMALL,9,1436,23,2400,964,1,46.0
12991,9620.0,FELTCRAFT BUTTERFLY HEARTS,3,1869,25,2600,731,1,50.0
12992,9621.0,PARTY CONE CHRISTMAS DECORATION ,6,127,1,200,73,1,2.0
12993,9622.0,VINTAGE HEADS AND TAILS CARD GAME ,2,512,16,1700,1188,1,32.0
12994,9623.0,WICKER STAR ,3,1509,16,1700,191,1,32.0
12995,9624.0,VINTAGE SNAP CARDS,4,100,0,100,0,1,0.0
12996,9625.0,FELTCRAFT 6 FLOWER FRIENDS,2,100,0,100,0,1,0.0
12997,9626.0, SET 2 TEA TOWELS I LOVE LONDON ,9,1134,15,1600,466,1,30.0
12998,9627.0,JAM MAKING SET PRINTED,2,682,8,900,218,1,16.0
12999,9628.0,BIRD DECORATION RED RETROSPOT,6,266,22,2300,2034,1,44.0
13000,9629.0,CHRISTMAS GINGHAM TREE,3,362,13,1400,1038,1,26.0
13001,9630.0,CHRISTMAS GINGHAM STAR,8,2490,25,2600,110,1,50.0
13002,9631.0,CHRISTMAS GINGHAM HEART,6,647,13,1400,753,1,26.0
13003,9632.0,PACK OF 12 PINK POLKADOT TISSUES,5,1127,16,1700,573,1,32.0
13004,9633.0,FELTCRAFT PRINCESS LOLA DOLL,3,183,2,300,117,1,4.0
13005,9634.0,PACK OF 12 LONDON TISSUES ,4,520,25,2600,2080,1,50.0
13006,9635.0,PURPLE DRAWERKNOB ACRYLIC EDWARDIAN,3,1573,22,2300,727,1,44.0
13007,9636.0,CHILDREN'S APRON DOLLY GIRL ,2,152,1,200,48,1,2.0
13008,9637.0,CHILDRENS APRON SPACEBOY DESIGN,10,2053,24,2500,447,1,48.0
13009,9638.0,CHRISTMAS LIGHTS 10 SANTAS ,5,1209,16,1700,491,1,32.0
13010,9639.0,CHRISTMAS LIGHTS 10 REINDEER,6,543,6,700,157,1,12.0
13011,9640.0,PAPER CHAIN KIT 50'S CHRISTMAS ,3,1866,22,2300,434,1,44.0
13012,9641.0,FELTCRAFT CHRISTMAS FAIRY,7,371,7,800,429,1,14.0
13013,9642.0,PACK OF 72 RETROSPOT CAKE CASES,2,120,1,200,80,1,2.0
13014,9643.0,PACK OF 60 MUSHROOM CAKE CASES,2,360,11,1200,840,1,22.0
13015,9644.0,68 CAKE CASES DOLLY GIRL DESIGN,5,359,6,700,341,1,12.0
13016,9645.0,PACK OF 60 PINK PAISLEY CAKE CASES,10,1235,13,1400,165,1,26.0
13017,9646.0,HAND WARMER BABUSHKA DESIGN,4,629,6,700,71,1,12.0
13018,9647.0,HAND WARMER BIRD DESIGN,5,378,4,500,122,1,8.0
13019,9648.0,HAND WARMER OWL DESIGN,4,661,23,2400,1739,1,46.0
13020,9649.0,HAND WARMER RED RETROSPOT,10,1428,15,1600,172,1,30.0
13021,9650.0,SET 12 RETRO WHITE CHALK STICKS,7,1098,16,1700,602,1,32.0
13022,9651.0,FELTCRAFT HAIRBAND RED AND BLUE,4,254,15,1600,1346,1,30.0
13023,9652.0,FELTCRAFT HAIRBAND PINK AND PURPLE,2,681,8,900,219,1,16.0
13024,9653.0,FELTCRAFT HAIRBANDS PINK AND WHITE ,8,1783,17,1800,17,1,34.0
13025,9654.0,TV DINNER TRAY DOLLY GIRL,8,2230,23,2400,170,1,46.0
13026,9655.0,PLASTERS IN TIN VINTAGE PAISLEY ,7,1398,20,2100,702,1,40.0
13027,9656.0,PLASTERS IN TIN SPACEBOY,4,884,18,1900,1016,1,36.0
13028,9657.0,PLASTERS IN TIN WOODLAND ANIMALS,4,635,25,2600,1965,1,50.0
13029,9658.0,MAGIC DRAWING SLATE SPACEBOY ,1,245,25,2600,2355,1,50.0
13030,9659.0,MAGIC DRAWING SLATE CIRCUS PARADE  ,6,293,6,700,407,1,12.0
13031,9660.0,MAGIC DRAWING SLATE GO TO THE FAIR ,7,1785,23,2400,615,1,46.0
13032,9661.0,MAGIC DRAWING SLATE DOLLY GIRL ,5,589,18,1900,1311,1,36.0
13033,9662.0,CHARLIE + LOLA RED HOT WATER BOTTLE,1,268,9,1000,732,1,18.0
13034,9663.0,HOT WATER BOTTLE BABUSHKA ,5,1519,15,1600,81,1,30.0
13035,9664.0,URBAN BLACK RIBBONS ,6,704,20,2100,1396,1,40.0
13036,9665.0,FELTCRAFT PRINCESS CHARLOTTE DOLL,2,682,6,700,18,1,12.0
13037,9666.0,SET OF 6 T-LIGHTS TOADSTOOLS,3,942,13,1400,458,1,26.0
13038,9667.0,ROTATING LEAVES T-LIGHT HOLDER,9,1244,21,2200,956,1,42.0
13039,9668.0,RED  HARMONICA IN BOX ,2,1138,13,1400,262,1,26.0
13040,9669.0,CUPCAKE LACE PAPER SET 14,4,2289,22,2300,11,1,44.0
13041,9670.0,FAMILY PHOTO FRAME CORNICE,10,544,22,2300,1756,1,44.0
13042,9671.0,TRIPLE PHOTO FRAME CORNICE ,2,560,13,1400,840,1,26.0
13043,9672.0,WOODEN FRAME ANTIQUE WHITE ,4,1403,23,2400,997,1,46.0
13044,9673.0,WOODEN BOX OF DOMINOES,6,213,3,400,187,1,6.0
13045,9674.0,TRADITIONAL WOODEN CATCH CUP GAME ,4,2030,20,2100,70,1,40.0
13046,9675.0,TRADITIONAL WOODEN SKIPPING ROPE,5,160,4,500,340,1,8.0
13047,9676.0,S/6 WOODEN SKITTLES IN COTTON BAG,5,381,5,600,219,1,10.0
13048,9677.0,RED METAL BEACH SPADE ,8,350,10,1100,750,1,20.0
13049,9678.0,BOYS VINTAGE TIN SEASIDE BUCKET,4,204,2,300,96,1,4.0
13050,9679.0,GIRLS VINTAGE TIN SEASIDE BUCKET,3,959,9,1000,41,1,18.0
13051,9680.0,GREY HEART HOT WATER BOTTLE,2,1021,11,1200,179,1,22.0
13052,9681.0,SCOTTIE DOG HOT WATER BOTTLE,6,211,19,2000,1789,1,38.0
13053,9682.0,BIRD HOUSE HOT WATER BOTTLE,5,126,1,200,74,1,2.0
13054,9683.0,KINGS CHOICE TEA CADDY ,5,139,6,700,561,1,12.0
13055,9684.0,KINGS CHOICE BISCUIT TIN,5,360,4,500,140,1,8.0
13056,9685.0,METAL SIGN EMPIRE TEA,2,1830,19,2000,170,1,38.0
13057,9686.0,HOMEMADE JAM SCENTED CANDLES,2,1033,25,2600,1567,1,50.0
13058,9687.0,SET OF 6 SOLDIER SKITTLES,2,642,19,2000,1358,1,38.0
13059,9688.0,FAWN BLUE HOT WATER BOTTLE,1,160,2,300,140,1,4.0
13060,9689.0,HAND WARMER RED RETROSPOT,9,827,23,2400,1573,1,46.0
13061,9690.0,HOT WATER BOTTLE BABUSHKA ,6,771,23,2400,1629,1,46.0
13062,9691.0,WHITE SKULL HOT WATER BOTTLE ,10,162,1,200,38,1,2.0
13063,9692.0,RETROSPOT HEART HOT WATER BOTTLE,5,701,7,800,99,1,14.0
13064,9693.0,RED WOOLLY HOTTIE WHITE HEART.,2,218,4,500,282,1,8.0
13065,9694.0,SCOTTIE DOG HOT WATER BOTTLE,8,591,8,900,309,1,16.0
13066,9695.0,GREY HEART HOT WATER BOTTLE,1,828,11,1200,372,1,22.0
13067,9696.0,HOT WATER BOTTLE BABUSHKA ,2,247,2,300,53,1,4.0
13068,9697.0,PACK OF 6 BIRDY GIFT TAGS,3,1134,18,1900,766,1,36.0
13069,9698.0,CHILLI LIGHTS,4,347,8,900,553,1,16.0
13070,9699.0,PIGGY BANK RETROSPOT ,6,1511,15,1600,89,1,30.0
13071,9700.0,CERAMIC STRAWBERRY MONEY BOX,1,100,0,100,0,1,0.0
13072,9701.0,CERAMIC STRAWBERRY CAKE MONEY BANK,1,936,9,1000,64,1,18.0
13073,9702.0,CERAMIC CHERRY CAKE MONEY BANK,5,597,21,2200,1603,1,42.0
13074,9703.0,CERAMIC HEART FAIRY CAKE MONEY BANK,2,275,8,900,625,1,16.0
13075,9704.0,CERAMIC PIRATE CHEST MONEY BANK,6,228,3,400,172,1,6.0
13076,9705.0,DOORSTOP RETROSPOT HEART,6,430,7,800,370,1,14.0
13077,9706.0,GINGHAM HEART  DOORSTOP RED,3,312,18,1900,1588,1,36.0
13078,9707.0,RETROSPOT BABUSHKA DOORSTOP,5,188,1,200,12,1,2.0
13079,9708.0,SILK PURSE BABUSHKA RED,1,100,1,200,100,1,2.0
13080,9709.0,SILK PURSE BABUSHKA PINK,7,100,0,100,0,1,0.0
13081,9710.0,FAMILY PHOTO FRAME CORNICE,9,541,13,1400,859,1,26.0
13082,9711.0,SWEETHEART WIRE WALL TIDY,7,700,20,2100,1400,1,40.0
13083,9712.0,JAM MAKING SET PRINTED,1,1526,21,2200,674,1,42.0
13084,9713.0,RED RETROSPOT OVEN GLOVE ,10,354,15,1600,1246,1,30.0
13085,9714.0,CREAM HEART CARD HOLDER,4,459,19,2000,1541,1,38.0
13086,9715.0,NAMASTE SWAGAT INCENSE,6,1207,25,2600,1393,1,50.0
13087,9716.0,CERAMIC STRAWBERRY DESIGN MUG,4,1553,19,2000,447,1,38.0
13088,9717.0,BLACK HEART CARD HOLDER,3,100,0,100,0,1,0.0
13089,9718.0,CLASSICAL ROSE SMALL VASE,5,1627,17,1800,173,1,34.0
13090,9719.0,HYACINTH BULB T-LIGHT CANDLES,10,821,19,2000,1179,1,38.0
13091,9720.0,CHRISTMAS CRAFT WHITE FAIRY ,2,730,9,1000,270,1,18.0
13092,9721.0,CHRISTMAS CRAFT LITTLE FRIENDS,10,120,11,1200,1080,1,22.0
13093,9722.0,COSY HOUR CIGAR BOX MATCHES ,2,617,7,800,183,1,14.0
13094,9723.0,RED TEA TOWEL CLASSIC DESIGN,3,524,19,2000,1476,1,38.0
13095,9724.0,HEART FILIGREE DOVE  SMALL,7,542,23,2400,1858,1,46.0
13096,9725.0,RETROSPOT CHILDRENS APRON,6,100,0,100,0,1,0.0
13097,9726.0,COLOURING PENCILS BROWN TUBE,5,331,5,600,269,1,10.0
13098,9727.0,12 IVORY DINNER CANDLES SILVER FLOCK,4,100,0,100,0,1,0.0
13099,9728.0,HEART FILIGREE DOVE  SMALL,2,250,20,2100,1850,1,40.0
13100,9729.0,ZINC METAL HEART DECORATION,8,982,10,1100,118,1,20.0
13101,9730.0,GREEN FERN NOTEBOOK,4,1249,24,2500,1251,1,48.0
13102,9731.0,BLUE PAISLEY NOTEBOOK,7,533,19,2000,1467,1,38.0
13103,9732.0,CHRYSANTHEMUM NOTEBOOK,6,167,12,1300,1133,1,24.0
13104,9733.0,LARGE CHINESE STYLE SCISSOR,7,177,1,200,23,1,2.0
13105,9734.0,SMALL CHINESE STYLE SCISSOR,6,135,6,700,565,1,12.0
13106,9735.0,S/6 WOODEN SKITTLES IN COTTON BAG,4,628,7,800,172,1,14.0
13107,9736.0,TRADITIONAL WOODEN SKIPPING ROPE,1,1211,15,1600,389,1,30.0
13108,9737.0,SET OF 6 SOLDIER SKITTLES,4,235,3,400,165,1,6.0
13109,9738.0,12 TRADITIONAL SPINNING TOPS,8,1403,16,1700,297,1,32.0
13110,9739.0,ROTATING SILVER ANGELS T-LIGHT HLDR,8,2201,25,2600,399,1,50.0
13111,9740.0,BLACK LOVE BIRD CANDLE,6,1434,18,1900,466,1,36.0
13112,9741.0,RETROSPOT CHILDRENS APRON,7,106,1,200,94,1,2.0
13113,9742.0,HANGING GLASS ETCHED TEALIGHT,6,279,6,700,421,1,12.0
13114,9743.0,HANGING GLASS ETCHED TEALIGHT,10,456,8,900,444,1,16.0
13115,9744.0,BLUE NEW BAROQUE CANDLESTICK CANDLE,10,575,6,700,125,1,12.0
13116,9745.0,COOKING SET RETROSPOT,3,813,19,2000,1187,1,38.0
13117,9746.0,KINGS CHOICE GIANT TUBE MATCHES,9,100,0,100,0,1,0.0
13118,9747.0,COSY HOUR GIANT TUBE MATCHES,2,231,22,2300,2069,1,44.0
13119,9748.0,PLACE SETTING WHITE STAR,4,156,13,1400,1244,1,26.0
13120,9749.0,HYACINTH BULB T-LIGHT CANDLES,3,948,12,1300,352,1,24.0
13121,9750.0,S/15 SILVER GLASS BAUBLES IN BAG,10,107,2,300,193,1,4.0
13122,9751.0,FRENCH WC SIGN BLUE METAL,4,181,6,700,519,1,12.0
13123,9752.0,KINGS CHOICE GIANT TUBE MATCHES,8,640,25,2600,1960,1,50.0
13124,9753.0,80 SWEETHEART FAIRY CAKE CASES,8,310,6,700,390,1,12.0
13125,9754.0,ASSORTED COLOUR BIRD ORNAMENT,4,759,22,2300,1541,1,44.0
13126,9755.0,FAIRY SOAP SOAP HOLDER,4,1264,18,1900,636,1,36.0
13127,9756.0,GREEN GIANT GARDEN THERMOMETER,1,246,15,1600,1354,1,30.0
13128,9757.0,IVORY GIANT GARDEN THERMOMETER,4,100,0,100,0,1,0.0
13129,9758.0,BLUE GIANT GARDEN THERMOMETER,1,1293,14,1500,207,1,28.0
13130,9759.0,PACK OF 60 PINK PAISLEY CAKE CASES,4,569,5,600,31,1,10.0
13131,9760.0,RETROSPOT HEART HOT WATER BOTTLE,4,1859,22,2300,441,1,44.0
13132,9761.0,CHICK GREY HOT WATER BOTTLE,7,1773,24,2500,727,1,48.0
13133,9762.0,VICTORIAN SEWING BOX SMALL ,7,100,0,100,0,1,0.0
13134,9763.0,VICTORIAN SEWING BOX MEDIUM,10,142,2,300,158,1,4.0
13135,9764.0,SET/10 RED POLKADOT PARTY CANDLES,6,404,21,2200,1796,1,42.0
13136,9765.0,WASHROOM METAL SIGN,2,2098,24,2500,402,1,48.0
13137,9766.0,BLACK SWEETHEART BRACELET,2,444,8,900,456,1,16.0
13138,9767.0,DIAMANTE HAIR GRIP PACK/2 BLACK DIA,5,843,25,2600,1757,1,50.0
13139,9768.0,BLACK DIAMANTE EXPANDABLE RING,6,2063,23,2400,337,1,46.0
13140,9769.0,DIAMANTE HAIR GRIP PACK/2 RUBY,9,822,19,2000,1178,1,38.0
13141,9770.0,DIAMANTE HAIR GRIP PACK/2 MONTANA,10,611,14,1500,889,1,28.0
13142,9771.0,BLUE SWEETHEART BRACELET,10,1518,18,1900,382,1,36.0
13143,9772.0,PINK SWEETHEART BRACELET,8,384,5,600,216,1,10.0
13144,9773.0,PURPLE SWEETHEART BRACELET,6,1078,18,1900,822,1,36.0
13145,9774.0,JUMBO BAG PINK POLKADOT,1,614,25,2600,1986,1,50.0
13146,9775.0,JUMBO BAG RED RETROSPOT,10,321,5,600,279,1,10.0
13147,9776.0,ASSORTED COLOUR BIRD ORNAMENT,10,729,10,1100,371,1,20.0
13148,9777.0,PAPER CHAIN KIT 50'S CHRISTMAS ,2,784,20,2100,1316,1,40.0
13149,9778.0,RIBBON REEL CHRISTMAS PRESENT ,6,621,7,800,179,1,14.0
13150,9779.0,FIRST AID TIN,2,302,22,2300,1998,1,44.0
13151,9780.0,MAKE YOUR OWN MONSOON CARD KIT,9,783,20,2100,1317,1,40.0
13152,9781.0,PACK OF 12 HEARTS DESIGN TISSUES ,5,702,18,1900,1198,1,36.0
13153,9782.0,PACK OF 12 RED RETROSPOT TISSUES ,1,196,3,400,204,1,6.0
13154,9783.0,SOLDIERS EGG CUP ,1,234,8,900,666,1,16.0
13155,9784.0,HEART IVORY TRELLIS SMALL,1,2182,23,2400,218,1,46.0
13156,9785.0,HEART FILIGREE DOVE  SMALL,8,1270,15,1600,330,1,30.0
13157,9786.0,HEART FILIGREE DOVE LARGE,3,1136,17,1800,664,1,34.0
13158,9787.0,PACK 3 BOXES BIRD PANNETONE ,7,927,25,2600,1673,1,50.0
13159,9788.0,PACK 3 BOXES CHRISTMAS PANNETONE,9,1462,17,1800,338,1,34.0
13160,9789.0,SMALL POPCORN HOLDER,7,143,10,1100,957,1,20.0
13161,9790.0,PACK OF 60 PINK PAISLEY CAKE CASES,5,1280,23,2400,1120,1,46.0
13162,9791.0,SET OF 6 SOLDIER SKITTLES,8,768,17,1800,1032,1,34.0
13163,9792.0,SWIRLY CIRCULAR RUBBERS IN BAG,10,472,15,1600,1128,1,30.0
13164,9793.0,VINTAGE PAISLEY STATIONERY SET,1,155,8,900,745,1,16.0
13165,9794.0,PAPER CHAIN KIT VINTAGE CHRISTMAS,7,164,6,700,536,1,12.0
13166,9795.0,SET/10 BLUE POLKADOT PARTY CANDLES,10,281,24,2500,2219,1,48.0
13167,9796.0,RIBBON REEL SOCKS AND MITTENS,8,2025,25,2600,575,1,50.0
13168,9797.0,68 CAKE CASES VINTAGE CHRISTMAS,9,437,6,700,263,1,12.0
13169,9798.0,CHRISTMAS METAL TAGS ASSORTED ,3,590,14,1500,910,1,28.0
13170,9799.0,CHRISTMAS TREE T-LIGHT HOLDER,3,100,0,100,0,1,0.0
13171,9800.0,STAR  T-LIGHT HOLDER ,9,1555,20,2100,545,1,40.0
13172,9801.0,HEART T-LIGHT HOLDER ,3,107,7,800,693,1,14.0
13173,9802.0,MINI FUNKY DESIGN TAPES,10,691,10,1100,409,1,20.0
13174,9803.0,SET OF 6 T-LIGHTS SNOWMEN,7,596,9,1000,404,1,18.0
13175,9804.0,STAR WOODEN CHRISTMAS DECORATION,5,1571,19,2000,429,1,38.0
13176,9805.0,WOODEN HEART CHRISTMAS SCANDINAVIAN,4,834,9,1000,166,1,18.0
13177,9806.0,CHRISTMAS RETROSPOT TREE WOOD,5,100,0,100,0,1,0.0
13178,9807.0,SET OF 6 T-LIGHTS SANTA,7,1155,23,2400,1245,1,46.0
13179,9808.0,SET/9 CHRISTMAS T-LIGHTS SCENTED ,8,218,18,1900,1682,1,36.0
13180,9809.0,BLUE ROSE FABRIC MIRROR,6,905,25,2600,1695,1,50.0
13181,9810.0,THREE CANVAS LUGGAGE TAGS,9,2294,22,2300,6,1,44.0
13182,9811.0,RETROSPOT PARTY BAG + STICKER SET,5,100,0,100,0,1,0.0
13183,9812.0,PLASTERS IN TIN VINTAGE PAISLEY ,1,135,20,2100,1965,1,40.0
13184,9813.0,RETROSPOT SMALL TUBE MATCHES,4,922,9,1000,78,1,18.0
13185,9814.0,HAND WARMER SCOTTY DOG DESIGN,2,704,11,1200,496,1,22.0
13186,9815.0,3D CHRISTMAS STAMPS STICKERS ,7,146,7,800,654,1,14.0
13187,9816.0,HAND WARMER SCOTTY DOG DESIGN,7,345,7,800,455,1,14.0
13188,9817.0,HAND WARMER SCOTTY DOG DESIGN,5,380,12,1300,920,1,24.0
13189,9818.0,CLOTHES PEGS RETROSPOT PACK 32,6,815,12,1300,485,1,24.0
13190,9819.0,44 FOIL HEART CAKE CASES,9,985,23,2400,1415,1,46.0
13191,9820.0,CHRISTMAS METAL TAGS ASSORTED ,2,1127,21,2200,1073,1,42.0
13192,9821.0,PACK OF 6 SWEETIE GIFT BOXES,8,977,20,2100,1123,1,40.0
13193,9822.0,PACK OF 72 RETROSPOT CAKE CASES,4,622,8,900,278,1,16.0
13194,9823.0,PACK OF 72 RETROSPOT CAKE CASES,2,1749,22,2300,551,1,44.0
13195,9824.0,PACK OF 6 BIRDY GIFT TAGS,2,559,11,1200,641,1,22.0
13196,9825.0,SET/10 RED POLKADOT PARTY CANDLES,10,226,3,400,174,1,6.0
13197,9826.0,SET/10 PINK POLKADOT PARTY CANDLES,10,729,7,800,71,1,14.0
13198,9827.0,SET OF 3 NOTEBOOKS IN PARCEL,9,376,12,1300,924,1,24.0
13199,9828.0,STAR  T-LIGHT HOLDER ,3,955,14,1500,545,1,28.0
13200,9829.0,CINAMMON SET OF 9 T-LIGHTS,7,908,15,1600,692,1,30.0
13201,9830.0,ORANGE SCENTED SET/9 T-LIGHTS,1,100,0,100,0,1,0.0
13202,9831.0,RIBBON REEL STRIPES DESIGN ,4,1266,21,2200,934,1,42.0
13203,9832.0,SET OF 2 TINS JARDIN DE PROVENCE,2,383,13,1400,1017,1,26.0
13204,9833.0,MAKE YOUR OWN PLAYTIME CARD KIT,7,176,5,600,424,1,10.0
13205,9834.0,DINOSAURS  WRITING SET ,10,1361,13,1400,39,1,26.0
13206,9835.0,BALLOONS  WRITING SET ,8,177,7,800,623,1,14.0
13207,9836.0,SKULLS WRITING SET ,1,114,1,200,86,1,2.0
13208,9837.0,VINTAGE PAISLEY STATIONERY SET,2,100,0,100,0,1,0.0
13209,9838.0,COSY SLIPPER SHOES SMALL  RED ,4,376,10,1100,724,1,20.0
13210,9839.0,DOORMAT BLACK FLOCK ,9,1205,15,1600,395,1,30.0
13211,9840.0,JUMBO  BAG BAROQUE BLACK WHITE,1,1501,16,1700,199,1,32.0
13212,9841.0,JAM MAKING SET WITH JARS,2,141,15,1600,1459,1,30.0
13213,9842.0,ORANGE SCENTED SET/9 T-LIGHTS,5,586,6,700,114,1,12.0
13214,9843.0,CINAMMON SET OF 9 T-LIGHTS,3,177,22,2300,2123,1,44.0
13215,9844.0,HAND WARMER SCOTTY DOG DESIGN,10,1079,12,1300,221,1,24.0
13216,9845.0,CHRISTMAS DECOUPAGE CANDLE,1,312,4,500,188,1,8.0
13217,9846.0,HEART T-LIGHT HOLDER ,1,501,12,1300,799,1,24.0
13218,9847.0,GROW YOUR OWN BASIL IN ENAMEL MUG,7,491,5,600,109,1,10.0
13219,9848.0,OFFICE MUG WARMER POLKADOT,4,2103,25,2600,497,1,50.0
13220,9849.0,SMALL POPCORN HOLDER,4,529,8,900,371,1,16.0
13221,9850.0,JUMBO BAG DOLLY GIRL DESIGN,9,624,10,1100,476,1,20.0
13222,9851.0,JAM MAKING SET WITH JARS,7,1768,23,2400,632,1,46.0
13223,9852.0,JAM MAKING SET PRINTED,10,262,20,2100,1838,1,40.0
13224,9853.0,SMALL GLASS HEART TRINKET POT,3,954,11,1200,246,1,22.0
13225,9854.0,RED WOOLLY HOTTIE WHITE HEART.,2,100,0,100,0,1,0.0
13226,9855.0,BLACK RECORD COVER FRAME,8,1446,22,2300,854,1,44.0
13227,9856.0,"RECORD FRAME 7"" SINGLE SIZE ",5,1303,14,1500,197,1,28.0
13228,9857.0,44 PENCILS TUBE RED RETROSPOT,4,1832,19,2000,168,1,38.0
13229,9858.0,44 PENCILS TUBE WOODLAND,9,139,1,200,61,1,2.0
13230,9859.0,SET OF 6 SOLDIER SKITTLES,9,720,19,2000,1280,1,38.0
13231,9860.0,ROCKING HORSE RED CHRISTMAS ,4,456,17,1800,1344,1,34.0
13232,9861.0,CHRISTMAS GINGHAM HEART,5,808,12,1300,492,1,24.0
13233,9862.0,CHRISTMAS GINGHAM STAR,7,2544,25,2600,56,1,50.0
13234,9863.0,HAND WARMER UNION JACK,4,890,12,1300,410,1,24.0
13235,9864.0,HAND WARMER RED RETROSPOT,2,319,5,600,281,1,10.0
13236,9865.0,REGENCY CAKESTAND 3 TIER,8,1431,17,1800,369,1,34.0
13237,9866.0,JUMBO SHOPPER VINTAGE RED PAISLEY,1,997,11,1200,203,1,22.0
13238,9867.0,RIBBON REEL SNOWY VILLAGE,3,982,10,1100,118,1,20.0
13239,9868.0,VINTAGE UNION JACK BUNTING,9,185,1,200,15,1,2.0
13240,9869.0,JAM MAKING SET WITH JARS,9,286,2,300,14,1,4.0
13241,9870.0,RIBBON REEL STRIPES DESIGN ,7,941,20,2100,1159,1,40.0
13242,9871.0,RETRO LONGBOARD IRONING BOARD COVER,4,676,12,1300,624,1,24.0
13243,9872.0,3D DOG PICTURE PLAYING CARDS,1,435,9,1000,565,1,18.0
13244,9873.0,RETROSPOT CIGAR BOX MATCHES ,2,194,1,200,6,1,2.0
13245,9874.0,SET/9 CHRISTMAS T-LIGHTS SCENTED ,2,164,2,300,136,1,4.0
13246,9875.0,ROTATING SILVER ANGELS T-LIGHT HLDR,2,521,7,800,279,1,14.0
13247,9876.0,ROTATING SILVER ANGELS T-LIGHT HLDR,9,616,9,1000,384,1,18.0
13248,9877.0,SAVE THE PLANET COTTON TOTE BAG,3,1218,24,2500,1282,1,48.0
13249,9878.0,SET OF 20 VINTAGE CHRISTMAS NAPKINS,7,191,1,200,9,1,2.0
13250,9879.0,PAPER BUNTING WHITE LACE,2,2114,22,2300,186,1,44.0
13251,9880.0,GENTLEMAN SHIRT REPAIR KIT ,8,1578,15,1600,22,1,30.0
13252,9881.0,CARD I LOVE LONDON ,2,485,7,800,315,1,14.0
13253,9882.0,PAPER CHAIN KIT VINTAGE CHRISTMAS,8,1147,17,1800,653,1,34.0
13254,9883.0,MIRRORED WALL ART FOXY,3,796,11,1200,404,1,22.0
13255,9884.0,MIRRORED WALL ART GENTS,2,230,6,700,470,1,12.0
13256,9885.0,AIRLINE BAG VINTAGE JET SET WHITE,8,203,2,300,97,1,4.0
13257,9886.0,JAM MAKING SET PRINTED,7,302,3,400,98,1,6.0
13258,9887.0,POTTING SHED SOW 'N' GROW SET,1,157,19,2000,1843,1,38.0
13259,9888.0,BABUSHKA LIGHTS STRING OF 18,5,299,4,500,201,1,8.0
13260,9889.0,REX CASH+CARRY JUMBO SHOPPER,10,801,15,1600,799,1,30.0
13261,9890.0,AIRLINE BAG VINTAGE WORLD CHAMPION ,10,100,0,100,0,1,0.0
13262,9891.0,HAND WARMER BIRD DESIGN,2,517,15,1600,1083,1,30.0
13263,9892.0,CHRISTMAS CRAFT LITTLE FRIENDS,5,245,11,1200,955,1,22.0
13264,9893.0,PINK HEARTS PAPER GARLAND,2,612,9,1000,388,1,18.0
13265,9894.0,POTTING SHED SEED ENVELOPES,7,522,8,900,378,1,16.0
13266,9895.0,HI TEC ALPINE HAND WARMER,4,568,5,600,32,1,10.0
13267,9896.0,FELTCRAFT CHRISTMAS FAIRY,5,147,1,200,53,1,2.0
13268,9897.0,HI TEC ALPINE HAND WARMER,4,325,9,1000,675,1,18.0
13269,9898.0,ROTATING SILVER ANGELS T-LIGHT HLDR,2,1669,20,2100,431,1,40.0
13270,9899.0,11 STRIPEY MICE FELTCRAFT,5,1031,21,2200,1169,1,42.0
13271,9900.0,FELTCRAFT 6 FLOWER FRIENDS,7,2070,22,2300,230,1,44.0
13272,9901.0,CHRISTMAS CRAFT LITTLE FRIENDS,6,569,19,2000,1431,1,38.0
13273,9902.0,VINTAGE UNION JACK CUSHION COVER,3,264,3,400,136,1,6.0
13274,9903.0,POLYESTER FILLER PAD 45x45cm,10,462,20,2100,1638,1,40.0
13275,9904.0,DOLLY GIRL LUNCH BOX,1,405,9,1000,595,1,18.0
13276,9905.0,PACK OF 12 LONDON TISSUES ,6,853,18,1900,1047,1,36.0
13277,9906.0,CARD DOLLY GIRL ,3,1979,20,2100,121,1,40.0
13278,9907.0,CARD BILLBOARD FONT,10,754,8,900,146,1,16.0
13279,9908.0,RAINY LADIES BIRTHDAY CARD,10,1672,24,2500,828,1,48.0
13280,9909.0,GREY HEART HOT WATER BOTTLE,9,126,18,1900,1774,1,36.0
13281,9910.0,RED WOOLLY HOTTIE WHITE HEART.,5,530,22,2300,1770,1,44.0
13282,9911.0,RED WHITE SCARF  HOT WATER BOTTLE,8,269,4,500,231,1,8.0
13283,9912.0, SET 2 TEA TOWELS I LOVE LONDON ,8,1358,17,1800,442,1,34.0
13284,9913.0,SET OF 2 TEA TOWELS APPLE AND PEARS,10,221,7,800,579,1,14.0
13285,9914.0,SET/2 RED RETROSPOT TEA TOWELS ,1,1042,25,2600,1558,1,50.0
13286,9915.0,LOVE BUILDING BLOCK WORD,4,288,8,900,612,1,16.0
13287,9916.0,HOME BUILDING BLOCK WORD,9,144,1,200,56,1,2.0
13288,9917.0,ASSORTED COLOUR BIRD ORNAMENT,4,1067,21,2200,1133,1,42.0
13289,9918.0,LANTERN CREAM GAZEBO ,3,208,14,1500,1292,1,28.0
13290,9919.0,BLUE BIRDHOUSE DECORATION,7,100,0,100,0,1,0.0
13291,9920.0,WHITE HANGING HEART T-LIGHT HOLDER,6,939,10,1100,161,1,20.0
13292,9921.0,REGENCY CAKESTAND 3 TIER,4,197,3,400,203,1,6.0
13293,9922.0,ANTIQUE SILVER TEA GLASS ENGRAVED,10,486,7,800,314,1,14.0
13294,9923.0,AGED GLASS SILVER T-LIGHT HOLDER,7,1042,15,1600,558,1,30.0
13295,9924.0,JAM MAKING SET WITH JARS,4,179,1,200,21,1,2.0
13296,9925.0,HAND WARMER OWL DESIGN,2,569,13,1400,831,1,26.0
13297,9926.0,SET OF 2 WOODEN MARKET CRATES,2,2423,25,2600,177,1,50.0
13298,9927.0,SET OF 6 T-LIGHTS TOADSTOOLS,3,196,17,1800,1604,1,34.0
13299,9928.0,HAND WARMER UNION JACK,9,101,19,2000,1899,1,38.0
13300,9929.0,HAND WARMER SCOTTY DOG DESIGN,5,786,8,900,114,1,16.0
13301,9930.0,CLASSIC FRENCH STYLE BASKET NATURAL,6,359,16,1700,1341,1,32.0
13302,9931.0,CRAZY DAISY HEART DECORATION,10,754,15,1600,846,1,30.0
13303,9932.0,GIN + TONIC DIET METAL SIGN,6,320,12,1300,980,1,24.0
13304,9933.0,IVORY GIANT GARDEN THERMOMETER,9,541,13,1400,859,1,26.0
13305,9934.0,CARD HOLDER GINGHAM HEART,10,1869,21,2200,331,1,42.0
13306,9935.0,SMALL STRIPES CHOCOLATE GIFT BAG ,10,1394,13,1400,6,1,26.0
13307,9936.0,S/6 WOODEN SKITTLES IN COTTON BAG,10,749,14,1500,751,1,28.0
13308,9937.0,HAND WARMER RED RETROSPOT,1,1657,18,1900,243,1,36.0
13309,9938.0,HAND WARMER UNION JACK,1,527,16,1700,1173,1,32.0
13310,9939.0,FRENCH WC SIGN BLUE METAL,9,418,4,500,82,1,8.0
13311,9940.0,PINK UNION JACK  LUGGAGE TAG,4,1669,17,1800,131,1,34.0
13312,9941.0,"TRAY, BREAKFAST IN BED",3,618,12,1300,682,1,24.0
13313,9942.0,PIZZA PLATE IN BOX,8,1456,14,1500,44,1,28.0
13314,9943.0,HEART OF WICKER LARGE,5,332,18,1900,1568,1,36.0
13315,9944.0,PINK HEART DOTS HOT WATER BOTTLE,2,350,21,2200,1850,1,42.0
13316,9945.0,PLACE SETTING WHITE HEART,7,765,16,1700,935,1,32.0
13317,9946.0,SET OF 4 NAPKIN CHARMS LEAVES   ,2,132,24,2500,2368,1,48.0
13318,9947.0,SET OF 4 NAPKIN CHARMS STARS   ,9,485,4,500,15,1,8.0
13319,9948.0,SET OF 4 NAPKIN CHARMS CUTLERY,10,317,11,1200,883,1,22.0
13320,9949.0,CARAVAN SQUARE TISSUE BOX,3,947,15,1600,653,1,30.0
13321,9950.0,PLASTERS IN TIN SKULLS,8,1725,25,2600,875,1,50.0
13322,9951.0,PLASTERS IN TIN SPACEBOY,4,325,9,1000,675,1,18.0
13323,9952.0,BUTTON BOX ,10,2592,25,2600,8,1,50.0
13324,9953.0,PLASTERS IN TIN VINTAGE PAISLEY ,10,619,6,700,81,1,12.0
13325,9954.0,20 MESSAGE CARDS WITH ENVELOPES,8,761,24,2500,1739,1,48.0
13326,9955.0,SMALL RED BABUSHKA NOTEBOOK ,1,100,0,100,0,1,0.0
13327,9956.0,CUPCAKE LACE PAPER SET 14,9,178,1,200,22,1,2.0
13328,9957.0,PACK 3 BOXES CHRISTMAS PANNETONE,2,957,21,2200,1243,1,42.0
13329,9958.0,HERB MARKER MINT,10,861,22,2300,1439,1,44.0
13330,9959.0,HERB MARKER ROSEMARY,9,1696,23,2400,704,1,46.0
13331,9960.0,HERB MARKER BASIL,4,607,6,700,93,1,12.0
13332,9961.0,HERB MARKER CHIVES ,4,1015,24,2500,1485,1,48.0
13333,9962.0,HERB MARKER PARSLEY,8,104,1,200,96,1,2.0
13334,9963.0,HERB MARKER THYME,2,629,15,1600,971,1,30.0
13335,9964.0,WHITE HANGING HEART T-LIGHT HOLDER,8,266,6,700,434,1,12.0
13336,9965.0,METAL MERRY CHRISTMAS WREATH,3,1358,13,1400,42,1,26.0
13337,9966.0,WHITE CHRISTMAS GARLAND STARS TREES,10,951,13,1400,449,1,26.0
13338,9967.0,RETROSPOT SMALL TUBE MATCHES,10,1341,14,1500,159,1,28.0
13339,9968.0,RETROSPOT GIANT TUBE MATCHES,3,831,11,1200,369,1,22.0
13340,9969.0,PLACE SETTING WHITE STAR,5,139,1,200,61,1,2.0
13341,9970.0,GROW YOUR OWN BASIL IN ENAMEL MUG,2,1431,23,2400,969,1,46.0
13342,9971.0,44 FOIL STAR CAKE CASES ,9,1209,24,2500,1291,1,48.0
13343,9972.0,44 FOIL HEART CAKE CASES,4,305,21,2200,1895,1,42.0
13344,9973.0,PACK OF 6 SWEETIE GIFT BOXES,5,952,16,1700,748,1,32.0
13345,9974.0,PACK OF 6 HANDBAG GIFT BOXES,6,100,0,100,0,1,0.0
13346,9975.0,GARLAND WOODEN HAPPY EASTER,4,339,8,900,561,1,16.0
13347,9976.0,CALENDAR PAPER CUT DESIGN,1,2137,22,2300,163,1,44.0
13348,9977.0,CALENDAR IN SEASON DESIGN,6,1034,18,1900,866,1,36.0
13349,9978.0,SMALL POPCORN HOLDER,4,201,5,600,399,1,10.0
13350,9979.0,BLUE PAISLEY TISSUE BOX,10,2234,24,2500,266,1,48.0
13351,9980.0,HEART OF WICKER SMALL,10,1188,12,1300,112,1,24.0
13352,9981.0,SKULLS SQUARE TISSUE BOX,6,706,7,800,94,1,14.0
13353,9982.0,SKULLS SQUARE TISSUE BOX,4,188,2,300,112,1,4.0
13354,9983.0,WHITE HANGING HEART T-LIGHT HOLDER,8,367,20,2100,1733,1,40.0
13355,9984.0,WHITE METAL LANTERN,4,138,3,400,262,1,6.0
13356,9985.0,CREAM CUPID HEARTS COAT HANGER,5,987,14,1500,513,1,28.0
13357,9986.0,KNITTED UNION FLAG HOT WATER BOTTLE,1,107,20,2100,1993,1,40.0
13358,9987.0,RED WOOLLY HOTTIE WHITE HEART.,4,1253,22,2300,1047,1,44.0
13359,9988.0,SET 7 BABUSHKA NESTING BOXES,9,1165,14,1500,335,1,28.0
13360,9989.0,GLASS STAR FROSTED T-LIGHT HOLDER,6,1516,20,2100,584,1,40.0
13361,9990.0,HAND WARMER UNION JACK,9,218,14,1500,1282,1,28.0
13362,9991.0,HAND WARMER RED POLKA DOT,8,1729,25,2600,871,1,50.0
13363,9992.0,ASSORTED COLOUR BIRD ORNAMENT,1,134,2,300,166,1,4.0
13364,9993.0,POPPY'S PLAYHOUSE BEDROOM ,1,100,0,100,0,1,0.0
13365,9994.0,POPPY'S PLAYHOUSE KITCHEN,7,514,23,2400,1886,1,46.0
13366,9995.0,FELTCRAFT PRINCESS CHARLOTTE DOLL,6,730,22,2300,1570,1,44.0
13367,9996.0,IVORY KNITTED MUG COSY ,6,564,12,1300,736,1,24.0
13368,9997.0,BOX OF 6 ASSORTED COLOUR TEASPOONS,5,306,7,800,494,1,14.0
13369,9998.0,BOX OF VINTAGE JIGSAW BLOCKS ,3,177,2,300,123,1,4.0
13370,9999.0,BOX OF VINTAGE ALPHABET BLOCKS,7,230,3,400,170,1,6.0
13371,10000.0,HOME BUILDING BLOCK WORD,2,684,22,2300,1616,1,44.0
13372,10001.0,LOVE BUILDING BLOCK WORD,10,1025,15,1600,575,1,30.0
13373,10002.0,RECIPE BOX WITH METAL HEART,1,2010,25,2600,590,1,50.0
13374,10003.0,DOORMAT NEW ENGLAND,7,229,14,1500,1271,1,28.0
13375,10004.0,JAM MAKING SET WITH JARS,7,706,11,1200,494,1,22.0
13376,10005.0,RED COAT RACK PARIS FASHION,2,197,2,300,103,1,4.0
13377,10006.0,YELLOW COAT RACK PARIS FASHION,5,574,18,1900,1326,1,36.0
13378,10007.0,BLUE COAT RACK PARIS FASHION,2,237,2,300,63,1,4.0
13379,10008.0,BATH BUILDING BLOCK WORD,10,1556,15,1600,44,1,30.0
13380,10009.0,ALARM CLOCK BAKELIKE PINK,5,1213,23,2400,1187,1,46.0
13381,10010.0,ALARM CLOCK BAKELIKE RED ,8,296,4,500,204,1,8.0
13382,10011.0,ALARM CLOCK BAKELIKE GREEN,7,1077,12,1300,223,1,24.0
13383,10012.0,PANDA AND BUNNIES STICKER SHEET,5,757,17,1800,1043,1,34.0
13384,10013.0,STARS GIFT TAPE ,9,409,9,1000,591,1,18.0
13385,10014.0,INFLATABLE POLITICAL GLOBE ,5,318,3,400,82,1,6.0
13386,10015.0,VINTAGE HEADS AND TAILS CARD GAME ,4,484,9,1000,516,1,18.0
13387,10016.0,SET/2 RED RETROSPOT TEA TOWELS ,5,665,9,1000,335,1,18.0
13388,10017.0,ROUND SNACK BOXES SET OF4 WOODLAND ,3,477,5,600,123,1,10.0
13389,10018.0,SPACEBOY LUNCH BOX ,2,881,14,1500,619,1,28.0
13390,10019.0,LUNCH BOX I LOVE LONDON,8,549,5,600,51,1,10.0
13391,10020.0,CIRCUS PARADE LUNCH BOX ,9,658,17,1800,1142,1,34.0
13392,10021.0,CHARLOTTE BAG DOLLY GIRL DESIGN,4,1422,24,2500,1078,1,48.0
13393,10022.0,RED TOADSTOOL LED NIGHT LIGHT,6,1425,23,2400,975,1,46.0
13394,10023.0, SET 2 TEA TOWELS I LOVE LONDON ,8,1592,22,2300,708,1,44.0
13395,10024.0,VINTAGE SEASIDE JIGSAW PUZZLES,10,459,7,800,341,1,14.0
13396,10025.0,MINI JIGSAW CIRCUS PARADE ,2,170,2,300,130,1,4.0
13397,10026.0,MINI JIGSAW SPACEBOY,5,1433,22,2300,867,1,44.0
13398,10027.0,MINI PAINT SET VINTAGE ,3,635,7,800,165,1,14.0
13399,10028.0,POSTAGE,9,400,19,2000,1600,1,38.0
13400,10029.0,PAPER CHAIN KIT 50'S CHRISTMAS ,9,146,1,200,54,1,2.0
13401,10030.0,HAND WARMER RED POLKA DOT,9,1604,17,1800,196,1,34.0
13402,10031.0,HAND WARMER UNION JACK,10,636,11,1200,564,1,22.0
13403,10032.0,WHITE HANGING HEART T-LIGHT HOLDER,2,398,7,800,402,1,14.0
13404,10033.0,WHITE METAL LANTERN,4,1420,19,2000,580,1,38.0
13405,10034.0,CREAM CUPID HEARTS COAT HANGER,4,555,8,900,345,1,16.0
13406,10035.0,EDWARDIAN PARASOL RED,1,757,8,900,143,1,16.0
13407,10036.0,RETRO COFFEE MUGS ASSORTED,3,458,4,500,42,1,8.0
13408,10037.0,SAVE THE PLANET MUG,5,728,22,2300,1572,1,44.0
13409,10038.0,VINTAGE BILLBOARD DRINK ME MUG,1,640,12,1300,660,1,24.0
13410,10039.0,VINTAGE BILLBOARD LOVE/HATE MUG,7,1282,19,2000,718,1,38.0
13411,10040.0,WOOD 2 DRAWER CABINET WHITE FINISH,5,185,7,800,615,1,14.0
13412,10041.0,WOOD S/3 CABINET ANT WHITE FINISH,2,314,12,1300,986,1,24.0
13413,10042.0,WOODEN PICTURE FRAME WHITE FINISH,4,1124,25,2600,1476,1,50.0
13414,10043.0,WOODEN FRAME ANTIQUE WHITE ,2,100,0,100,0,1,0.0
13415,10044.0,KNITTED UNION FLAG HOT WATER BOTTLE,1,860,12,1300,440,1,24.0
13416,10045.0,RED WOOLLY HOTTIE WHITE HEART.,8,295,2,300,5,1,4.0
13417,10046.0,SET 7 BABUSHKA NESTING BOXES,7,448,4,500,52,1,8.0
13418,10047.0,GLASS STAR FROSTED T-LIGHT HOLDER,4,868,16,1700,832,1,32.0
13419,10048.0,VICTORIAN SEWING BOX LARGE,4,633,6,700,67,1,12.0
13420,10049.0,WHITE HANGING HEART T-LIGHT HOLDER,1,165,1,200,35,1,2.0
13421,10050.0,WHITE METAL LANTERN,5,198,2,300,102,1,4.0
13422,10051.0,CREAM CUPID HEARTS COAT HANGER,10,902,12,1300,398,1,24.0
13423,10052.0,EDWARDIAN PARASOL RED,7,260,2,300,40,1,4.0
13424,10053.0,RETRO COFFEE MUGS ASSORTED,7,162,1,200,38,1,2.0
13425,10054.0,SAVE THE PLANET MUG,6,1536,16,1700,164,1,32.0
13426,10055.0,VINTAGE BILLBOARD DRINK ME MUG,8,109,2,300,191,1,4.0
13427,10056.0,VINTAGE BILLBOARD LOVE/HATE MUG,1,1348,16,1700,352,1,32.0
13428,10057.0,WOOD 2 DRAWER CABINET WHITE FINISH,4,427,6,700,273,1,12.0
13429,10058.0,WOOD S/3 CABINET ANT WHITE FINISH,2,690,17,1800,1110,1,34.0
13430,10059.0,WOODEN PICTURE FRAME WHITE FINISH,4,100,0,100,0,1,0.0
13431,10060.0,WOODEN FRAME ANTIQUE WHITE ,5,280,2,300,20,1,4.0
13432,10061.0,KNITTED UNION FLAG HOT WATER BOTTLE,1,795,19,2000,1205,1,38.0
13433,10062.0,RED WOOLLY HOTTIE WHITE HEART.,6,1985,21,2200,215,1,42.0
13434,10063.0,SET 7 BABUSHKA NESTING BOXES,1,287,3,400,113,1,6.0
13435,10064.0,GLASS STAR FROSTED T-LIGHT HOLDER,6,183,4,500,317,1,8.0
13436,10065.0,HOT WATER BOTTLE TEA AND SYMPATHY,4,739,21,2200,1461,1,42.0
13437,10066.0,RED HANGING HEART T-LIGHT HOLDER,1,528,9,1000,472,1,18.0
13438,10067.0,HAND WARMER RED POLKA DOT,6,188,7,800,612,1,14.0
13439,10068.0,HAND WARMER UNION JACK,10,265,2,300,35,1,4.0
13440,10069.0,JUMBO BAG PINK POLKADOT,3,657,11,1200,543,1,22.0
13441,10070.0,JUMBO  BAG BAROQUE BLACK WHITE,7,244,3,400,156,1,6.0
13442,10071.0,JUMBO BAG CHARLIE AND LOLA TOYS,2,287,7,800,513,1,14.0
13443,10072.0,STRAWBERRY CHARLOTTE BAG,4,2348,25,2600,252,1,50.0
13444,10073.0,RED 3 PIECE RETROSPOT CUTLERY SET,2,450,25,2600,2150,1,50.0
13445,10074.0,BLUE 3 PIECE POLKADOT CUTLERY SET,4,1110,13,1400,290,1,26.0
13446,10075.0,SET/6 RED SPOTTY PAPER PLATES,2,130,4,500,370,1,8.0
13447,10076.0,LUNCH BAG RED RETROSPOT,6,209,4,500,291,1,8.0
13448,10077.0,STRAWBERRY LUNCH BOX WITH CUTLERY,7,723,24,2500,1777,1,48.0
13449,10078.0,LUNCH BOX WITH CUTLERY RETROSPOT ,7,142,6,700,558,1,12.0
13450,10079.0,PACK OF 72 RETROSPOT CAKE CASES,1,547,5,600,53,1,10.0
13451,10080.0,PACK OF 60 DINOSAUR CAKE CASES,3,447,4,500,53,1,8.0
13452,10081.0,PACK OF 60 PINK PAISLEY CAKE CASES,5,568,21,2200,1632,1,42.0
13453,10082.0,69 TEATIME FAIRY CAKE CASES,2,1169,19,2000,831,1,38.0
13454,10083.0,TOMATO CHARLIE+LOLA COASTER SET,1,809,15,1600,791,1,30.0
13455,10084.0,CHARLIE & LOLA WASTEPAPER BIN FLORA,7,121,1,200,79,1,2.0
13456,10085.0,RED CHARLIE+LOLA PERSONAL DOORSIGN,6,195,1,200,5,1,2.0
13457,10086.0,JUMBO STORAGE BAG SUKI,4,390,11,1200,810,1,22.0
13458,10087.0,JUMBO BAG PINK VINTAGE PAISLEY,10,132,9,1000,868,1,18.0
13459,10088.0,JAM MAKING SET PRINTED,2,214,2,300,86,1,4.0
13460,10089.0,RETROSPOT TEA SET CERAMIC 11 PC ,4,2061,24,2500,439,1,48.0
13461,10090.0,GIRLY PINK TOOL SET,6,340,3,400,60,1,6.0
13462,10091.0,JUMBO SHOPPER VINTAGE RED PAISLEY,1,896,9,1000,104,1,18.0
13463,10092.0,"AIRLINE LOUNGE,METAL SIGN",1,206,17,1800,1594,1,34.0
13464,10093.0,WHITE SPOT RED CERAMIC DRAWER KNOB,10,273,2,300,27,1,4.0
13465,10094.0,RED DRAWER KNOB ACRYLIC EDWARDIAN,9,638,23,2400,1762,1,46.0
13466,10095.0,CLEAR DRAWER KNOB ACRYLIC EDWARDIAN,3,482,5,600,118,1,10.0
13467,10096.0,PHOTO CLIP LINE,10,1445,15,1600,155,1,30.0
13468,10097.0,FELT EGG COSY CHICKEN,4,618,11,1200,582,1,22.0
13469,10098.0,PIGGY BANK RETROSPOT ,1,1409,25,2600,1191,1,50.0
13470,10099.0,SKULL SHOULDER BAG,3,101,1,200,99,1,2.0
13471,10100.0,YOU'RE CONFUSING ME METAL SIGN ,9,1967,25,2600,633,1,50.0
13472,10101.0,COOK WITH WINE METAL SIGN ,6,722,16,1700,978,1,32.0
13473,10102.0,GIN + TONIC DIET METAL SIGN,7,292,11,1200,908,1,22.0
13474,10103.0,YELLOW BREAKFAST CUP AND SAUCER,6,630,15,1600,970,1,30.0
13475,10104.0,PINK BREAKFAST CUP AND SAUCER ,10,1130,24,2500,1370,1,48.0
13476,10105.0,PAPER CHAIN KIT 50'S CHRISTMAS ,5,1143,21,2200,1057,1,42.0
13477,10106.0,PAPER CHAIN KIT RETROSPOT,7,570,5,600,30,1,10.0
13478,10107.0,SMALL HEART FLOWERS HOOK ,5,1280,17,1800,520,1,34.0
13479,10108.0,PHOTO CLIP LINE,7,260,12,1300,1040,1,24.0
13480,10109.0,TEA TIME DES TEA COSY,1,472,21,2200,1728,1,42.0
13481,10110.0,FELT EGG COSY WHITE RABBIT ,5,386,4,500,114,1,8.0
13482,10111.0,ZINC WILLIE WINKIE  CANDLE STICK,5,1052,15,1600,548,1,30.0
13483,10112.0,CERAMIC CHERRY CAKE MONEY BANK,8,229,24,2500,2271,1,48.0
13484,10113.0,RETROSPOT LARGE MILK JUG,6,1280,14,1500,220,1,28.0
13485,10114.0,SET OF 6 FUNKY BEAKERS,1,1690,24,2500,810,1,48.0
13486,10115.0,EDWARDIAN PARASOL BLACK,1,129,4,500,371,1,8.0
13487,10116.0,EDWARDIAN PARASOL NATURAL,6,569,5,600,31,1,10.0
13488,10117.0,CERAMIC STRAWBERRY CAKE MONEY BANK,2,645,8,900,255,1,16.0
13489,10118.0,BLUE OWL SOFT TOY,1,100,0,100,0,1,0.0
13490,10119.0,BALLOON ART MAKE YOUR OWN FLOWERS,7,583,9,1000,417,1,18.0
13491,10120.0,RED TOADSTOOL LED NIGHT LIGHT,9,236,10,1100,864,1,20.0
13492,10121.0,GLASS CLOCHE SMALL,10,909,21,2200,1291,1,42.0
13493,10122.0,GUMBALL MONOCHROME COAT RACK,3,932,19,2000,1068,1,38.0
13494,10123.0,DOORMAT FANCY FONT HOME SWEET HOME,7,549,13,1400,851,1,26.0
13495,10124.0,Discount,8,1303,22,2300,997,1,44.0
13496,10125.0,INFLATABLE POLITICAL GLOBE ,2,519,12,1300,781,1,24.0
13497,10126.0,VINTAGE SNAKES & LADDERS,7,861,15,1600,739,1,30.0
13498,10127.0,CHOCOLATE CALCULATOR,6,440,17,1800,1360,1,34.0
13499,10128.0,JUMBO SHOPPER VINTAGE RED PAISLEY,9,1436,19,2000,564,1,38.0
13500,10129.0,RECYCLING BAG RETROSPOT ,6,218,2,300,82,1,4.0
13501,10130.0,TOY TIDY PINK POLKADOT,1,197,6,700,503,1,12.0
13502,10131.0,ANTIQUE GLASS DRESSING TABLE POT,10,1154,11,1200,46,1,22.0
13503,10132.0,ALARM CLOCK BAKELIKE GREEN,3,442,4,500,58,1,8.0
13504,10133.0,IVORY GIANT GARDEN THERMOMETER,6,1453,20,2100,647,1,40.0
13505,10134.0,12 TIER CAKE TIN GREEN AND CREAM,7,399,7,800,401,1,14.0
13506,10135.0,12 TIER CAKE TIN RED AND CREAM,9,598,6,700,102,1,12.0
13507,10136.0,SET 3 WICKER OVAL BASKETS W LIDS,8,157,1,200,43,1,2.0
13508,10137.0,SET OF 3 COLOURED  FLYING DUCKS,4,1348,17,1800,452,1,34.0
13509,10138.0,WOOD BLACK BOARD ANT WHITE FINISH,10,784,7,800,16,1,14.0
13510,10139.0,COLOUR GLASS T-LIGHT HOLDER HANGING,6,1486,25,2600,1114,1,50.0
13511,10140.0,HANGING METAL HEART LANTERN,4,661,21,2200,1539,1,42.0
13512,10141.0,HANGING MEDINA LANTERN SMALL,3,1582,23,2400,818,1,46.0
13513,10142.0,NATURAL SLATE HEART CHALKBOARD ,10,947,20,2100,1153,1,40.0
13514,10143.0,HEART OF WICKER SMALL,9,202,5,600,398,1,10.0
13515,10144.0,HEART OF WICKER LARGE,5,683,10,1100,417,1,20.0
13516,10145.0,WHITE LOVEBIRD LANTERN,2,195,8,900,705,1,16.0
13517,10146.0,CLASSIC METAL BIRDCAGE PLANT HOLDER,3,1611,18,1900,289,1,36.0
13518,10147.0,CREAM HEART CARD HOLDER,2,545,6,700,155,1,12.0
13519,10148.0,ENAMEL FLOWER JUG CREAM,3,100,0,100,0,1,0.0
13520,10149.0,ENAMEL FIRE BUCKET CREAM,4,1770,21,2200,430,1,42.0
13521,10150.0,ENAMEL BREAD BIN CREAM,9,145,1,200,55,1,2.0
13522,10151.0,SET 3 WICKER OVAL BASKETS W LIDS,10,137,2,300,163,1,4.0
13523,10152.0,JAM MAKING SET PRINTED,10,173,16,1700,1527,1,32.0
13524,10153.0,JAM MAKING SET WITH JARS,1,415,13,1400,985,1,26.0
13525,10154.0,JUMBO BAG DOLLY GIRL DESIGN,9,221,10,1100,879,1,20.0
13526,10155.0,TRADITIONAL CHRISTMAS RIBBONS,2,345,14,1500,1155,1,28.0
13527,10156.0,ORGANISER WOOD ANTIQUE WHITE ,1,760,17,1800,1040,1,34.0
13528,10157.0,LUNCH BAG DOLLY GIRL DESIGN,8,348,6,700,352,1,12.0
13529,10158.0,WHITE WIRE EGG HOLDER,3,1095,10,1100,5,1,20.0
13530,10159.0,JUMBO  BAG BAROQUE BLACK WHITE,2,1980,20,2100,120,1,40.0
13531,10160.0,JUMBO BAG RED RETROSPOT,9,406,17,1800,1394,1,34.0
13532,10161.0,CHILLI LIGHTS,1,591,7,800,209,1,14.0
13533,10162.0,LIGHT GARLAND BUTTERFILES PINK,6,964,15,1600,636,1,30.0
13534,10163.0,WOODEN OWLS LIGHT GARLAND ,8,708,10,1100,392,1,20.0
13535,10164.0,FAIRY TALE COTTAGE NIGHTLIGHT,3,346,4,500,154,1,8.0
13536,10165.0,RED TOADSTOOL LED NIGHT LIGHT,2,1014,23,2400,1386,1,46.0
13537,10166.0,HOME BUILDING BLOCK WORD,3,178,11,1200,1022,1,22.0
13538,10167.0,LOVE BUILDING BLOCK WORD,1,303,18,1900,1597,1,36.0
13539,10168.0,DOORMAT FANCY FONT HOME SWEET HOME,5,932,10,1100,168,1,20.0
13540,10169.0,HOME SMALL WOOD LETTERS,6,279,20,2100,1821,1,40.0
13541,10170.0,GINGHAM HEART  DOORSTOP RED,9,100,0,100,0,1,0.0
13542,10171.0,FIVE HEART HANGING DECORATION,8,670,24,2500,1830,1,48.0
13543,10172.0,HANGING METAL HEART LANTERN,9,957,17,1800,843,1,34.0
13544,10173.0,ASSORTED BOTTLE TOP  MAGNETS ,2,531,5,600,69,1,10.0
13545,10174.0,FRIDGE MAGNETS US DINER ASSORTED,9,141,1,200,59,1,2.0
13546,10175.0,HOMEMADE JAM SCENTED CANDLES,8,732,7,800,68,1,14.0
13547,10176.0,FRIDGE MAGNETS LES ENFANTS ASSORTED,7,220,6,700,480,1,12.0
13548,10177.0,ROSE CARAVAN DOORSTOP,8,193,6,700,507,1,12.0
13549,10178.0,HEART OF WICKER SMALL,7,1918,20,2100,182,1,40.0
13550,10179.0,14 HOOK HANGER MAGIC TOADSTOOL,9,1062,24,2500,1438,1,48.0
13551,10180.0,CHRISTMAS LIGHTS 10 REINDEER,9,108,1,200,92,1,2.0
13552,10181.0,VINTAGE UNION JACK CUSHION COVER,4,1205,15,1600,395,1,30.0
13553,10182.0,VINTAGE HEADS AND TAILS CARD GAME ,3,316,16,1700,1384,1,32.0
13554,10183.0,SET OF 3 COLOURED  FLYING DUCKS,3,382,11,1200,818,1,22.0
13555,10184.0,SET OF 3 GOLD FLYING DUCKS,2,628,24,2500,1872,1,48.0
13556,10185.0,RED RETROSPOT UMBRELLA,4,252,8,900,648,1,16.0
13557,10186.0,BLACK/BLUE POLKADOT UMBRELLA,7,1487,15,1600,113,1,30.0
13558,10187.0,RED DINER WALL CLOCK,7,273,5,600,327,1,10.0
13559,10188.0,ALARM CLOCK BAKELIKE GREEN,4,181,15,1600,1419,1,30.0
13560,10189.0,ALARM CLOCK BAKELIKE RED ,9,904,13,1400,496,1,26.0
13561,10190.0,BLUE DINER WALL CLOCK,4,151,25,2600,2449,1,50.0
13562,10191.0,IVORY DINER WALL CLOCK,4,107,8,900,793,1,16.0
13563,10192.0,LARGE HEART MEASURING SPOONS,2,100,0,100,0,1,0.0
13564,10193.0,SMALL HEART MEASURING SPOONS,9,100,0,100,0,1,0.0
13565,10194.0,CHRISTMAS LIGHTS 10 REINDEER,9,225,12,1300,1075,1,24.0
13566,10195.0,JAM MAKING SET WITH JARS,2,393,3,400,7,1,6.0
13567,10196.0,JAM MAKING SET PRINTED,9,123,1,200,77,1,2.0
13568,10197.0,JAM JAR WITH PINK LID,8,216,3,400,184,1,6.0
13569,10198.0,JAM JAR WITH GREEN LID,10,646,8,900,254,1,16.0
13570,10199.0,ROSE COTTAGE KEEPSAKE BOX ,10,1276,12,1300,24,1,24.0
13571,10200.0,HANGING HEART ZINC T-LIGHT HOLDER,2,547,12,1300,753,1,24.0
13572,10201.0,PAPER CHAIN KIT VINTAGE CHRISTMAS,8,135,3,400,265,1,6.0
13573,10202.0,DISCO BALL CHRISTMAS DECORATION,3,1312,16,1700,388,1,32.0
13574,10203.0,WHITE HANGING HEART T-LIGHT HOLDER,2,328,3,400,72,1,6.0
13575,10204.0,SMALL POPCORN HOLDER,7,746,20,2100,1354,1,40.0
13576,10205.0,LARGE POPCORN HOLDER ,2,699,7,800,101,1,14.0
13577,10206.0,RETROSPOT LARGE MILK JUG,6,1033,11,1200,167,1,22.0
13578,10207.0,SET/20 RED RETROSPOT PAPER NAPKINS ,4,1112,14,1500,388,1,28.0
13579,10208.0,SET/6 RED SPOTTY PAPER PLATES,5,728,24,2500,1772,1,48.0
13580,10209.0,SET/6 RED SPOTTY PAPER CUPS,6,1927,20,2100,173,1,40.0
13581,10210.0,POLKADOT RAIN HAT ,8,489,23,2400,1911,1,46.0
13582,10211.0,DELUXE SEWING KIT ,5,175,1,200,25,1,2.0
13583,10212.0,RETROSPOT HEART HOT WATER BOTTLE,8,768,18,1900,1132,1,36.0
13584,10213.0,KNITTED UNION FLAG HOT WATER BOTTLE,9,2129,21,2200,71,1,42.0
13585,10214.0,ENGLISH ROSE HOT WATER BOTTLE,4,1307,15,1600,293,1,30.0
13586,10215.0,PHOTO CUBE,1,1209,25,2600,1391,1,50.0
13587,10216.0,HOMEMADE JAM SCENTED CANDLES,1,225,2,300,75,1,4.0
13588,10217.0,JUMBO BAG RED RETROSPOT,9,443,9,1000,557,1,18.0
13589,10218.0,PLASTERS IN TIN CIRCUS PARADE ,8,1829,20,2100,271,1,40.0
13590,10219.0,PACK OF 12 PINK PAISLEY TISSUES ,8,129,5,600,471,1,10.0
13591,10220.0,PACK OF 12 BLUE PAISLEY TISSUES ,6,484,11,1200,716,1,22.0
13592,10221.0,PACK OF 12 RED RETROSPOT TISSUES ,7,962,21,2200,1238,1,42.0
13593,10222.0,CHICK GREY HOT WATER BOTTLE,1,188,4,500,312,1,8.0
13594,10223.0,PLASTERS IN TIN VINTAGE PAISLEY ,8,763,16,1700,937,1,32.0
13595,10224.0,PLASTERS IN TIN SKULLS,9,190,9,1000,810,1,18.0
13596,10225.0,12 STRIPEY MICE FELTCRAFT,8,556,24,2500,1944,1,48.0
13597,10226.0,SET OF 6 SOLDIER SKITTLES,8,100,0,100,0,1,0.0
13598,10227.0,TRADITIONAL WOODEN SKIPPING ROPE,5,1181,12,1300,119,1,24.0
13599,10228.0,WOODEN BOX OF DOMINOES,1,1791,24,2500,709,1,48.0
13600,10229.0,RUSTIC  SEVENTEEN DRAWER SIDEBOARD,7,161,17,1800,1639,1,34.0
13601,10230.0,PARTY CONES CARNIVAL ASSORTED,2,829,13,1400,571,1,26.0
13602,10231.0,PARTY CONES CANDY ASSORTED,1,882,14,1500,618,1,28.0
13603,10232.0,PICNIC BASKET WICKER SMALL,1,1291,25,2600,1309,1,50.0
13604,10233.0,ASSORTED COLOUR BIRD ORNAMENT,2,181,2,300,119,1,4.0
13605,10234.0,STAR DECORATION PAINTED ZINC ,3,322,6,700,378,1,12.0
13606,10235.0,RETROSPOT LAMP,8,704,7,800,96,1,14.0
13607,10236.0,"FANCY FONT BIRTHDAY CARD, ",7,262,5,600,338,1,10.0
13608,10237.0,HAND WARMER UNION JACK,5,789,23,2400,1611,1,46.0
13609,10238.0,HAND WARMER SCOTTY DOG DESIGN,7,927,13,1400,473,1,26.0
13610,10239.0,HAND WARMER OWL DESIGN,2,2176,25,2600,424,1,50.0
13611,10240.0,HAND WARMER RED RETROSPOT,8,2154,24,2500,346,1,48.0
13612,10241.0,RETROSPOT HEART HOT WATER BOTTLE,5,1430,17,1800,370,1,34.0
13613,10242.0,DOG BOWL CHASING BALL DESIGN,6,233,7,800,567,1,14.0
13614,10243.0,CLOTHES PEGS RETROSPOT PACK 33,4,1116,22,2300,1184,1,44.0
13615,10244.0,HAND OVER THE CHOCOLATE   SIGN ,1,285,4,500,215,1,8.0
13616,10245.0,WHITE HANGING HEART T-LIGHT HOLDER,1,409,4,500,91,1,8.0
13617,10246.0,TRAVEL SEWING KIT,8,432,22,2300,1868,1,44.0
13618,10247.0,BLACK HEART CARD HOLDER,2,411,9,1000,589,1,18.0
13619,10248.0,ASSORTED COLOUR BIRD ORNAMENT,9,273,9,1000,727,1,18.0
13620,10249.0,PACK OF 60 PINK PAISLEY CAKE CASES,9,433,22,2300,1867,1,44.0
13621,10250.0,69 TEATIME FAIRY CAKE CASES,6,337,5,600,263,1,10.0
13622,10251.0,PACK OF 72 RETROSPOT CAKE CASES,7,1481,18,1900,419,1,36.0
13623,10252.0,CHICK GREY HOT WATER BOTTLE,5,424,13,1400,976,1,26.0
13624,10253.0,SMALL GLASS HEART TRINKET POT,1,579,5,600,21,1,10.0
13625,10254.0,ALARM CLOCK BAKELIKE IVORY,4,142,3,400,258,1,6.0
13626,10255.0,ALARM CLOCK BAKELIKE RED ,2,1159,23,2400,1241,1,46.0
13627,10256.0,ALARM CLOCK BAKELIKE ORANGE,1,416,21,2200,1784,1,42.0
13628,10257.0,ALARM CLOCK BAKELIKE GREEN,8,823,16,1700,877,1,32.0
13629,10258.0,HOT WATER BOTTLE TEA AND SYMPATHY,7,184,6,700,516,1,12.0
13630,10259.0,HAND WARMER BIRD DESIGN,1,1529,18,1900,371,1,36.0
13631,10260.0,HAND WARMER SCOTTY DOG DESIGN,1,515,19,2000,1485,1,38.0
13632,10261.0,WHITE HANGING HEART T-LIGHT HOLDER,7,224,3,400,176,1,6.0
13633,10262.0,WHITE METAL LANTERN,8,402,4,500,98,1,8.0
13634,10263.0,CREAM CUPID HEARTS COAT HANGER,6,742,8,900,158,1,16.0
13635,10264.0,EDWARDIAN PARASOL BLACK,4,683,23,2400,1717,1,46.0
13636,10265.0,EDWARDIAN PARASOL RED,3,471,5,600,129,1,10.0
13637,10266.0,RETRO COFFEE MUGS ASSORTED,2,1750,22,2300,550,1,44.0
13638,10267.0,SAVE THE PLANET MUG,8,553,6,700,147,1,12.0
13639,10268.0,VINTAGE BILLBOARD DRINK ME MUG,5,1000,9,1000,0,1,18.0
13640,10269.0,VINTAGE BILLBOARD LOVE/HATE MUG,9,1827,20,2100,273,1,40.0
13641,10270.0,WOOD 2 DRAWER CABINET WHITE FINISH,9,449,8,900,451,1,16.0
13642,10271.0,WOOD S/3 CABINET ANT WHITE FINISH,2,748,9,1000,252,1,18.0
13643,10272.0,WOODEN PICTURE FRAME WHITE FINISH,1,236,2,300,64,1,4.0
13644,10273.0,WOODEN FRAME ANTIQUE WHITE ,7,132,1,200,68,1,2.0
13645,10274.0,KNITTED UNION FLAG HOT WATER BOTTLE,10,650,14,1500,850,1,28.0
13646,10275.0,RED WOOLLY HOTTIE WHITE HEART.,4,631,23,2400,1769,1,46.0
13647,10276.0,SET 7 BABUSHKA NESTING BOXES,4,464,6,700,236,1,12.0
13648,10277.0,IVORY EMBROIDERED QUILT ,9,100,0,100,0,1,0.0
13649,10278.0,GLASS STAR FROSTED T-LIGHT HOLDER,5,456,5,600,144,1,10.0
13650,10279.0,SET OF 3 BLACK FLYING DUCKS,5,678,6,700,22,1,12.0
13651,10280.0,SET OF 3 COLOURED  FLYING DUCKS,1,183,14,1500,1317,1,28.0
13652,10281.0,PACK OF 12 RED RETROSPOT TISSUES ,6,545,11,1200,655,1,22.0
13653,10282.0,RED RETROSPOT MUG,4,831,10,1100,269,1,20.0
13654,10283.0,BABUSHKA LIGHTS STRING OF 19,5,339,10,1100,761,1,20.0
13655,10284.0,PIGGY BANK RETROSPOT ,2,134,3,400,266,1,6.0
13656,10285.0,SET 7 BABUSHKA NESTING BOXES,6,100,0,100,0,1,0.0
13657,10286.0,DOORMAT FAIRY CAKE,9,2482,25,2600,118,1,50.0
13658,10287.0,HAND WARMER RED RETROSPOT,9,1646,24,2500,854,1,48.0
13659,10288.0,HAND WARMER SCOTTY DOG DESIGN,1,120,11,1200,1080,1,22.0
13660,10289.0,HAND WARMER OWL DESIGN,5,324,8,900,576,1,16.0
13661,10290.0,STRAWBERRY CERAMIC TRINKET BOX,5,1408,18,1900,492,1,36.0
13662,10291.0,PINK DOUGHNUT TRINKET POT ,8,189,4,500,311,1,8.0
13663,10292.0,SILK PURSE BABUSHKA PINK,9,1413,23,2400,987,1,46.0
13664,10293.0,HOT WATER BOTTLE TEA AND SYMPATHY,10,334,3,400,66,1,6.0
13665,10294.0,HOT WATER BOTTLE I AM SO POORLY,9,541,23,2400,1859,1,46.0
13666,10295.0,CHOCOLATE HOT WATER BOTTLE,9,557,8,900,343,1,16.0
13667,10296.0,WHITE SKULL HOT WATER BOTTLE ,9,279,24,2500,2221,1,48.0
13668,10297.0,SCOTTIE DOG HOT WATER BOTTLE,10,567,7,800,233,1,14.0
13669,10298.0,HAND WARMER RED POLKA DOT,8,1086,15,1600,514,1,30.0
13670,10299.0,HAND WARMER UNION JACK,2,380,9,1000,620,1,18.0
13671,10300.0,HOMEMADE JAM SCENTED CANDLES,1,822,21,2200,1378,1,42.0
13672,10301.0,BIRD HOUSE HOT WATER BOTTLE,6,805,20,2100,1295,1,40.0
13673,10302.0,BOUDOIR SQUARE TISSUE BOX,6,911,21,2200,1289,1,42.0
13674,10303.0,SKULLS SQUARE TISSUE BOX,3,1165,20,2100,935,1,40.0
13675,10304.0,PHOTO FRAME CORNICE,5,213,3,400,187,1,6.0
13676,10305.0,SILK PURSE BABUSHKA RED,2,430,10,1100,670,1,20.0
13677,10306.0,PICTURE DOMINOES,8,100,0,100,0,1,0.0
13678,10307.0,S/6 SEW ON CROCHET FLOWERS,7,610,11,1200,590,1,22.0
13679,10308.0,SCANDINAVIAN REDS RIBBONS,5,234,2,300,66,1,4.0
13680,10309.0,BALLOONS  WRITING SET ,10,477,17,1800,1323,1,34.0
13681,10310.0,JAM MAKING SET PRINTED,2,1299,18,1900,601,1,36.0
13682,10311.0,LAVENDER INCENSE IN TIN,3,1410,15,1600,190,1,30.0
13683,10312.0,TV DINNER TRAY VINTAGE PAISLEY,7,419,20,2100,1681,1,40.0
13684,10313.0,SET OF 4 ENGLISH ROSE PLACEMATS,6,393,22,2300,1907,1,44.0
13685,10314.0,SET OF 4 ENGLISH ROSE COASTERS,3,1520,17,1800,280,1,34.0
13686,10315.0,TRIPLE PHOTO FRAME CORNICE ,7,282,18,1900,1618,1,36.0
13687,10316.0,FAMILY PHOTO FRAME CORNICE,4,534,20,2100,1566,1,40.0
13688,10317.0,MIRRORED DISCO BALL ,6,330,8,900,570,1,16.0
13689,10318.0,DISCO BALL ROTATOR BATTERY OPERATED,1,1379,23,2400,1021,1,46.0
13690,10319.0,SILVER LOOKING MIRROR,5,476,5,600,124,1,10.0
13691,10320.0,LADIES & GENTLEMEN METAL SIGN,1,700,22,2300,1600,1,44.0
13692,10321.0,METAL SIGN HER DINNER IS SERVED ,6,1372,15,1600,228,1,30.0
13693,10322.0,YOU'RE CONFUSING ME METAL SIGN ,1,630,8,900,270,1,16.0
13694,10323.0,DOORMAT TOPIARY,6,1847,19,2000,153,1,38.0
13695,10324.0,BATHROOM METAL SIGN,8,487,5,600,113,1,10.0
13696,10325.0,KITCHEN METAL SIGN,1,262,3,400,138,1,6.0
13697,10326.0,TOILET METAL SIGN,3,1528,19,2000,472,1,38.0
13698,10327.0,METAL SIGN TAKE IT OR LEAVE IT ,1,276,19,2000,1724,1,38.0
13699,10328.0,I'M ON HOLIDAY METAL SIGN,10,2488,25,2600,112,1,50.0
13700,10329.0,GROW YOUR OWN BASIL IN ENAMEL MUG,6,913,10,1100,187,1,20.0
13701,10330.0,SET/10 PINK POLKADOT PARTY CANDLES,5,221,4,500,279,1,8.0
13702,10331.0,SET 20 NAPKINS FAIRY CAKES DESIGN ,3,1190,17,1800,610,1,34.0
13703,10332.0,69 TEATIME FAIRY CAKE CASES,1,1057,22,2300,1243,1,44.0
13704,10333.0,SET OF 6 T-LIGHTS SNOWMEN,1,593,8,900,307,1,16.0
13705,10334.0,SET OF 6 T-LIGHTS SANTA,3,196,9,1000,804,1,18.0
13706,10335.0,SET OF 9 HEART SHAPED BALLOONS,3,1541,17,1800,259,1,34.0
13707,10336.0,SANDWICH BATH SPONGE,6,1174,13,1400,226,1,26.0
13708,10337.0,APPLE BATH SPONGE,1,137,1,200,63,1,2.0
13709,10338.0,STRAWBERRY BATH SPONGE ,4,757,16,1700,943,1,32.0
13710,10339.0,BLACK PIRATE TREASURE CHEST,4,2401,25,2600,199,1,50.0
13711,10340.0,STAR PORTABLE TABLE LIGHT ,4,173,25,2600,2427,1,50.0
13712,10341.0,SNOWFLAKE PORTABLE TABLE LIGHT ,4,924,21,2200,1276,1,42.0
13713,10342.0,PINK OVAL JEWELLED MIRROR,1,703,12,1300,597,1,24.0
13714,10343.0,RETROSPOT CIGAR BOX MATCHES ,9,476,11,1200,724,1,22.0
13715,10344.0,COSY HOUR GIANT TUBE MATCHES,7,1416,14,1500,84,1,28.0
13716,10345.0,JAZZ HEARTS PURSE NOTEBOOK,4,1143,13,1400,257,1,26.0
13717,10346.0,LUNCH BAG DOLLY GIRL DESIGN,6,100,0,100,0,1,0.0
13718,10347.0,WHITE HANGING HEART T-LIGHT HOLDER,4,1933,23,2400,467,1,46.0
13719,10348.0,CANDLEHOLDER PINK HANGING HEART,3,1780,21,2200,420,1,42.0
13720,10349.0,WOOD 2 DRAWER CABINET WHITE FINISH,1,344,9,1000,656,1,18.0
13721,10350.0,ASSORTED COLOUR MINI CASES,4,470,7,800,330,1,14.0
13722,10351.0,LUNCH BAG RED RETROSPOT,5,794,8,900,106,1,16.0
13723,10352.0,LUNCH BAG SPACEBOY DESIGN ,4,1024,15,1600,576,1,30.0
13724,10353.0,LUNCH BAG WOODLAND,2,239,2,300,61,1,4.0
13725,10354.0,LUNCH BAG PINK POLKADOT,3,106,15,1600,1494,1,30.0
13726,10355.0,GUMBALL COAT RACK,10,946,14,1500,554,1,28.0
13727,10356.0,BLUE NEW BAROQUE CANDLESTICK CANDLE,8,330,4,500,170,1,8.0
13728,10357.0,PINK NEW BAROQUECANDLESTICK CANDLE,4,693,7,800,107,1,14.0
13729,10358.0,FAIRY CAKE FLANNEL ASSORTED COLOUR,1,686,8,900,214,1,16.0
13730,10359.0,BREAD BIN DINER STYLE PINK,7,207,3,400,193,1,6.0
13731,10360.0,JUMBO BAG CHARLIE AND LOLA TOYS,7,420,7,800,380,1,14.0
13732,10361.0,TEA TIME TABLE CLOTH,5,232,2,300,68,1,4.0
13733,10362.0,ENGLISH ROSE HOT WATER BOTTLE,9,144,9,1000,856,1,18.0
13734,10363.0,ENAMEL FIRE BUCKET CREAM,9,100,0,100,0,1,0.0
13735,10364.0,PICNIC BASKET WICKER SMALL,2,453,5,600,147,1,10.0
13736,10365.0,PAPER CHAIN KIT 50'S CHRISTMAS ,3,314,5,600,286,1,10.0
13737,10366.0,PAPER CHAIN KIT VINTAGE CHRISTMAS,1,196,1,200,4,1,2.0
13738,10367.0,HOT WATER BOTTLE BABUSHKA ,10,2038,20,2100,62,1,40.0
13739,10368.0,HAND WARMER BIRD DESIGN,9,1076,21,2200,1124,1,42.0
13740,10369.0,POSTAGE,5,1299,16,1700,401,1,32.0
13741,10370.0,HEART IVORY TRELLIS SMALL,7,1020,12,1300,280,1,24.0
13742,10371.0,CLEAR DRAWER KNOB ACRYLIC EDWARDIAN,10,2422,24,2500,78,1,48.0
13743,10372.0,PINK DRAWER KNOB ACRYLIC EDWARDIAN,6,546,13,1400,854,1,26.0
13744,10373.0,GREEN DRAWER KNOB ACRYLIC EDWARDIAN,7,175,1,200,25,1,2.0
13745,10374.0,BLUE DRAWER KNOB ACRYLIC EDWARDIAN,10,594,20,2100,1506,1,40.0
13746,10375.0,HEART OF WICKER SMALL,4,1142,24,2500,1358,1,48.0
13747,10376.0,SMALL POPCORN HOLDER,10,637,6,700,63,1,12.0
13748,10377.0,SET 6 FOOTBALL CELEBRATION CANDLES,2,942,23,2400,1458,1,46.0
13749,10378.0,SET OF 6 GIRLS CELEBRATION CANDLES,7,425,10,1100,675,1,20.0
13750,10379.0,ROMANTIC PINKS RIBBONS ,1,503,5,600,97,1,10.0
13751,10380.0,BRIGHT BLUES RIBBONS ,5,605,11,1200,595,1,22.0
13752,10381.0,SCANDINAVIAN REDS RIBBONS,8,1708,25,2600,892,1,50.0
13753,10382.0,CHOCOLATE BOX RIBBONS ,1,2353,25,2600,247,1,50.0
13754,10383.0,PARTY INVITES FOOTBALL,3,565,7,800,235,1,14.0
13755,10384.0,PARTY INVITES JAZZ HEARTS,7,168,6,700,532,1,12.0
13756,10385.0,PARTY INVITES SPACEMAN,8,207,9,1000,793,1,18.0
13757,10386.0,SET OF 3 BUTTERFLY COOKIE CUTTERS,6,100,0,100,0,1,0.0
13758,10387.0,SET OF 3 HEART COOKIE CUTTERS,1,905,10,1100,195,1,20.0
13759,10388.0,12 PIECE SPACEBOY COOKIE CUTTER SET,1,273,5,600,327,1,10.0
13760,10389.0,PACK OF 72 SKULL CAKE CASES,6,479,9,1000,521,1,18.0
13761,10390.0,PACK OF 60 SPACEBOY CAKE CASES,2,364,4,500,136,1,8.0
13762,10391.0,PACK OF 72 RETROSPOT CAKE CASES,4,939,10,1100,161,1,20.0
13763,10392.0,81 SWEETHEART FAIRY CAKE CASES,10,846,8,900,54,1,16.0
13764,10393.0,PACK OF 60 DINOSAUR CAKE CASES,10,306,5,600,294,1,10.0
13765,10394.0,LUNCH BAG SUKI  DESIGN ,10,415,4,500,85,1,8.0
13766,10395.0,LUNCH BAG CARS BLUE,7,207,3,400,193,1,6.0
13767,10396.0,LUNCH BAG  BLACK SKULL.,5,777,10,1100,323,1,20.0
13768,10397.0,HEART IVORY TRELLIS LARGE,7,163,8,900,737,1,16.0
13769,10398.0,SET/5 RED RETROSPOT LID GLASS BOWLS,5,899,17,1800,901,1,34.0
13770,10399.0,WHITE HANGING HEART T-LIGHT HOLDER,9,281,9,1000,719,1,18.0
13771,10400.0,WHITE METAL LANTERN,7,169,8,900,731,1,16.0
13772,10401.0,CREAM CUPID HEARTS COAT HANGER,3,794,9,1000,206,1,18.0
13773,10402.0,EDWARDIAN PARASOL RED,3,981,21,2200,1219,1,42.0
13774,10403.0,RETRO COFFEE MUGS ASSORTED,1,422,7,800,378,1,14.0
13775,10404.0,SAVE THE PLANET MUG,2,1182,11,1200,18,1,22.0
13776,10405.0,VINTAGE BILLBOARD DRINK ME MUG,8,966,23,2400,1434,1,46.0
13777,10406.0,VINTAGE BILLBOARD LOVE/HATE MUG,10,303,10,1100,797,1,20.0
13778,10407.0,WOOD 2 DRAWER CABINET WHITE FINISH,10,197,3,400,203,1,6.0
13779,10408.0,WOOD S/3 CABINET ANT WHITE FINISH,3,580,5,600,20,1,10.0
13780,10409.0,WOODEN PICTURE FRAME WHITE FINISH,9,325,8,900,575,1,16.0
13781,10410.0,WOODEN FRAME ANTIQUE WHITE ,4,1497,14,1500,3,1,28.0
13782,10411.0,KNITTED UNION FLAG HOT WATER BOTTLE,10,1532,17,1800,268,1,34.0
13783,10412.0,RED WOOLLY HOTTIE WHITE HEART.,4,102,3,400,298,1,6.0
13784,10413.0,SET 7 BABUSHKA NESTING BOXES,3,161,1,200,39,1,2.0
13785,10414.0,IVORY EMBROIDERED QUILT ,1,916,17,1800,884,1,34.0
13786,10415.0,GLASS STAR FROSTED T-LIGHT HOLDER,4,429,25,2600,2171,1,50.0
13787,10416.0,HAND WARMER RED POLKA DOT,3,100,0,100,0,1,0.0
13788,10417.0,HAND WARMER UNION JACK,9,602,22,2300,1698,1,44.0
13789,10418.0,MAGIC DRAWING SLATE DINOSAUR,6,2210,24,2500,290,1,48.0
13790,10419.0,MAGIC DRAWING SLATE BAKE A CAKE ,3,1214,15,1600,386,1,30.0
13791,10420.0,21 PENCILS TALL TUBE SKULLS,2,190,1,200,10,1,2.0
13792,10421.0,CHOCOLATE CALCULATOR,5,161,9,1000,839,1,18.0
13793,10422.0,RED  HARMONICA IN BOX ,5,447,12,1300,853,1,24.0
13794,10423.0,BLUE HARMONICA IN BOX ,9,297,5,600,303,1,10.0
13795,10424.0,SKULLS  WATER TRANSFER TATTOOS ,4,467,6,700,233,1,12.0
13796,10425.0,PACK 3 BOXES BIRD PANNETONE ,10,221,2,300,79,1,4.0
13797,10426.0,HOT WATER BOTTLE TEA AND SYMPATHY,3,2372,25,2600,228,1,50.0
13798,10427.0,RED WOOLLY HOTTIE WHITE HEART.,3,1000,25,2600,1600,1,50.0
13799,10428.0,WHITE SKULL HOT WATER BOTTLE ,3,468,7,800,332,1,14.0
13800,10429.0,12 PIECE SPACEBOY COOKIE CUTTER SET,6,1528,22,2300,772,1,44.0
13801,10430.0,SET OF 20 KIDS COOKIE CUTTERS,1,546,6,700,154,1,12.0
13802,10431.0,19 COLOUR SPACEBOY PEN,5,261,22,2300,2039,1,44.0
13803,10432.0,VICTORIAN GLASS HANGING T-LIGHT,5,653,19,2000,1347,1,38.0
13804,10433.0,SINGLE HEART ZINC T-LIGHT HOLDER,9,1033,12,1300,267,1,24.0
13805,10434.0,RED HANGING HEART T-LIGHT HOLDER,4,1059,12,1300,241,1,24.0
13806,10435.0,HANGING METAL STAR LANTERN,8,380,19,2000,1620,1,38.0
13807,10436.0,SILVER HANGING T-LIGHT HOLDER,1,1648,20,2100,452,1,40.0
13808,10437.0,DOORMAT RED RETROSPOT,7,573,8,900,327,1,16.0
13809,10438.0,DOORMAT HEARTS,9,1905,24,2500,595,1,48.0
13810,10439.0,NATURAL SLATE RECTANGLE CHALKBOARD,4,100,0,100,0,1,0.0
13811,10440.0,LOVEBIRD HANGING DECORATION WHITE ,7,750,16,1700,950,1,32.0
13812,10441.0,ASSORTED COLOUR BIRD ORNAMENT,4,103,1,200,97,1,2.0
13813,10442.0,HOME BUILDING BLOCK WORD,6,1122,22,2300,1178,1,44.0
13814,10443.0,LOVE BUILDING BLOCK WORD,2,260,12,1300,1040,1,24.0
13815,10444.0,PHOTO FRAME CORNICE,2,964,16,1700,736,1,32.0
13816,10445.0,PENS ASSORTED FUNNY FACE,1,953,14,1500,547,1,28.0
13817,10446.0,CARD CIRCUS PARADE,1,495,5,600,105,1,10.0
13818,10447.0,WRAP COWBOYS  ,7,1365,19,2000,635,1,38.0
13819,10448.0,AIRLINE BAG VINTAGE TOKYO 87,1,1055,20,2100,1045,1,40.0
13820,10449.0,RED RETROSPOT UMBRELLA,2,653,14,1500,847,1,28.0
13821,10450.0,BLACK/BLUE POLKADOT UMBRELLA,10,289,14,1500,1211,1,28.0
13822,10451.0,RED 3 PIECE RETROSPOT CUTLERY SET,9,998,12,1300,302,1,24.0
13823,10452.0,PACK OF 72 RETROSPOT CAKE CASES,4,524,6,700,176,1,12.0
13824,10453.0,SET OF 72 RETROSPOT PAPER  DOILIES,3,340,10,1100,760,1,20.0
13825,10454.0,BLUE COAT RACK PARIS FASHION,7,247,4,500,253,1,8.0
13826,10455.0,PLASTERS IN TIN SKULLS,6,1748,22,2300,552,1,44.0
13827,10456.0,SLEEPING CAT ERASERS,10,484,14,1500,1016,1,28.0
13828,10457.0,CARD BIRTHDAY COWBOY,7,1024,14,1500,476,1,28.0
13829,10458.0,PACK 3 BOXES CHRISTMAS PANNETONE,10,453,4,500,47,1,8.0
13830,10459.0,ROTATING SILVER ANGELS T-LIGHT HLDR,4,121,13,1400,1279,1,26.0
13831,10460.0,COSY HOUR GIANT TUBE MATCHES,1,205,4,500,295,1,8.0
13832,10461.0,RIBBON REEL MAKING SNOWMEN ,7,773,18,1900,1127,1,36.0
13833,10462.0,MINI PAINT SET VINTAGE ,5,568,13,1400,832,1,26.0
13834,10463.0,13 TRADITIONAL SPINNING TOPS,9,436,13,1400,964,1,26.0
13835,10464.0,SET OF 6 SOLDIER SKITTLES,3,1574,18,1900,326,1,36.0
13836,10465.0,BAG 500g SWIRLY MARBLES,1,251,20,2100,1849,1,40.0
13837,10466.0,14 STRAND GLASS NECKLACE CRYSTAL,2,251,2,300,49,1,4.0
13838,10467.0,WHITE SKULL HOT WATER BOTTLE ,8,238,2,300,62,1,4.0
13839,10468.0,SCOTTIE DOG HOT WATER BOTTLE,8,237,2,300,63,1,4.0
13840,10469.0,SQUARECUSHION COVER PINK UNION FLAG,5,392,7,800,408,1,14.0
13841,10470.0,SPACEBOY CHILDRENS EGG CUP,1,263,4,500,237,1,8.0
13842,10471.0,CHILDREN'S SPACEBOY MUG,6,791,9,1000,209,1,18.0
13843,10472.0,HAND WARMER SCOTTY DOG DESIGN,9,594,7,800,206,1,14.0
13844,10473.0,FELTCRAFT CUSHION OWL,10,1139,11,1200,61,1,22.0
13845,10474.0,BLACK CANDELABRA T-LIGHT HOLDER,1,2013,22,2300,287,1,44.0
13846,10475.0,TOY TIDY DOLLY GIRL DESIGN,9,502,5,600,98,1,10.0
13847,10476.0,SET 12 LAVENDER  BOTANICAL T-LIGHTS,3,649,7,800,151,1,14.0
13848,10477.0,UNION JACK FLAG LUGGAGE TAG,2,1937,21,2200,263,1,42.0
13849,10478.0,RED HEART LUGGAGE TAG,7,970,10,1100,130,1,20.0
13850,10479.0,RED GLASS TASSLE BAG CHARM,7,572,5,600,28,1,10.0
13851,10480.0,CLEAR ACRYLIC FACETED BANGLE,6,229,3,400,171,1,6.0
13852,10481.0,14 STRAND GLASS NECKLACE CRYSTAL,5,711,13,1400,689,1,26.0
13853,10482.0,DOORMAT UNION JACK GUNS AND ROSES,6,492,15,1600,1108,1,30.0
13854,10483.0,VANILLA SCENT CANDLE JEWELLED BOX,3,301,14,1500,1199,1,28.0
13855,10484.0,FULL ENGLISH BREAKFAST PLATE,2,296,3,400,104,1,6.0
13856,10485.0,BLACK CANDELABRA T-LIGHT HOLDER,8,1210,15,1600,390,1,30.0
13857,10486.0,MAGIC DRAWING SLATE CIRCUS PARADE  ,6,426,5,600,174,1,10.0
13858,10487.0,CHRISTMAS HANGING HEART WITH BELL,1,1395,25,2600,1205,1,50.0
13859,10488.0,CAKE STAND VICTORIAN FILIGREE MED,9,485,11,1200,715,1,22.0
13860,10489.0,PAISLEY PATTERN  STICKERS,3,1367,13,1400,33,1,26.0
13861,10490.0,FLOWERS  STICKERS,8,306,16,1700,1394,1,32.0
13862,10491.0,PINK NEW BAROQUECANDLESTICK CANDLE,5,1011,15,1600,589,1,30.0
13863,10492.0,BLUE NEW BAROQUE CANDLESTICK CANDLE,9,594,18,1900,1306,1,36.0
13864,10493.0,JUMBO STORAGE BAG SUKI,10,357,24,2500,2143,1,48.0
13865,10494.0,BLACK LOVE BIRD CANDLE,1,1267,21,2200,933,1,42.0
13866,10495.0,PARTY TIME PENCIL ERASERS,1,766,10,1100,334,1,20.0
13867,10496.0,DISCO BALL CHRISTMAS DECORATION,8,367,5,600,233,1,10.0
13868,10497.0,PINK B'FLY C/COVER W BOBBLES,8,2439,24,2500,61,1,48.0
13869,10498.0,PINK UNION JACK  LUGGAGE TAG,9,337,15,1600,1263,1,30.0
13870,10499.0,15 RIBBONS ELEGANT CHRISTMAS ,4,592,15,1600,1008,1,30.0
13871,10500.0,UNION JACK FLAG LUGGAGE TAG,10,1708,21,2200,492,1,42.0
13872,10501.0,AGED GLASS SILVER T-LIGHT HOLDER,6,321,5,600,279,1,10.0
13873,10502.0,BOOM BOX SPEAKER GIRLS,4,1513,15,1600,87,1,30.0
13874,10503.0,15 RIBBONS SHIMMERING PINKS ,10,1121,13,1400,279,1,26.0
13875,10504.0, SET 2 TEA TOWELS I LOVE LONDON ,7,316,5,600,284,1,10.0
13876,10505.0,JUMBO BAG OWLS,2,1520,21,2200,680,1,42.0
13877,10506.0,SANDWICH BATH SPONGE,3,611,16,1700,1089,1,32.0
13878,10507.0,OWL DOORSTOP,8,1025,11,1200,175,1,22.0
13879,10508.0,14 STRAND GLASS NECKLACE CRYSTAL,3,241,10,1100,859,1,20.0
13880,10509.0,HAND WARMER UNION JACK,1,331,4,500,169,1,8.0
13881,10510.0,HAND WARMER SCOTTY DOG DESIGN,4,778,12,1300,522,1,24.0
13882,10511.0,LARGE POPCORN HOLDER ,3,884,24,2500,1616,1,48.0
13883,10512.0,PAINTED METAL STAR WITH HOLLY BELLS,7,258,10,1100,842,1,20.0
13884,10513.0,PAINTED METAL HEART WITH HOLLY BELL,4,1669,19,2000,331,1,38.0
13885,10514.0,ANGEL DECORATION STARS ON DRESS,3,123,3,400,277,1,6.0
13886,10515.0,SMALL POPCORN HOLDER,8,1271,17,1800,529,1,34.0
13887,10516.0,JUMBO BAG RED RETROSPOT,4,1179,17,1800,621,1,34.0
13888,10517.0,JUMBO BAG STRAWBERRY,2,861,14,1500,639,1,28.0
13889,10518.0,STRAWBERRY SHOPPER BAG,3,548,12,1300,752,1,24.0
13890,10519.0,STRAWBERRY CHARLOTTE BAG,5,100,0,100,0,1,0.0
13891,10520.0, SET 2 TEA TOWELS I LOVE LONDON ,6,1244,13,1400,156,1,26.0
13892,10521.0,PACK OF 12 RED RETROSPOT TISSUES ,3,298,10,1100,802,1,20.0
13893,10522.0,SCOTTIE DOG HOT WATER BOTTLE,5,1408,16,1700,292,1,32.0
13894,10523.0,CHOCOLATE HOT WATER BOTTLE,4,241,4,500,259,1,8.0
13895,10524.0,LUNCH BAG CARS BLUE,1,2076,25,2600,524,1,50.0
13896,10525.0,LUNCH BAG SPACEBOY DESIGN ,7,1552,17,1800,248,1,34.0
13897,10526.0,ROUND SNACK BOXES SET OF4 WOODLAND ,1,1009,16,1700,691,1,32.0
13898,10527.0,LUNCH BAG DOLLY GIRL DESIGN,2,1417,23,2400,983,1,46.0
13899,10528.0,LUNCH BAG SUKI  DESIGN ,3,676,6,700,24,1,12.0
13900,10529.0,LUNCH BAG  BLACK SKULL.,7,1963,22,2300,337,1,44.0
13901,10530.0,ROUND SNACK BOXES SET OF 4 FRUITS ,4,2150,25,2600,450,1,50.0
13902,10531.0,ROUND SNACK BOXES SET OF 4 SKULLS,9,584,13,1400,816,1,26.0
13903,10532.0,DOLLY GIRL LUNCH BOX,4,263,7,800,537,1,14.0
13904,10533.0,SPACEBOY LUNCH BOX ,2,277,7,800,523,1,14.0
13905,10534.0,GREEN POLKADOT PLATE ,1,396,9,1000,604,1,18.0
13906,10535.0,BLUE POLKADOT PLATE ,6,1335,19,2000,665,1,38.0
13907,10536.0,RED RETROSPOT PLATE ,3,125,1,200,75,1,2.0
13908,10537.0,PINK  POLKADOT PLATE ,9,238,10,1100,862,1,20.0
13909,10538.0,ROUND SNACK BOXES SET OF 4 SKULLS,2,1381,13,1400,19,1,26.0
13910,10539.0,FELTCRAFT DOLL MOLLY,5,2158,21,2200,42,1,42.0
13911,10540.0,FELTCRAFT CHRISTMAS FAIRY,6,503,9,1000,497,1,18.0
13912,10541.0,TRAVEL SEWING KIT,4,916,25,2600,1684,1,50.0
13913,10542.0,SET OF 3 NOTEBOOKS IN PARCEL,6,1831,18,1900,69,1,36.0
13914,10543.0,RED RETROSPOT TAPE,3,435,19,2000,1565,1,38.0
13915,10544.0,COSY SLIPPER SHOES SMALL  RED ,7,1916,22,2300,384,1,44.0
13916,10545.0,15 RIBBONS RUSTIC CHARM,10,110,2,300,190,1,4.0
13917,10546.0,SCANDINAVIAN REDS RIBBONS,4,528,11,1200,672,1,22.0
13918,10547.0,JAM MAKING SET PRINTED,8,799,14,1500,701,1,28.0
13919,10548.0,21 DAISY PEGS IN WOOD BOX,4,212,11,1200,988,1,22.0
13920,10549.0,HOT WATER BOTTLE BABUSHKA ,8,1151,21,2200,1049,1,42.0
13921,10550.0,FELTCRAFT PRINCESS CHARLOTTE DOLL,5,111,1,200,89,1,2.0
13922,10551.0,FELTCRAFT CHRISTMAS FAIRY,3,1915,25,2600,685,1,50.0
13923,10552.0,FELTCRAFT PRINCESS CHARLOTTE DOLL,9,957,9,1000,43,1,18.0
13924,10553.0,15 RIBBONS RUSTIC CHARM,5,230,13,1400,1170,1,26.0
13925,10554.0,COSY SLIPPER SHOES SMALL  RED ,2,511,22,2300,1789,1,44.0
13926,10555.0,SCANDINAVIAN REDS RIBBONS,7,158,2,300,142,1,4.0
13927,10556.0,14 HOOK HANGER RED MAGIC TOADSTOOL,10,197,4,500,303,1,8.0
13928,10557.0,CHRISTMAS CRAFT TREE TOP ANGEL,6,319,4,500,181,1,8.0
13929,10558.0,CHRISTMAS CRAFT LITTLE FRIENDS,4,2134,21,2200,66,1,42.0
13930,10559.0,14 HOOK HANGER RED MAGIC TOADSTOOL,2,1507,20,2100,593,1,40.0
13931,10560.0,15 RIBBONS RUSTIC CHARM,8,1211,14,1500,289,1,28.0
13932,10561.0,21 DAISY PEGS IN WOOD BOX,1,1749,24,2500,751,1,48.0
13933,10562.0,SET OF 3 NOTEBOOKS IN PARCEL,6,589,10,1100,511,1,20.0
13934,10563.0,14 HOOK HANGER MAGIC TOADSTOOL,2,432,7,800,368,1,14.0
13935,10564.0,SCANDINAVIAN REDS RIBBONS,5,136,1,200,64,1,2.0
13936,10565.0,RED TOADSTOOL LED NIGHT LIGHT,5,1036,10,1100,64,1,20.0
13937,10566.0,14 HOOK HANGER RED MAGIC TOADSTOOL,7,313,8,900,587,1,16.0
13938,10567.0,COSY SLIPPER SHOES SMALL GREEN,6,310,4,500,190,1,8.0
13939,10568.0,COSY SLIPPER SHOES SMALL  RED ,8,361,9,1000,639,1,18.0
13940,10569.0,FELTCRAFT DOLL ROSIE,6,1977,24,2500,523,1,48.0
13941,10570.0,FELTCRAFT DOLL MOLLY,3,1293,12,1300,7,1,24.0
13942,10571.0,FELTCRAFT DOLL EMILY,7,825,14,1500,675,1,28.0
13943,10572.0,FELTCRAFT PRINCESS CHARLOTTE DOLL,8,953,14,1500,547,1,28.0
13944,10573.0,FELTCRAFT PRINCESS OLIVIA DOLL,7,461,11,1200,739,1,22.0
13945,10574.0,REX CASH+CARRY JUMBO SHOPPER,9,181,4,500,319,1,8.0
13946,10575.0,FELTCRAFT DOLL MOLLY,6,604,6,700,96,1,12.0
13947,10576.0,FELTCRAFT CUSHION OWL,7,1337,14,1500,163,1,28.0
13948,10577.0,CHRISTMAS CRAFT TREE TOP ANGEL,4,1289,13,1400,111,1,26.0
13949,10578.0,CHRISTMAS CRAFT LITTLE FRIENDS,9,1007,13,1400,393,1,26.0
13950,10579.0,FELTCRAFT CUSHION RABBIT,3,416,9,1000,584,1,18.0
13951,10580.0,FELTCRAFT CUSHION BUTTERFLY,7,1013,16,1700,687,1,32.0
13952,10581.0,21 DAISY PEGS IN WOOD BOX,10,794,15,1600,806,1,30.0
13953,10582.0,PAPER CHAIN KIT 50'S CHRISTMAS ,9,841,8,900,59,1,16.0
13954,10583.0,FELTCRAFT CUSHION BUTTERFLY,2,1303,13,1400,97,1,26.0
13955,10584.0,21 DAISY PEGS IN WOOD BOX,3,152,6,700,548,1,12.0
13956,10585.0,ROSE COTTAGE KEEPSAKE BOX ,1,807,20,2100,1293,1,40.0
13957,10586.0,TOTE BAG I LOVE LONDON,10,163,21,2200,2037,1,42.0
13958,10587.0,21 DAISY PEGS IN WOOD BOX,1,1920,23,2400,480,1,46.0
13959,10588.0,TOTE BAG I LOVE LONDON,4,100,19,2000,1900,1,38.0
13960,10589.0,FOLDING UMBRELLA PINKWHITE POLKADOT,5,1879,21,2200,321,1,42.0
13961,10590.0,FOLDING UMBRELLA CREAM POLKADOT,7,1841,19,2000,159,1,38.0
13962,10591.0,FOLDING UMBRELLA WHITE/RED POLKADOT,1,680,12,1300,620,1,24.0
13963,10592.0,SET 10 LIGHTS NIGHT OWL,1,161,2,300,139,1,4.0
13964,10593.0,SMALL POPCORN HOLDER,7,321,8,900,579,1,16.0
13965,10594.0, SET 2 TEA TOWELS I LOVE LONDON ,9,202,18,1900,1698,1,36.0
13966,10595.0,FOLDING UMBRELLA RED/WHITE POLKADOT,1,167,1,200,33,1,2.0
13967,10596.0,BABUSHKA LIGHTS STRING OF 19,5,1816,22,2300,484,1,44.0
13968,10597.0,LUNCH BAG RED RETROSPOT,4,399,15,1600,1201,1,30.0
13969,10598.0,S/4 VALENTINE DECOUPAGE HEART BOX,4,1497,21,2200,703,1,42.0
13970,10599.0,FOLDING UMBRELLA CREAM POLKADOT,8,591,6,700,109,1,12.0
13971,10600.0, SET 2 TEA TOWELS I LOVE LONDON ,5,500,11,1200,700,1,22.0
13972,10601.0,FOLDING UMBRELLA RED/WHITE POLKADOT,1,151,1,200,49,1,2.0
13973,10602.0,SOLDIERS EGG CUP ,5,179,12,1300,1121,1,24.0
13974,10603.0,S/4 VALENTINE DECOUPAGE HEART BOX,9,1097,14,1500,403,1,28.0
13975,10604.0,RED RETROSPOT MINI CASES,4,399,7,800,401,1,14.0
13976,10605.0,,4,164,13,1400,1236,1,26.0
13977,10606.0,69 CAKE CASES VINTAGE CHRISTMAS,4,272,4,500,228,1,8.0
13978,10607.0,PAPER CHAIN KIT VINTAGE CHRISTMAS,7,233,5,600,367,1,10.0
13979,10608.0,RIBBON REEL CHRISTMAS SOCK BAUBLE,7,2026,20,2100,74,1,40.0
13980,10609.0,RIBBON REEL SNOWY VILLAGE,10,610,17,1800,1190,1,34.0
13981,10610.0,RIBBON REEL MAKING SNOWMEN ,3,1245,16,1700,455,1,32.0
13982,10611.0,SET OF 20 VINTAGE CHRISTMAS NAPKINS,1,1172,11,1200,28,1,22.0
13983,10612.0,TURQUOISE CHRISTMAS TREE ,1,756,21,2200,1444,1,42.0
13984,10613.0,RED STAR CARD HOLDER,7,1156,16,1700,544,1,32.0
13985,10614.0,WICKER WREATH SMALL,9,100,18,1900,1800,1,36.0
13986,10615.0,HEART OF WICKER LARGE,4,571,5,600,29,1,10.0
13987,10616.0,ADVENT CALENDAR GINGHAM SACK,8,538,18,1900,1362,1,36.0
13988,10617.0,HEART OF WICKER SMALL,7,109,19,2000,1891,1,38.0
13989,10618.0,FELTCRAFT BUTTERFLY HEARTS,4,686,9,1000,314,1,18.0
13990,10619.0,PARTY CONE CHRISTMAS DECORATION ,6,105,3,400,295,1,6.0
13991,10620.0,VINTAGE HEADS AND TAILS CARD GAME ,10,274,9,1000,726,1,18.0
13992,10621.0,WICKER STAR ,5,1755,22,2300,545,1,44.0
13993,10622.0,VINTAGE SNAP CARDS,6,1083,25,2600,1517,1,50.0
13994,10623.0,FELTCRAFT 6 FLOWER FRIENDS,2,147,3,400,253,1,6.0
13995,10624.0, SET 2 TEA TOWELS I LOVE LONDON ,4,697,18,1900,1203,1,36.0
13996,10625.0,JAM MAKING SET PRINTED,5,1274,21,2200,926,1,42.0
13997,10626.0,BIRD DECORATION RED RETROSPOT,1,100,0,100,0,1,0.0
13998,10627.0,CHRISTMAS GINGHAM TREE,3,588,23,2400,1812,1,46.0
13999,10628.0,CHRISTMAS GINGHAM STAR,6,2337,23,2400,63,1,46.0
14000,10629.0,CHRISTMAS GINGHAM HEART,6,1411,20,2100,689,1,40.0
14001,10630.0,PACK OF 12 PINK POLKADOT TISSUES,4,144,6,700,556,1,12.0
14002,10631.0,FELTCRAFT PRINCESS LOLA DOLL,4,217,7,800,583,1,14.0
14003,10632.0,PACK OF 12 LONDON TISSUES ,1,829,11,1200,371,1,22.0
14004,10633.0,PURPLE DRAWERKNOB ACRYLIC EDWARDIAN,8,682,23,2400,1718,1,46.0
14005,10634.0,CHILDREN'S APRON DOLLY GIRL ,4,346,4,500,154,1,8.0
14006,10635.0,CHILDRENS APRON SPACEBOY DESIGN,6,117,15,1600,1483,1,30.0
14007,10636.0,CHRISTMAS LIGHTS 10 SANTAS ,8,217,2,300,83,1,4.0
14008,10637.0,CHRISTMAS LIGHTS 10 REINDEER,6,100,0,100,0,1,0.0
14009,10638.0,PAPER CHAIN KIT 50'S CHRISTMAS ,9,526,7,800,274,1,14.0
14010,10639.0,FELTCRAFT CHRISTMAS FAIRY,1,1020,25,2600,1580,1,50.0
14011,10640.0,PACK OF 72 RETROSPOT CAKE CASES,8,1813,20,2100,287,1,40.0
14012,10641.0,PACK OF 60 MUSHROOM CAKE CASES,3,1408,15,1600,192,1,30.0
14013,10642.0,69 CAKE CASES DOLLY GIRL DESIGN,4,116,9,1000,884,1,18.0
14014,10643.0,PACK OF 60 PINK PAISLEY CAKE CASES,5,1073,15,1600,527,1,30.0
14015,10644.0,HAND WARMER BABUSHKA DESIGN,1,252,19,2000,1748,1,38.0
14016,10645.0,HAND WARMER BIRD DESIGN,2,118,14,1500,1382,1,28.0
14017,10646.0,HAND WARMER OWL DESIGN,4,1452,17,1800,348,1,34.0
14018,10647.0,HAND WARMER RED RETROSPOT,7,494,20,2100,1606,1,40.0
14019,10648.0,SET 12 RETRO WHITE CHALK STICKS,6,193,4,500,307,1,8.0
14020,10649.0,FELTCRAFT HAIRBAND RED AND BLUE,1,709,19,2000,1291,1,38.0
14021,10650.0,FELTCRAFT HAIRBAND PINK AND PURPLE,4,100,0,100,0,1,0.0
14022,10651.0,FELTCRAFT HAIRBANDS PINK AND WHITE ,2,376,3,400,24,1,6.0
14023,10652.0,TV DINNER TRAY DOLLY GIRL,3,807,12,1300,493,1,24.0
14024,10653.0,PLASTERS IN TIN VINTAGE PAISLEY ,5,127,1,200,73,1,2.0
14025,10654.0,PLASTERS IN TIN SPACEBOY,3,142,1,200,58,1,2.0
14026,10655.0,PLASTERS IN TIN WOODLAND ANIMALS,7,2133,22,2300,167,1,44.0
14027,10656.0,MAGIC DRAWING SLATE SPACEBOY ,4,871,19,2000,1129,1,38.0
14028,10657.0,MAGIC DRAWING SLATE CIRCUS PARADE  ,6,136,8,900,764,1,16.0
14029,10658.0,MAGIC DRAWING SLATE GO TO THE FAIR ,2,788,7,800,12,1,14.0
14030,10659.0,MAGIC DRAWING SLATE DOLLY GIRL ,2,160,2,300,140,1,4.0
14031,10660.0,CHARLIE + LOLA RED HOT WATER BOTTLE,3,897,14,1500,603,1,28.0
14032,10661.0,HOT WATER BOTTLE BABUSHKA ,5,364,3,400,36,1,6.0
14033,10662.0,URBAN BLACK RIBBONS ,7,315,3,400,85,1,6.0
14034,10663.0,FELTCRAFT PRINCESS CHARLOTTE DOLL,4,100,0,100,0,1,0.0
14035,10664.0,SET OF 6 T-LIGHTS TOADSTOOLS,7,829,9,1000,171,1,18.0
14036,10665.0,ROTATING LEAVES T-LIGHT HOLDER,9,214,3,400,186,1,6.0
14037,10666.0,RED  HARMONICA IN BOX ,8,989,17,1800,811,1,34.0
14038,10667.0,CUPCAKE LACE PAPER SET 15,4,1858,19,2000,142,1,38.0
14039,10668.0,FAMILY PHOTO FRAME CORNICE,3,329,8,900,571,1,16.0
14040,10669.0,TRIPLE PHOTO FRAME CORNICE ,2,100,1,200,100,1,2.0
14041,10670.0,WOODEN FRAME ANTIQUE WHITE ,6,598,16,1700,1102,1,32.0
14042,10671.0,WOODEN BOX OF DOMINOES,8,2067,25,2600,533,1,50.0
14043,10672.0,TRADITIONAL WOODEN CATCH CUP GAME ,1,1097,18,1900,803,1,36.0
14044,10673.0,TRADITIONAL WOODEN SKIPPING ROPE,8,1085,12,1300,215,1,24.0
14045,10674.0,S/6 WOODEN SKITTLES IN COTTON BAG,10,1192,19,2000,808,1,38.0
14046,10675.0,RED METAL BEACH SPADE ,2,1591,17,1800,209,1,34.0
14047,10676.0,BOYS VINTAGE TIN SEASIDE BUCKET,8,367,4,500,133,1,8.0
14048,10677.0,GIRLS VINTAGE TIN SEASIDE BUCKET,6,167,3,400,233,1,6.0
14049,10678.0,GREY HEART HOT WATER BOTTLE,4,1303,13,1400,97,1,26.0
14050,10679.0,SCOTTIE DOG HOT WATER BOTTLE,1,232,2,300,68,1,4.0
14051,10680.0,BIRD HOUSE HOT WATER BOTTLE,1,187,3,400,213,1,6.0
14052,10681.0,KINGS CHOICE TEA CADDY ,8,104,17,1800,1696,1,34.0
14053,10682.0,KINGS CHOICE BISCUIT TIN,1,813,20,2100,1287,1,40.0
14054,10683.0,METAL SIGN EMPIRE TEA,7,213,2,300,87,1,4.0
14055,10684.0,HOMEMADE JAM SCENTED CANDLES,6,601,22,2300,1699,1,44.0
14056,10685.0,SET OF 6 SOLDIER SKITTLES,8,180,1,200,20,1,2.0
14057,10686.0,FAWN BLUE HOT WATER BOTTLE,6,234,4,500,266,1,8.0
14058,10687.0,HAND WARMER RED RETROSPOT,5,1389,16,1700,311,1,32.0
14059,10688.0,HOT WATER BOTTLE BABUSHKA ,2,1448,25,2600,1152,1,50.0
14060,10689.0,WHITE SKULL HOT WATER BOTTLE ,3,644,19,2000,1356,1,38.0
14061,10690.0,RETROSPOT HEART HOT WATER BOTTLE,6,176,4,500,324,1,8.0
14062,10691.0,RED WOOLLY HOTTIE WHITE HEART.,1,222,2,300,78,1,4.0
14063,10692.0,SCOTTIE DOG HOT WATER BOTTLE,10,116,1,200,84,1,2.0
14064,10693.0,GREY HEART HOT WATER BOTTLE,5,1161,13,1400,239,1,26.0
14065,10694.0,HOT WATER BOTTLE BABUSHKA ,5,373,3,400,27,1,6.0
14066,10695.0,PACK OF 6 BIRDY GIFT TAGS,7,141,8,900,759,1,16.0
14067,10696.0,CHILLI LIGHTS,6,2145,24,2500,355,1,48.0
14068,10697.0,PIGGY BANK RETROSPOT ,8,100,0,100,0,1,0.0
14069,10698.0,CERAMIC STRAWBERRY MONEY BOX,5,966,12,1300,334,1,24.0
14070,10699.0,CERAMIC STRAWBERRY CAKE MONEY BANK,10,156,2,300,144,1,4.0
14071,10700.0,CERAMIC CHERRY CAKE MONEY BANK,7,166,1,200,34,1,2.0
14072,10701.0,CERAMIC HEART FAIRY CAKE MONEY BANK,7,722,9,1000,278,1,18.0
14073,10702.0,CERAMIC PIRATE CHEST MONEY BANK,5,591,13,1400,809,1,26.0
14074,10703.0,DOORSTOP RETROSPOT HEART,9,451,11,1200,749,1,22.0
14075,10704.0,GINGHAM HEART  DOORSTOP RED,4,1518,20,2100,582,1,40.0
14076,10705.0,RETROSPOT BABUSHKA DOORSTOP,5,815,8,900,85,1,16.0
14077,10706.0,SILK PURSE BABUSHKA RED,6,733,19,2000,1267,1,38.0
14078,10707.0,SILK PURSE BABUSHKA PINK,4,1252,15,1600,348,1,30.0
14079,10708.0,FAMILY PHOTO FRAME CORNICE,4,1178,11,1200,22,1,22.0
14080,10709.0,SWEETHEART WIRE WALL TIDY,8,129,13,1400,1271,1,26.0
14081,10710.0,JAM MAKING SET PRINTED,2,100,0,100,0,1,0.0
14082,10711.0,RED RETROSPOT OVEN GLOVE ,3,1042,13,1400,358,1,26.0
14083,10712.0,CREAM HEART CARD HOLDER,2,1626,24,2500,874,1,48.0
14084,10713.0,NAMASTE SWAGAT INCENSE,1,654,18,1900,1246,1,36.0
14085,10714.0,CERAMIC STRAWBERRY DESIGN MUG,8,617,6,700,83,1,12.0
14086,10715.0,BLACK HEART CARD HOLDER,7,1503,21,2200,697,1,42.0
14087,10716.0,CLASSICAL ROSE SMALL VASE,9,287,2,300,13,1,4.0
14088,10717.0,HYACINTH BULB T-LIGHT CANDLES,10,862,19,2000,1138,1,38.0
14089,10718.0,CHRISTMAS CRAFT WHITE FAIRY ,6,362,9,1000,638,1,18.0
14090,10719.0,CHRISTMAS CRAFT LITTLE FRIENDS,7,417,8,900,483,1,16.0
14091,10720.0,COSY HOUR CIGAR BOX MATCHES ,9,1441,17,1800,359,1,34.0
14092,10721.0,RED TEA TOWEL CLASSIC DESIGN,2,145,8,900,755,1,16.0
14093,10722.0,HEART FILIGREE DOVE  SMALL,4,123,4,500,377,1,8.0
14094,10723.0,RETROSPOT CHILDRENS APRON,4,1175,12,1300,125,1,24.0
14095,10724.0,COLOURING PENCILS BROWN TUBE,5,952,10,1100,148,1,20.0
14096,10725.0,13 IVORY DINNER CANDLES SILVER FLOCK,1,100,0,100,0,1,0.0
14097,10726.0,HEART FILIGREE DOVE  SMALL,6,1606,17,1800,194,1,34.0
14098,10727.0,ZINC METAL HEART DECORATION,5,130,18,1900,1770,1,36.0
14099,10728.0,GREEN FERN NOTEBOOK,7,1575,21,2200,625,1,42.0
14100,10729.0,BLUE PAISLEY NOTEBOOK,1,301,24,2500,2199,1,48.0
14101,10730.0,CHRYSANTHEMUM NOTEBOOK,9,489,9,1000,511,1,18.0
14102,10731.0,LARGE CHINESE STYLE SCISSOR,7,2001,21,2200,199,1,42.0
14103,10732.0,SMALL CHINESE STYLE SCISSOR,9,1515,17,1800,285,1,34.0
14104,10733.0,S/6 WOODEN SKITTLES IN COTTON BAG,9,2080,22,2300,220,1,44.0
14105,10734.0,TRADITIONAL WOODEN SKIPPING ROPE,9,106,1,200,94,1,2.0
14106,10735.0,SET OF 6 SOLDIER SKITTLES,7,1023,13,1400,377,1,26.0
14107,10736.0,13 TRADITIONAL SPINNING TOPS,1,309,5,600,291,1,10.0
14108,10737.0,ROTATING SILVER ANGELS T-LIGHT HLDR,2,435,25,2600,2165,1,50.0
14109,10738.0,BLACK LOVE BIRD CANDLE,8,157,1,200,43,1,2.0
14110,10739.0,RETROSPOT CHILDRENS APRON,3,1863,20,2100,237,1,40.0
14111,10740.0,HANGING GLASS ETCHED TEALIGHT,9,2119,22,2300,181,1,44.0
14112,10741.0,HANGING GLASS ETCHED TEALIGHT,9,1723,17,1800,77,1,34.0
14113,10742.0,BLUE NEW BAROQUE CANDLESTICK CANDLE,4,203,4,500,297,1,8.0
14114,10743.0,COOKING SET RETROSPOT,7,399,5,600,201,1,10.0
14115,10744.0,KINGS CHOICE GIANT TUBE MATCHES,4,1096,13,1400,304,1,26.0
14116,10745.0,COSY HOUR GIANT TUBE MATCHES,9,893,10,1100,207,1,20.0
14117,10746.0,PLACE SETTING WHITE STAR,8,1632,19,2000,368,1,38.0
14118,10747.0,HYACINTH BULB T-LIGHT CANDLES,2,805,14,1500,695,1,28.0
14119,10748.0,S/15 SILVER GLASS BAUBLES IN BAG,4,509,14,1500,991,1,28.0
14120,10749.0,FRENCH WC SIGN BLUE METAL,10,199,16,1700,1501,1,32.0
14121,10750.0,KINGS CHOICE GIANT TUBE MATCHES,5,191,14,1500,1309,1,28.0
14122,10751.0,81 SWEETHEART FAIRY CAKE CASES,2,393,23,2400,2007,1,46.0
14123,10752.0,ASSORTED COLOUR BIRD ORNAMENT,2,1210,24,2500,1290,1,48.0
14124,10753.0,FAIRY SOAP SOAP HOLDER,4,176,2,300,124,1,4.0
14125,10754.0,GREEN GIANT GARDEN THERMOMETER,7,189,11,1200,1011,1,22.0
14126,10755.0,IVORY GIANT GARDEN THERMOMETER,1,459,24,2500,2041,1,48.0
14127,10756.0,BLUE GIANT GARDEN THERMOMETER,5,624,6,700,76,1,12.0
14128,10757.0,PACK OF 60 PINK PAISLEY CAKE CASES,5,191,10,1100,909,1,20.0
14129,10758.0,RETROSPOT HEART HOT WATER BOTTLE,2,118,1,200,82,1,2.0
14130,10759.0,CHICK GREY HOT WATER BOTTLE,3,458,8,900,442,1,16.0
14131,10760.0,VICTORIAN SEWING BOX SMALL ,9,1625,16,1700,75,1,32.0
14132,10761.0,VICTORIAN SEWING BOX MEDIUM,9,461,4,500,39,1,8.0
14133,10762.0,SET/10 RED POLKADOT PARTY CANDLES,7,660,13,1400,740,1,26.0
14134,10763.0,WASHROOM METAL SIGN,9,168,3,400,232,1,6.0
14135,10764.0,BLACK SWEETHEART BRACELET,10,1766,17,1800,34,1,34.0
14136,10765.0,DIAMANTE HAIR GRIP PACK/2 BLACK DIA,7,1873,22,2300,427,1,44.0
14137,10766.0,BLACK DIAMANTE EXPANDABLE RING,10,147,6,700,553,1,12.0
14138,10767.0,DIAMANTE HAIR GRIP PACK/2 RUBY,5,518,22,2300,1782,1,44.0
14139,10768.0,DIAMANTE HAIR GRIP PACK/2 MONTANA,1,843,8,900,57,1,16.0
14140,10769.0,BLUE SWEETHEART BRACELET,2,983,18,1900,917,1,36.0
14141,10770.0,PINK SWEETHEART BRACELET,2,937,11,1200,263,1,22.0
14142,10771.0,PURPLE SWEETHEART BRACELET,2,310,4,500,190,1,8.0
14143,10772.0,JUMBO BAG PINK POLKADOT,10,792,7,800,8,1,14.0
14144,10773.0,JUMBO BAG RED RETROSPOT,5,246,2,300,54,1,4.0
14145,10774.0,ASSORTED COLOUR BIRD ORNAMENT,7,669,21,2200,1531,1,42.0
14146,10775.0,PAPER CHAIN KIT 50'S CHRISTMAS ,3,683,24,2500,1817,1,48.0
14147,10776.0,RIBBON REEL CHRISTMAS PRESENT ,4,149,4,500,351,1,8.0
14148,10777.0,FIRST AID TIN,7,122,5,600,478,1,10.0
14149,10778.0,MAKE YOUR OWN MONSOON CARD KIT,5,545,9,1000,455,1,18.0
14150,10779.0,PACK OF 12 HEARTS DESIGN TISSUES ,9,218,5,600,382,1,10.0
14151,10780.0,PACK OF 12 RED RETROSPOT TISSUES ,8,402,6,700,298,1,12.0
14152,10781.0,SOLDIERS EGG CUP ,9,547,20,2100,1553,1,40.0
14153,10782.0,HEART IVORY TRELLIS SMALL,2,242,6,700,458,1,12.0
14154,10783.0,HEART FILIGREE DOVE  SMALL,3,408,12,1300,892,1,24.0
14155,10784.0,HEART FILIGREE DOVE LARGE,2,920,12,1300,380,1,24.0
14156,10785.0,PACK 3 BOXES BIRD PANNETONE ,10,868,22,2300,1432,1,44.0
14157,10786.0,PACK 3 BOXES CHRISTMAS PANNETONE,2,1390,21,2200,810,1,42.0
14158,10787.0,SMALL POPCORN HOLDER,9,286,18,1900,1614,1,36.0
14159,10788.0,PACK OF 60 PINK PAISLEY CAKE CASES,4,776,23,2400,1624,1,46.0
14160,10789.0,SET OF 6 SOLDIER SKITTLES,5,514,18,1900,1386,1,36.0
14161,10790.0,SWIRLY CIRCULAR RUBBERS IN BAG,5,730,18,1900,1170,1,36.0
14162,10791.0,VINTAGE PAISLEY STATIONERY SET,3,783,16,1700,917,1,32.0
14163,10792.0,PAPER CHAIN KIT VINTAGE CHRISTMAS,10,682,7,800,118,1,14.0
14164,10793.0,SET/10 BLUE POLKADOT PARTY CANDLES,2,1330,14,1500,170,1,28.0
14165,10794.0,RIBBON REEL SOCKS AND MITTENS,10,245,18,1900,1655,1,36.0
14166,10795.0,69 CAKE CASES VINTAGE CHRISTMAS,3,407,4,500,93,1,8.0
14167,10796.0,CHRISTMAS METAL TAGS ASSORTED ,8,142,2,300,158,1,4.0
14168,10797.0,CHRISTMAS TREE T-LIGHT HOLDER,7,2029,23,2400,371,1,46.0
14169,10798.0,STAR  T-LIGHT HOLDER ,6,591,7,800,209,1,14.0
14170,10799.0,HEART T-LIGHT HOLDER ,10,377,8,900,523,1,16.0
14171,10800.0,MINI FUNKY DESIGN TAPES,3,1927,24,2500,573,1,48.0
14172,10801.0,SET OF 6 T-LIGHTS SNOWMEN,4,435,8,900,465,1,16.0
14173,10802.0,STAR WOODEN CHRISTMAS DECORATION,10,941,14,1500,559,1,28.0
14174,10803.0,WOODEN HEART CHRISTMAS SCANDINAVIAN,7,108,4,500,392,1,8.0
14175,10804.0,CHRISTMAS RETROSPOT TREE WOOD,1,669,6,700,31,1,12.0
14176,10805.0,SET OF 6 T-LIGHTS SANTA,3,194,6,700,506,1,12.0
14177,10806.0,SET/9 CHRISTMAS T-LIGHTS SCENTED ,4,634,6,700,66,1,12.0
14178,10807.0,BLUE ROSE FABRIC MIRROR,6,584,22,2300,1716,1,44.0
14179,10808.0,THREE CANVAS LUGGAGE TAGS,10,622,11,1200,578,1,22.0
14180,10809.0,RETROSPOT PARTY BAG + STICKER SET,2,231,7,800,569,1,14.0
14181,10810.0,PLASTERS IN TIN VINTAGE PAISLEY ,3,348,4,500,152,1,8.0
14182,10811.0,RETROSPOT SMALL TUBE MATCHES,2,993,15,1600,607,1,30.0
14183,10812.0,HAND WARMER SCOTTY DOG DESIGN,7,2079,24,2500,421,1,48.0
14184,10813.0,3D CHRISTMAS STAMPS STICKERS ,2,820,18,1900,1080,1,36.0
14185,10814.0,HAND WARMER SCOTTY DOG DESIGN,2,107,1,200,93,1,2.0
14186,10815.0,HAND WARMER SCOTTY DOG DESIGN,1,956,21,2200,1244,1,42.0
14187,10816.0,CLOTHES PEGS RETROSPOT PACK 33,6,1310,21,2200,890,1,42.0
14188,10817.0,45 FOIL HEART CAKE CASES,8,135,22,2300,2165,1,44.0
14189,10818.0,CHRISTMAS METAL TAGS ASSORTED ,3,440,9,1000,560,1,18.0
14190,10819.0,PACK OF 6 SWEETIE GIFT BOXES,1,476,5,600,124,1,10.0
14191,10820.0,PACK OF 72 RETROSPOT CAKE CASES,1,426,8,900,474,1,16.0
14192,10821.0,PACK OF 72 RETROSPOT CAKE CASES,10,391,4,500,109,1,8.0
14193,10822.0,PACK OF 6 BIRDY GIFT TAGS,6,754,18,1900,1146,1,36.0
14194,10823.0,SET/10 RED POLKADOT PARTY CANDLES,9,956,10,1100,144,1,20.0
14195,10824.0,SET/10 PINK POLKADOT PARTY CANDLES,10,776,16,1700,924,1,32.0
14196,10825.0,SET OF 3 NOTEBOOKS IN PARCEL,8,1178,11,1200,22,1,22.0
14197,10826.0,STAR  T-LIGHT HOLDER ,3,135,1,200,65,1,2.0
14198,10827.0,CINAMMON SET OF 9 T-LIGHTS,9,380,3,400,20,1,6.0
14199,10828.0,ORANGE SCENTED SET/9 T-LIGHTS,2,808,9,1000,192,1,18.0
14200,10829.0,RIBBON REEL STRIPES DESIGN ,10,159,20,2100,1941,1,40.0
14201,10830.0,SET OF 2 TINS JARDIN DE PROVENCE,7,1916,20,2100,184,1,40.0
14202,10831.0,MAKE YOUR OWN PLAYTIME CARD KIT,3,1503,16,1700,197,1,32.0
14203,10832.0,DINOSAURS  WRITING SET ,10,841,9,1000,159,1,18.0
14204,10833.0,BALLOONS  WRITING SET ,4,734,21,2200,1466,1,42.0
14205,10834.0,SKULLS WRITING SET ,5,1547,22,2300,753,1,44.0
14206,10835.0,VINTAGE PAISLEY STATIONERY SET,8,311,12,1300,989,1,24.0
14207,10836.0,COSY SLIPPER SHOES SMALL  RED ,5,271,2,300,29,1,4.0
14208,10837.0,DOORMAT BLACK FLOCK ,4,118,15,1600,1482,1,30.0
14209,10838.0,JUMBO  BAG BAROQUE BLACK WHITE,4,1171,16,1700,529,1,32.0
14210,10839.0,JAM MAKING SET WITH JARS,2,1452,17,1800,348,1,34.0
14211,10840.0,ORANGE SCENTED SET/9 T-LIGHTS,4,1398,15,1600,202,1,30.0
14212,10841.0,CINAMMON SET OF 9 T-LIGHTS,7,309,4,500,191,1,8.0
14213,10842.0,HAND WARMER SCOTTY DOG DESIGN,6,2207,23,2400,193,1,46.0
14214,10843.0,CHRISTMAS DECOUPAGE CANDLE,2,223,4,500,277,1,8.0
14215,10844.0,HEART T-LIGHT HOLDER ,6,953,9,1000,47,1,18.0
14216,10845.0,GROW YOUR OWN BASIL IN ENAMEL MUG,4,100,0,100,0,1,0.0
14217,10846.0,OFFICE MUG WARMER POLKADOT,3,1500,15,1600,100,1,30.0
14218,10847.0,SMALL POPCORN HOLDER,8,2003,20,2100,97,1,40.0
14219,10848.0,JUMBO BAG DOLLY GIRL DESIGN,5,687,14,1500,813,1,28.0
14220,10849.0,JAM MAKING SET WITH JARS,2,100,0,100,0,1,0.0
14221,10850.0,JAM MAKING SET PRINTED,8,2125,23,2400,275,1,46.0
14222,10851.0,SMALL GLASS HEART TRINKET POT,9,1403,20,2100,697,1,40.0
14223,10852.0,RED WOOLLY HOTTIE WHITE HEART.,1,472,11,1200,728,1,22.0
14224,10853.0,BLACK RECORD COVER FRAME,8,635,9,1000,365,1,18.0
14225,10854.0,"RECORD FRAME 7"" SINGLE SIZE ",5,887,18,1900,1013,1,36.0
14226,10855.0,45 PENCILS TUBE RED RETROSPOT,7,893,10,1100,207,1,20.0
14227,10856.0,45 PENCILS TUBE WOODLAND,9,341,3,400,59,1,6.0
14228,10857.0,SET OF 6 SOLDIER SKITTLES,2,293,8,900,607,1,16.0
14229,10858.0,ROCKING HORSE RED CHRISTMAS ,4,376,19,2000,1624,1,38.0
14230,10859.0,CHRISTMAS GINGHAM HEART,10,1231,12,1300,69,1,24.0
14231,10860.0,CHRISTMAS GINGHAM STAR,8,196,1,200,4,1,2.0
14232,10861.0,HAND WARMER UNION JACK,8,625,11,1200,575,1,22.0
14233,10862.0,HAND WARMER RED RETROSPOT,6,1490,19,2000,510,1,38.0
14234,10863.0,REGENCY CAKESTAND 3 TIER,7,1095,19,2000,905,1,38.0
14235,10864.0,JUMBO SHOPPER VINTAGE RED PAISLEY,9,164,3,400,236,1,6.0
14236,10865.0,RIBBON REEL SNOWY VILLAGE,3,1781,18,1900,119,1,36.0
14237,10866.0,VINTAGE UNION JACK BUNTING,7,576,12,1300,724,1,24.0
14238,10867.0,JAM MAKING SET WITH JARS,4,419,5,600,181,1,10.0
14239,10868.0,RIBBON REEL STRIPES DESIGN ,6,658,15,1600,942,1,30.0
14240,10869.0,RETRO LONGBOARD IRONING BOARD COVER,3,1135,16,1700,565,1,32.0
14241,10870.0,3D DOG PICTURE PLAYING CARDS,9,277,15,1600,1323,1,30.0
14242,10871.0,RETROSPOT CIGAR BOX MATCHES ,2,149,4,500,351,1,8.0
14243,10872.0,SET/9 CHRISTMAS T-LIGHTS SCENTED ,5,737,13,1400,663,1,26.0
14244,10873.0,ROTATING SILVER ANGELS T-LIGHT HLDR,4,155,1,200,45,1,2.0
14245,10874.0,ROTATING SILVER ANGELS T-LIGHT HLDR,9,101,1,200,99,1,2.0
14246,10875.0,SAVE THE PLANET COTTON TOTE BAG,8,565,21,2200,1635,1,42.0
14247,10876.0,SET OF 20 VINTAGE CHRISTMAS NAPKINS,8,750,14,1500,750,1,28.0
14248,10877.0,PAPER BUNTING WHITE LACE,7,168,6,700,532,1,12.0
14249,10878.0,GENTLEMAN SHIRT REPAIR KIT ,3,230,7,800,570,1,14.0
14250,10879.0,CARD I LOVE LONDON ,9,179,1,200,21,1,2.0
14251,10880.0,PAPER CHAIN KIT VINTAGE CHRISTMAS,7,911,11,1200,289,1,22.0
14252,10881.0,MIRRORED WALL ART FOXY,1,734,20,2100,1366,1,40.0
14253,10882.0,MIRRORED WALL ART GENTS,10,1232,17,1800,568,1,34.0
14254,10883.0,AIRLINE BAG VINTAGE JET SET WHITE,8,1456,23,2400,944,1,46.0
14255,10884.0,JAM MAKING SET PRINTED,2,426,21,2200,1774,1,42.0
14256,10885.0,POTTING SHED SOW 'N' GROW SET,2,589,16,1700,1111,1,32.0
14257,10886.0,BABUSHKA LIGHTS STRING OF 19,5,100,0,100,0,1,0.0
14258,10887.0,REX CASH+CARRY JUMBO SHOPPER,8,947,25,2600,1653,1,50.0
14259,10888.0,AIRLINE BAG VINTAGE WORLD CHAMPION ,3,175,1,200,25,1,2.0
14260,10889.0,HAND WARMER BIRD DESIGN,3,100,0,100,0,1,0.0
14261,10890.0,CHRISTMAS CRAFT LITTLE FRIENDS,2,721,7,800,79,1,14.0
14262,10891.0,PINK HEARTS PAPER GARLAND,7,147,18,1900,1753,1,36.0
14263,10892.0,POTTING SHED SEED ENVELOPES,7,921,10,1100,179,1,20.0
14264,10893.0,HI TEC ALPINE HAND WARMER,8,1161,14,1500,339,1,28.0
14265,10894.0,FELTCRAFT CHRISTMAS FAIRY,10,869,8,900,31,1,16.0
14266,10895.0,HI TEC ALPINE HAND WARMER,5,186,7,800,614,1,14.0
14267,10896.0,ROTATING SILVER ANGELS T-LIGHT HLDR,3,636,8,900,264,1,16.0
14268,10897.0,12 STRIPEY MICE FELTCRAFT,2,312,5,600,288,1,10.0
14269,10898.0,FELTCRAFT 6 FLOWER FRIENDS,7,892,8,900,8,1,16.0
14270,10899.0,CHRISTMAS CRAFT LITTLE FRIENDS,10,357,9,1000,643,1,18.0
14271,10900.0,VINTAGE UNION JACK CUSHION COVER,5,1566,16,1700,134,1,32.0
14272,10901.0,POLYESTER FILLER PAD 45x45cm,9,2177,23,2400,223,1,46.0
14273,10902.0,DOLLY GIRL LUNCH BOX,3,168,4,500,332,1,8.0
14274,10903.0,PACK OF 12 LONDON TISSUES ,7,641,12,1300,659,1,24.0
14275,10904.0,CARD DOLLY GIRL ,6,498,10,1100,602,1,20.0
14276,10905.0,CARD BILLBOARD FONT,1,117,1,200,83,1,2.0
14277,10906.0,RAINY LADIES BIRTHDAY CARD,3,290,12,1300,1010,1,24.0
14278,10907.0,GREY HEART HOT WATER BOTTLE,1,243,4,500,257,1,8.0
14279,10908.0,RED WOOLLY HOTTIE WHITE HEART.,10,1321,13,1400,79,1,26.0
14280,10909.0,RED WHITE SCARF  HOT WATER BOTTLE,5,2052,22,2300,248,1,44.0
14281,10910.0, SET 2 TEA TOWELS I LOVE LONDON ,10,1061,18,1900,839,1,36.0
14282,10911.0,SET OF 2 TEA TOWELS APPLE AND PEARS,10,296,6,700,404,1,12.0
14283,10912.0,SET/2 RED RETROSPOT TEA TOWELS ,1,570,25,2600,2030,1,50.0
14284,10913.0,LOVE BUILDING BLOCK WORD,3,1519,25,2600,1081,1,50.0
14285,10914.0,HOME BUILDING BLOCK WORD,7,1744,24,2500,756,1,48.0
14286,10915.0,ASSORTED COLOUR BIRD ORNAMENT,4,100,0,100,0,1,0.0
14287,10916.0,LANTERN CREAM GAZEBO ,10,1202,17,1800,598,1,34.0
14288,10917.0,BLUE BIRDHOUSE DECORATION,1,2007,23,2400,393,1,46.0
14289,10918.0,WHITE HANGING HEART T-LIGHT HOLDER,3,383,5,600,217,1,10.0
14290,10919.0,REGENCY CAKESTAND 3 TIER,6,1460,19,2000,540,1,38.0
14291,10920.0,ANTIQUE SILVER TEA GLASS ENGRAVED,2,329,9,1000,671,1,18.0
14292,10921.0,AGED GLASS SILVER T-LIGHT HOLDER,10,1331,19,2000,669,1,38.0
14293,10922.0,JAM MAKING SET WITH JARS,2,243,5,600,357,1,10.0
14294,10923.0,HAND WARMER OWL DESIGN,10,1200,17,1800,600,1,34.0
14295,10924.0,SET OF 2 WOODEN MARKET CRATES,8,177,1,200,23,1,2.0
14296,10925.0,SET OF 6 T-LIGHTS TOADSTOOLS,3,161,7,800,639,1,14.0
14297,10926.0,HAND WARMER UNION JACK,1,1837,23,2400,563,1,46.0
14298,10927.0,HAND WARMER SCOTTY DOG DESIGN,5,769,12,1300,531,1,24.0
14299,10928.0,CLASSIC FRENCH STYLE BASKET NATURAL,3,848,10,1100,252,1,20.0
14300,10929.0,CRAZY DAISY HEART DECORATION,7,940,11,1200,260,1,22.0
14301,10930.0,GIN + TONIC DIET METAL SIGN,9,142,4,500,358,1,8.0
14302,10931.0,IVORY GIANT GARDEN THERMOMETER,4,351,4,500,149,1,8.0
14303,10932.0,CARD HOLDER GINGHAM HEART,3,331,20,2100,1769,1,40.0
14304,10933.0,SMALL STRIPES CHOCOLATE GIFT BAG ,5,132,3,400,268,1,6.0
14305,10934.0,S/6 WOODEN SKITTLES IN COTTON BAG,1,186,4,500,314,1,8.0
14306,10935.0,HAND WARMER RED RETROSPOT,9,956,25,2600,1644,1,50.0
14307,10936.0,HAND WARMER UNION JACK,6,916,10,1100,184,1,20.0
14308,10937.0,FRENCH WC SIGN BLUE METAL,8,1783,23,2400,617,1,46.0
14309,10938.0,PINK UNION JACK  LUGGAGE TAG,9,497,22,2300,1803,1,44.0
14310,10939.0,"TRAY, BREAKFAST IN BED",7,642,11,1200,558,1,22.0
14311,10940.0,PIZZA PLATE IN BOX,1,409,5,600,191,1,10.0
14312,10941.0,HEART OF WICKER LARGE,10,323,13,1400,1077,1,26.0
14313,10942.0,PINK HEART DOTS HOT WATER BOTTLE,7,492,23,2400,1908,1,46.0
14314,10943.0,PLACE SETTING WHITE HEART,4,2248,23,2400,152,1,46.0
14315,10944.0,SET OF 4 NAPKIN CHARMS LEAVES   ,5,679,14,1500,821,1,28.0
14316,10945.0,SET OF 4 NAPKIN CHARMS STARS   ,1,1458,15,1600,142,1,30.0
14317,10946.0,SET OF 4 NAPKIN CHARMS CUTLERY,6,519,6,700,181,1,12.0
14318,10947.0,CARAVAN SQUARE TISSUE BOX,3,844,24,2500,1656,1,48.0
14319,10948.0,PLASTERS IN TIN SKULLS,8,1388,18,1900,512,1,36.0
14320,10949.0,PLASTERS IN TIN SPACEBOY,3,764,24,2500,1736,1,48.0
14321,10950.0,BUTTON BOX ,10,1339,24,2500,1161,1,48.0
14322,10951.0,PLASTERS IN TIN VINTAGE PAISLEY ,5,501,13,1400,899,1,26.0
14323,10952.0,21 MESSAGE CARDS WITH ENVELOPES,4,2318,23,2400,82,1,46.0
14324,10953.0,SMALL RED BABUSHKA NOTEBOOK ,8,451,10,1100,649,1,20.0
14325,10954.0,CUPCAKE LACE PAPER SET 15,3,2024,21,2200,176,1,42.0
14326,10955.0,PACK 3 BOXES CHRISTMAS PANNETONE,6,1206,14,1500,294,1,28.0
14327,10956.0,HERB MARKER MINT,9,1064,18,1900,836,1,36.0
14328,10957.0,HERB MARKER ROSEMARY,9,2380,24,2500,120,1,48.0
14329,10958.0,HERB MARKER BASIL,4,1478,16,1700,222,1,32.0
14330,10959.0,HERB MARKER CHIVES ,3,532,10,1100,568,1,20.0
14331,10960.0,HERB MARKER PARSLEY,10,159,3,400,241,1,6.0
14332,10961.0,HERB MARKER THYME,9,1002,17,1800,798,1,34.0
14333,10962.0,WHITE HANGING HEART T-LIGHT HOLDER,9,858,18,1900,1042,1,36.0
14334,10963.0,METAL MERRY CHRISTMAS WREATH,6,2251,22,2300,49,1,44.0
14335,10964.0,WHITE CHRISTMAS GARLAND STARS TREES,9,300,2,300,0,1,4.0
14336,10965.0,RETROSPOT SMALL TUBE MATCHES,7,1926,19,2000,74,1,38.0
14337,10966.0,RETROSPOT GIANT TUBE MATCHES,6,927,14,1500,573,1,28.0
14338,10967.0,PLACE SETTING WHITE STAR,2,726,7,800,74,1,14.0
14339,10968.0,GROW YOUR OWN BASIL IN ENAMEL MUG,9,1379,13,1400,21,1,26.0
14340,10969.0,45 FOIL STAR CAKE CASES ,2,366,6,700,334,1,12.0
14341,10970.0,45 FOIL HEART CAKE CASES,3,347,3,400,53,1,6.0
14342,10971.0,PACK OF 6 SWEETIE GIFT BOXES,6,142,25,2600,2458,1,50.0
14343,10972.0,PACK OF 6 HANDBAG GIFT BOXES,8,244,11,1200,956,1,22.0
14344,10973.0,GARLAND WOODEN HAPPY EASTER,5,1503,23,2400,897,1,46.0
14345,10974.0,CALENDAR PAPER CUT DESIGN,5,602,16,1700,1098,1,32.0
14346,10975.0,CALENDAR IN SEASON DESIGN,5,1303,16,1700,397,1,32.0
14347,10976.0,SMALL POPCORN HOLDER,7,330,9,1000,670,1,18.0
14348,10977.0,BLUE PAISLEY TISSUE BOX,3,1785,21,2200,415,1,42.0
14349,10978.0,HEART OF WICKER SMALL,2,1028,16,1700,672,1,32.0
14350,10979.0,SKULLS SQUARE TISSUE BOX,7,449,8,900,451,1,16.0
14351,10980.0,SKULLS SQUARE TISSUE BOX,1,370,13,1400,1030,1,26.0
14352,10981.0,WHITE HANGING HEART T-LIGHT HOLDER,9,100,0,100,0,1,0.0
14353,10982.0,WHITE METAL LANTERN,3,592,22,2300,1708,1,44.0
14354,10983.0,CREAM CUPID HEARTS COAT HANGER,2,252,2,300,48,1,4.0
14355,10984.0,KNITTED UNION FLAG HOT WATER BOTTLE,9,471,5,600,129,1,10.0
14356,10985.0,RED WOOLLY HOTTIE WHITE HEART.,2,1091,25,2600,1509,1,50.0
14357,10986.0,SET 7 BABUSHKA NESTING BOXES,9,274,2,300,26,1,4.0
14358,10987.0,GLASS STAR FROSTED T-LIGHT HOLDER,3,100,0,100,0,1,0.0
14359,10988.0,HAND WARMER UNION JACK,10,958,13,1400,442,1,26.0
14360,10989.0,HAND WARMER RED POLKA DOT,10,183,2,300,117,1,4.0
14361,10990.0,ASSORTED COLOUR BIRD ORNAMENT,3,526,14,1500,974,1,28.0
14362,10991.0,POPPY'S PLAYHOUSE BEDROOM ,1,854,9,1000,146,1,18.0
14363,10992.0,POPPY'S PLAYHOUSE KITCHEN,10,835,15,1600,765,1,30.0
14364,10993.0,FELTCRAFT PRINCESS CHARLOTTE DOLL,1,346,10,1100,754,1,20.0
14365,10994.0,IVORY KNITTED MUG COSY ,2,2188,21,2200,12,1,42.0
14366,10995.0,BOX OF 6 ASSORTED COLOUR TEASPOONS,2,1569,25,2600,1031,1,50.0
14367,10996.0,BOX OF VINTAGE JIGSAW BLOCKS ,2,186,6,700,514,1,12.0
14368,10997.0,BOX OF VINTAGE ALPHABET BLOCKS,5,826,13,1400,574,1,26.0
14369,10998.0,HOME BUILDING BLOCK WORD,3,472,8,900,428,1,16.0
14370,10999.0,LOVE BUILDING BLOCK WORD,4,509,12,1300,791,1,24.0
14371,11000.0,RECIPE BOX WITH METAL HEART,5,143,2,300,157,1,4.0
14372,11001.0,DOORMAT NEW ENGLAND,4,959,18,1900,941,1,36.0
14373,11002.0,JAM MAKING SET WITH JARS,3,290,3,400,110,1,6.0
14374,11003.0,RED COAT RACK PARIS FASHION,7,1504,15,1600,96,1,30.0
14375,11004.0,YELLOW COAT RACK PARIS FASHION,2,995,18,1900,905,1,36.0
14376,11005.0,BLUE COAT RACK PARIS FASHION,3,160,2,300,140,1,4.0
